mystical	神話的な
recurrence	再発
drawback	戻し税|欠点|障害
darn	繕う|かがる|繕い
visionary	幻の|非現実的な|夢のような|空想家|空想
warden	刑務所長|管理人|看守(長)|番人|長官|監督者|巡視員|学長|校長|理事|役員|監督保護する
authenticate	信頼できることを証明する
underwood	下草(したくさ) 2|アンダーウッド|人名
breakout	脱走
sonny	坊や
longevity	(lɑndʒévəṭi)長生き|長寿|生命|寿命
lux	ルクス(照度の国際単位)
sterile	実のならない|不妊の|不毛の|無菌の
importer	輸入商
krona	(複‐nor)クローナ(スウェーデンの貨幣単位)|(複‐nur)クローナ(アイスランドの貨幣単位)
botany	植物学
upland	高地|高台|高地の|高台の
vocalist	声楽家
venom	悪意|毒|毒液|うらみ|に毒を注ぐ|悪意で満たす
allegro	(音楽の演奏の指示で)急速に(な)|アレグロ
materially	大いに|かなり|実質的に|物質的に
hummingbird	ハチドリ
dreamy	夢のような
spoof	いたずらにだますこと|いたずらにだます
backstage	舞台裏(の)
crypt	地下室
acquaintance	面識|知識|知人|知合い
intuition	直観
giggle	くすくす笑う|笑いながら言う|くすくす笑い
aquifer	帯水層
tuxedo	タキシード
dagger	短剣(暗殺の象徴)
qq	questions
collier	(炭鉱の)坑夫|石炭船
lash	さっと動かす|鞭|マツゲ
hostility	戦争行為|敵意|敵性|敵愾心|反抗|敵対行為|反対|対立
cultivate	交際を求める|耕作する|耕す|養殖する
proclaim	宣言する|公表する|を声明する|を公然と示す
greed	欲張り|貧欲|どん欲
commando	特殊部隊
lastly	最後に
herring	ニシン|鰊
firearm	小火器
quorum	定足数
expectancy	予測値
coffin	棺|棺桶|かんおけ|ひつぎ|(=casket)|ぼろ船|棺に入れる|納棺する
plow	(馬･牛に引かせる)すき(犂)|耕す|すきで耕す|(=plough)|cf|hoe(鍬|くわ)
participatory	参加の
intermittent	断続する|途切れ途切れの
budgetary	予算の
bearer	運搬人|使者|(手形などの)持参人|実のなる植物
cruelty	残酷
hustle	押しのけて進む|精をだす|せきたたて～させる|ハッスル
spongebob	スポンジボブ(テレビアニメ名)
fractional	分数の
ideological	イデオロギーの
geriatric	老人(病)学|老人の|老人向けの|老人病の|おいぼれた
concierge	アパートなどの管理人(通例女性)
rheumatoid	リウマチ(様)の|リウマチにかかった
thence	そこから|それから|その時から
polarization	偏向|分極|分極化
understandable	(言葉･理論などが)理解できる|分かり易い|道理にかなった
shea	shea butterシアバター|(アカテツ科のシアーバターノキ)|(その種子の胚から得られる植物性脂肪がシアバター)|(Shear刈る|は別語)
hammock	ハンモック
practicable	実行可能な|通行できる|実際的な|実用的な|使用できる
ancestor	祖先|先祖|始祖|原型
coastline	海岸線
canonical	正統な|権威のある|聖書正典の(と認められた)
believer	信奉者|教徒|信ずる人|信者
notary	公証人
nifty	粋な(stylish)|楽しい(pleasing)|気が利いた|格好いい|素晴らしい
utmost	最大限の|最上の|極度の|最高の|一番端の|極限|全力
scrape	こすること|こすった跡|をこする|をこすりつけてけがをする|すれる
disbursement	支払い|出費|支出
skeletal	骨格の|骸骨(がいこつ)の|非常にやせ(衰え)た
shoppe	(shopの古い綴り)(主に店の看板に用いて)小さな店
shove	強く押す|(～を)押す|を突っ込む|押しやる
anthrax	(医)炭疽(たんそ)病(家畜|人の伝染病)
deity	神|神性
juniper	トショウ(杜松)|ネズ(常緑の低木で球果は紫色で薬用またはジン酒の味付けに用いられる)
shockwave	衝撃波
stink	悪臭(を放つ)|スキャンダル|騒動|ひどいもんだ|どうしようもない|化学
negatively	マイナスに|否定的に
spinach	ホウレンソウ
ancillary	補助的な|副の
planar	二次元の|平面の|平面的な
adequacy	妥当性
paralegal	弁護士助手
oscillator	発振器
cavalry	機甲部隊|騎兵隊|騎兵|騎馬隊
deformation	形をくずすこと
comeback	復帰|返り咲き|カムバック|再起
prevalent	普及した|流行の|一般的な|有力な
pip	(リンゴ･ナシなどの)種|不機嫌|(トランプ･さいころの)目|(ひなが)ピヨピヨ鳴く|(卵の殻を)破って出る|(時報の)ピッという音|(相手を)打ち負かす
repertoire	レパートリー|上演目録|演奏曲目
prostitution	売春|堕落
joker	冗談を言う人|ふざけ屋|やつ|(トランプ)ジョーカー
horseback	馬の背|馬に乗って|低い切りたった尾根
terribly	恐ろしく|ものすごく
earnest	まじめな|熱心な|真剣な|重大な
skew	曲り|歪み|曲げる|歪む
myocardial	心筋の
homme	オム|フランス語で「男性」|女性は「Femme」
everytime	毎回
sander	サンドペーパーをかける人|砂まきトラック|砂まき装置|砂まき器
catchment	貯水池|集水
foreman	作業長|職長|現場主任|現場監督者
glider	グライダー
campsite	キャンプ場
creditor	債権者
aloe	アロエ|ロカイ(ユリ科の植物)|リュウゼツラン|アロエ汁は下剤に使われる
abrasive	すり減らす|研磨剤|研磨の|不快な
pertain	に関係がある|属する|ふさわしい
deacon	執事|カトリックの助祭
outback	奥地|未開拓の奥地
muddy	どろだらけの|泥だらけの|泥の|ぬかるみの|濁った|さえない
quicken	はやくなる|急がせる|を生き返らせる
allegiance	忠誠|忠実
seneca	セネカ|Lucius Annaeus Seneca(4 BC?-AD 65|ローマの哲学者･政治家)
oceanic	大洋の;《O-》大洋州(オセアニア)の|大洋に住む|大洋のような|巨大な
flair	勘|傾向|直感|ひらめき|第六感|嗅覚|識別力|素質
comprehend	を理解する|把握する|を包含する|含む
quarantine	隔離(させる)|検疫(させる)|隔離所|隔離期間
festive	お祝いの|陽気な
awakening	目覚め
pictorial	絵の|絵画の(ような)|画家の|絵入新聞|絵入り雑誌
waiter	給仕|ボーイ
ode	叙情詩|オード
penthouse	ペントハウス|高級な高層アパートメントの最上階の住まい
myriad	無数の|無数
flamingo	フラミンゴ(鳥)
uninsured	無保険の
ambiguous	あいまいな|両義にとれる|不明瞭な
originator	創始者|創設者|発起人|起案者|本家|開祖
righteousness	正義|正直|正しさ|実直
unicorn	一角獣(角のある伝説上の動物)
discriminatory	差別的な
tableware	《集合的に》卓上食器類(皿・ナイフ・フォーク・スプーンなど)
lama	ラマ僧
suction	吸水管|吸引力|吸引|飲酒
ache	痛む
prioritize	優先順位を決める|を優先^する(させる)|優先順位をつける
lilac	リラ|ライラック|薄紫色(の)
plural	複数の|複数形|複数形の
teak	チークの木
adjective	形容詞
shank	すね(の骨･肉)|すね状の物|柄
hillside	丘の中腹
loch	湖|入り江
omission	遺漏|省略|怠慢
applaud	拍手かっさいする|賞賛する|拍手する
nomad	遊牧民|流浪者
speculate	思索する|熟考する|推測する|投機する|に投資する|を思惑買い(売り)する
methane	メタン
tumour	(主に英国)腫瘍(=tumor)
comptroller	(会計･銀行)検査官|監査官
epoch	時代|新時代を開くできごと|銘記すべきできごと|新しい時代のあけぼの|新紀元
doorway	戸口
correctness	正しさ
wacky	気違いじみた|風変わりな|ばかげた
fairway	(川･港などの)航路|フェアウエー
implication	(かくれた)意味|暗示|(類語connotation)
dreamer	夢みる人|夢見る人|夢想家
bazaar	バザー
relativity	相対性物理学|相対論|相対性原理
confuse	(人)を困らせる|を混乱させる|を混同する
quay	波止場
navigational	航行の
awaken	目をさまさせる
cavern	大洞穴|洞穴|洞窟
multiplex	多重送信する|多重送信システム
insanity	狂気(のさた)|精神異常
waffle	ワッフル|無駄口をきく|曖昧な態度をとる
toad	ヒキガエル|いやなやつ
vl	Vulgar
oversized	特大の
sibling	(男女の別をつけない)兄弟|兄弟姉妹 
airbag	エアバッグ(自動車事故けが防止装置;自動的に空気がはいってふくらむ)
polytechnic	工芸の|工芸学校|科学技術専門学校
tickle	くすぐったい|をくすぐる(=titillate)|を満足させる|を喜ばせる
ashamed	恥ずかしがって|恥ずかしく思う|恥て
commemorate	記念する|を祝う
gathering	集まること|集会
ire	怒り|憤怒|を怒らせる|anger
scribe	作家|新聞記者|筆記者|写本筆写者|書記|書く|writer|newsman
unabridged	省略してない|完全な|無削除の
dickens	驚きや婉曲な悪口をあらわす
saucer	皿|茶碗の受け皿|小皿|空飛ぶ円盤
synchronous	同時(性)の|同時に起こる|同位相の|同期の
folly	愚かさ|愚行
mermaid	(女の)人魚|女子水泳選手
preparatory	入学準備の|準備の|予備となる|予備の|進学準備の
serpent	ヘビ|蛇(snakeより文語的表現|また大型のイメージ)
moo	モー(と鳴く)|牛の鳴き声|牛肉|牛乳|愚かなやつ
dune	砂丘|砂の小山
homelessness	家がないこと|ホームレスであること
stony	石だらけの|無感覚な|石の(多い)
weep	すすり泣く|泣く|しくしく泣く|しずくをたらす|涙を流す
missy	(呼びかけで)お嬢さん|娘さん
trucker	トラック運送業者|トラック運転手|交易者|行商人
turnout	出席数|人出|投票者数|集合|turn outすること
lessen	小さくなる(する)|減少する(させる)
helium	ヘリウム(希ガス元素)|元素記号He
furry	毛皮のような|あわただしさ
screwdriver	ねじ回し|ウオッカとオレンジジュースのカクテル
wonderfully	驚くほど|不思議なほど|素晴らしく
whitewater	川の急流(ｔorrent)
workgroup	ワークグループ
congenital	先天的な|生来の
underestimate	過小評価する
barge	遊覧船|荷船|はしけ
finely	立派に|きちんと
depository	保管所|倉庫|保管人|受託者
robotic	ロボットの(ような)|ロボット利用の
flagship	最も重要なもの|旗艦
maestro	大音楽家|大作曲家|名指揮者|(芸術の)巨匠|大家
rodent	齧歯(げっし)動物|齧歯類の|かじる
dialysis	透析
tram	市街電車|路面電車|電車で行く|電車軌道|線路
noticeable	目立つ|著しい
tabletop	卓上
smoker	喫煙者|喫煙家|発煙物|喫煙できる車両(客室)
beep	時報音|ビーッと鳴る|プープー|車のクラクションの音
catastrophe	悲劇的結末|大変動|破局|大災害|大失敗
benign	良性の|恵み深い|親切な|優しい|温和な|(病気が)悪性でない
bale	ベイル(大型荷物)|梱包する
dunno	don't know
evidently	明らかに
unforgettable	忘れられない
elemental	自然の力による|元素状態で存在する|要素の|元素の|原理的な|基本的な|自然力の
lore	知識|学問|教え|伝承|伝承による知識
bod	《英話》人;(特に)男
genuinely	真に|純粋に
subcontract	下請け契約|外注|下請けに出す|下請け負いする
songbook	歌集|賛美歌集
slant	傾斜|傾向|斜めになる|偏る
souvenir	記念品|土産|おみやげ
wicker	邪悪な|小枝|枝編み細工
mojo	魔法のパワー(a magic power)|魔法の呪文(a magic spell)
decisive	決定的な|断固とした
typewriter	タイプライター
genotype	遺伝子型
immersion	水(液体)に浸すこと|浸礼(全身洗礼)|没頭すること
swarm	いっぱいになる|群がる|群れ|昆虫の群れ|群衆
annals	年代記|記録
storytelling	嘘をつく|物語を話す|物語の話術
sadness	悲しみ|悲しさ
dictator	独裁者
periodical	定期刊行の|周期的な|定期刊行物
recital	リサイタル|独奏|独演会
bombing	爆撃
pianist	ピアニスト|ピアノをひく人
sabre	サーベル|軍刀|をサーベルで切る|saber
corset	コルセット
lettuce	レタス
accomplishment	達成|完成|才能
onwards	前方へ
bogus	偽の|いんちきの|にせものの|偽りの
anemia	貧血(Anemia of Chronic Disease　慢性疾患性貧血)
clubhouse	クラブ会館|運動選手のロッカー室
tat	ぼろを縫い合わせた敷物|粗製ズック|薄汚い服|みすぼらしい人|安っぽいもの|軽打|tattoo|カンバス地|タッチングtattingで作る|糸をかがって作る
bunk	(船･列車の)寝だな|寝台|ごまかし|逃亡|ごろ寝する
dusk	黄昏(たそがれ)
nouveau	ヌーヴォー|新しい(仏語)
customary	習慣的の|慣習の|いつもの|例の
vertically	垂直に
cautious	注意深い|用心深い
malt	麦芽|モルト
bullshit	嘘|でたらめ|ナンセンス|心にもないことを言う
jive	スイングに合わせて踊る(曲)|ジルバ|(俗)たわごと
inhalation	吸入
mobil	モービル
counterpart	よく似たもの|対応物|複製|対の片方|相手方|片割れ|対照物
downtime	中断時間|運転休止時間
secretly	秘密に
hive	ミツバチの巣箱(=beehive)
repeater	リピータ(繰り返す人|客)
fob	フォッブ|策略|ごまかす|無視する|つかませる
fam	家族
experimentation	試すこと|実験
dealing	分配する
pathetic	哀れな|感傷的な|無価値な
guerrilla	ゲリラ兵|不正規兵
centric	中心の
striker	ストライキをする人|撃鉄|打ち手|打つ人(物)
geophysical	地球物理学[上]の
fictional	虚構の
adherence	固守|執着|忠実|支持(to)
brotherhood	兄弟関係|組合|兄弟の間柄|同業者
illegally	不法に
harden	がんこにする|非情にする|堅くなる|かたくする|を強健にする
halogen	ハロゲン|ハロゲン元素 (フッ素F|塩素Cl|臭素Br|ヨウ素I|アスタチンAtの総称)|ハロゲンの語源はギリシャ語の｢塩を作るもの」
mediate	調停する|仲介する
proclamation	宣言|公布|布告|発布|宣言書|声明文
bender	曲げるもの|曲げ|ベンダー(曲げる道具)|(俗)深酒|(B-)人名(姓)
cardigan	カーディガン
servo	=servomechanism|=servomotor
respectfully	うやうやしく
ulster	(通例ベルト付きの)防寒用長コート
macroeconomic	マクロ経済の
yogurt	ヨーグルト (=yoghurt)
tanker	油送船|タンカー|タンクローリー
salesman	販売係|男子販売員|男子店員|外交販売員|セールスマン
equate	等しく扱う|同一視する
brownie	クルミ入りチョコレートケーキ|夜農家に来て仕事をする小妖精
destroyer	破壊するもの|破壊者
chit	幼児|子供|小娘|(飲食の)伝票|短い手紙|メモ|(chit-chatおしゃべり)
starch	澱粉|糊|のり
leash	(犬などを)つなぐひも|鎖
elicit	引き出す|導きだす
grenade	手りゅう弾|手榴弾|催涙弾
sanity	正気|(思想･判断などの)健全さ
pragmatic	実用主義の|実際的な
heron	アオサギ|サギ
hector	いばりちらす|どなる人|からいばり屋
audible	聞こえる
checker	照合係|(携帯品)一時預かり|レジ係|格子縞(にする)|色とりどりにする|チェッカー(ボードゲーム)
stomp	どっしりと歩む
homogeneous	同種の|同質の|同性の|均一の|等質の|均質の
forte	強み|長所|得手|おはこ|特長
convection	伝達|対流
catheter	導尿管
paragon	模範|手本
derivation	誘導|(文法)派生
feminism	フェミニズム
pointless	無意味な|無得点の|先のない
vox	音声|言葉|声
harrow	まぐわ(農具の一種)|〈掘り起こした土〉‘を'まぐわでならす《+『up』+『名|』+『名』+『up』》|〈人〉‘に'精神的な苦痛を与える;〈人の心〉‘を'傷つける
whisky	ウイスキー
genealogical	系図の
forehead	ひたい|額|前面|前部
grit	軋らせる|小砂
kicker	ける人|反抗者|不平家|意外な結末
selfish	わがままな|利己的な|自分勝手な
eventual	終局の|結果として来るべき|最後の
upscale	高所得者向けの|金持ち相手の
unpack	の梱包を解く
persuasion	説得
kiln	窯|かま
novelist	小説家
arguably	間違いなく (she is arguably the best 彼女は間違いなくベストだ) 
walkman	ウォークマン
keepsake	記念品|形見
bureaucracy	官僚政治|官僚主義|官僚制|官僚社会
saltwater	塩水
truss	トラス|桁構え|干し草･わらなどの束
grassland	草原|牧草地|牧場|草地
haute	高級な
interviewer	面接官|インタビューをする人
sportsman	スポーツマン
unfamiliar	なじみのない
deterioration	(品質などの)低下|悪化|堕落|退歩
caliber	能力|価値|直径|銃などの口径
arid	乾燥した|不毛の|異常に乾燥した
bobcat	ボブキャット|北米産のヤマネコ
raft	いかだ|(rafting|いかだ競技)
linden	シナノキ(植物)
synagogue	ユダヤ教の礼拝堂|《the ~》ユダヤ教徒の集会
gall	心痛|すりむく|いらだたせる|植物のこぶ(昆虫(gallfly)による虫こぶや|菌類の寄生によるコブ)
neighbour	に隣接する
allure	そそのかす
dispense	分配する|調剤する|施す|施行する|免除する
ding	ジャン|ゴーン(と鳴る･鳴らす)|くどくど話す
permissible	許すことのできる|許される|許された|差支えない
latent	潜伏している|隠れている|潜在している|見えない
cockpit	操縦室(席)|操縦席|闘鶏場|コクピット|戦場
nicotine	ニコチン
inward	本質的な|内へ|内部へ|内陸の|奥地の|内部|内側
sulphur	硫黄
wager	を賭ける|請け合う|賭け|賭事|賭け金
curricular	教育(教科)課程の
duvet	羽根ぶとん
relic	記念物|遺物|遺跡|遺風|なごり|面影
chaotic	混とんとした
principally	主に
outright	完全に|率直な
parachute	落下傘|パラシュートで降下する
sandal	サンダル|サンダルをはく
naive	あどけない|ばか正直の|無邪気な|世間知らずの|だまされやすい
skeptical	懐疑的な|無神論の|疑い深い|疑わしい
transceiver	トランシーバー
weir	ダム|堰|(魚をとるための)やな
dependable	信頼できる
prudent	分別のある|慎重な|思慮深い|賢明な|用心深い
sultan	(またはS-)トルコ皇帝|イスラム国王|サルタン|絶対君主|回教徒の君主
alchemy	錬金術
stalk	茎|軸|細長い支え|煙突|忍び寄る|大またに歩く
geographically	地質学的に
pandemic	全地域にわたる
sire	の種馬となる|を産む|種付けする
tong	(中国の)党|(中国人の)秘密結社|(俗)学生クラブハウス|物をつまむ|箸(はし|通常複数形|tongs)
forfeit	没収される|剥奪される|権利を失う|放棄する|没収物|罰金|違約金
colleen	少女|娘
mismatch	不適当に組み合わせる|の組合せを誤る|不釣り合い|不釣合いな縁組
childbirth	出産|分娩
seduce	を誘惑する|をそそのかす|誘惑|誘惑する
plumber	配管工|(俗)台無しにする|ぶち壊す
plank	厚板|政策|支えとなるもの|を板張りする
intestine	腸|(large intestine大腸|small intestine小腸)
fiery	火の
convex	凸(おう)状の
carver	彫刻者|肉を切る人|肉切り包丁と大型フォーク
manure	こやし|肥料|肥料をやる
maven	達人|(自称)物知り|通
surfer	サーファー|サーフィンをする人|波乗り人
proprietor	所有者|経営者|持主
bop	bebop|ビーバップ(ジャズの一形式)
slang	スラング|俗語
squat	しゃがむ|うずくまる|すわる|無断で居座る
outbound	外国行きの
scrabble	ひっかき回す|手さぐりする
restless	絶えず動いている|落ち着かない|不安な|やむことのない
unanswered	未回答
cameo	カメオ(瑪瑙･大理石･貝殻などに横顔を浮き彫りにした装身具)
courtroom	法廷
bolster	強める|支持(する)|長まくら(pillowの下の)
corsair	(アフリカ北岸の)海賊(船)
workaround	次善策・本来の方法でうまくいかないときの代わりの方法・回避方法
jargon	わけの分からない言葉|専門語(=technical term)|特殊用語
intellect	知性
torso	胴|胴体
annoy	うるさがらせる|をいらいらさせる
playhouse	おもちゃの家|劇場
synthase	シンターゼ|合成酵素の一種
excitation	励起|励磁|励振|エキサイテーション|エクサイテーション|加振
ascension	上昇|即位
taper	だんだん細くなる|次第に細くなる|次第に小さくなる|漸減|次第に細くする
scientology	サイエントロジー|米国の作家Hubbardが創始した応用宗教哲学
flagstaff	旗ざお
hoist	引き上げ|掲げる|持ち上げる|巻き上げる
savior	救済者|救世主
attest	証明する|誓言する|実証する
rightly	正しく
basal	基底の|基礎的な|根元から出ている
rooster	おんどり(米ではcockよりもこちらを用いる)|うぬぼれの強い人
indispensable	(絶対に)欠くことのできない|必須の|無くてはならない|不可欠の
wen	瘤|腫れ物|(腫れ物のように)異常に膨れ上がった都市|人口が密集した大都市|ロンドン市の俗称|おニューの|新しい
ornamental	飾りの|装飾的な|装飾品
illicit	違法の|不法な|無免許の|もぐりの|不義の|禁制の
oppression	圧迫|憂鬱
homecoming	帰郷|(大学の)同窓会
monoclonal	monoclonal antibody モノクローナル抗体(単一な抗原決定基と反応する構造が均一な抗体)
curling	カーリング(スポーツ)
crusader	十字軍の戦死|改革運動家
ignite	点火する
are	2人称単数および各人称の複数を主語とするbe動詞の直説法現在形|アール(面積の単位=100平方メートル)
wholesaler	卸売業者|卸し売りで|卸し売りの
smoky	けむい|煤けた|煙を出す|煙のような|くすんだ
opus	(音楽･文芸)作品|音声圧縮フォーマット
recession	景気後退|後退|退去|窪み|返還
narrator	ナレーター
mage	魔法使い|学者
inherently	生得的に|もともと|本質的に
forefront	(theをつけて)最前部
outboard	外側寄りの|船外の|中心を離れた所にある
dilution	薄めること|希薄|薄めたもの
monophonic	単旋律の;単旋律曲の|1チャンネル録音再生の(monaural)
amazingly	驚くほど|すてきに
gambler	ばくち打ち|やくざ
hereinafter	以下|以下の
skipper	スキッパー|船長|機長|主将|経営者|ボス
analogous	外見や機能は似ているが共通の祖先に由来しない場合「相似analogous」という|cf|遺伝子が共通の祖先に由来する場合「相同|orthologous」という
unpleasant	不愉快な|いやな|気にさわる
dram	ドラム(重量の単位で常衡は1.772グラム|薬局衡では3.9グラム)|(ウイスキーなどの)微量|一口《+『of』+『名』》|(一般に)わずか(の〜)《+『of』+『名』》
ecstasy	こうこつ|忘我|有頂天
blindness	盲目
negotiable	交渉できる|交渉の余地がある
hearted	「〜の心を持った」「心が〜の」の意を表す
tint	薄い色|色合い|気味|色彩|濃淡|淡い色
agility	機敏さ
crouch	身をかがめる|かがむ(こと)|卑屈にちぢこまること
indemnity	将来の損害にたいする法的な保護･保障|補償(金)|賠償金|保険
syringe	注入する|注射器(=injector)
noteworthy	注目に値する
agile	機敏な|頭の回転の早い|活気のある|身の軽い|鋭敏な
ionic	イオンの;イオンを含む
clinically	臨床的に
monmouth	モンマス
burr	いが|荒い削り面|バリ
presenter	司会者|申告者|推薦者|贈呈者
teal	小ガモ
unnamed	名前のない
inlay	はめ込む
mindless	思慮のない|愚かな|意に介さない
amplification	増幅
intruder	侵略者|侵入者
greedy	どん欲な|切望した|欲張りの
baht	バーツ(タイの通貨単位)
thermostat	サーモスタット
societal	社会の|社会的な
detergent	洗剤|洗浄剤
witty	機知に富んだ|機知のある|気のきいた
dorado	シイラ(魚)|ドラド|旗魚座
occult	神秘(の)|超自然的な|隠れる
hoax	人をかつぐこと|いたずら|でっち上げ
coaxial	共通軸の|同軸の
accompaniment	伴うもの|随伴物
deprivation	(権利などを)奪うこと|剥奪
setter	置く人|並べる人|垂れ込み屋|(バレーボールの)セッター
heuristic	発見的な|発見を助ける
ballistic	弾道(学)の|衝撃の
recite	学課を復唱する|暗誦する|を暗唱する|を吟唱する|を物語る
confederation	連盟|連合|同盟
exemplary	模範的な|称賛に値する|見上げた|りっぱな|見せしめの|戒めの
cider	リンゴ酒(日本語で言う｢サイダー｣の意味はない)
playful	遊び好きの|滑稽な|ふざけた|陽気な|冗談の
plaid	格子じまの|格子じま(の肩掛け･織物)
revere	尊敬する
contraception	避妊
deodorant	脱臭剤|防臭剤
polaroid	ポラロイド|(人造偏光板)
marquis	侯爵
prognosis	病気の予後|予後|予知|予測
underage	未成年の
cardio	(連結形)|「心臓」の意
brow	額|ひたい|(複数形で)眉･眉毛
acclaim	に喝采する|大声で言う|歓呼
cleanse	清潔にする|浄化する
kool	クール|メンソールたばこの商品名|(Keep Only One Loveの頭文字)
synthesizer	シンセサイザー
caveat	予告記載|警告|手続停止申請|誤解を招かないようにするための警告･注
lymph	リンパ|リンパ液|血清|痘苗
cleanser	洗剤
pollutant	汚染物質
protease	プロテアーゼ(Protease)|ペプチド結合加水分解酵素の総称
grandson	男の孫|孫息子
almighty	全能の
modernization	近代化
pinpoint	ピンの先|正確に示す(ねらう)|ピン先(ほどの)|ごく小さい物|わずか
openness	公開|開放性
chromium	クロミウム(金属元素)|クロム
tyrosine	チロシンまたは4-ヒドロキシフェニルアラニン(4-hydroxyphenylalanine)と呼ばれ|細胞でのタンパク質生合成に使われるアミノ酸のうちの一つ
weary	疲れた|退屈な|飽き飽きして|うんざりした
fart	おなら|いやな奴|屁を放る
envoy	大使|外交使節|個人の使節
teaser	いじめる人|悩ます人|男をじらす女|難問
grower	栽培者
slippery	つるつるした|つるつる滑る|不安定な|理解しにくい|信頼できない|ずるい
unpredictable	予想できない|予言できない|突発的
stash	を隠す|(俗)置く|かくまう
nationalism	民族主義|愛国心|愛国主義
sparse	まばらな|希薄な|薄い
generalization	一般化すること|総括
braille	点字
motorize	動力化する|農業を動力化する|車にエンジンをつける
snare	誘惑(する)|わな(に･をかける)|陥れる
plume	羽を思わせるもの|羽毛|羽(飾り)|を整える|を羽毛で飾る
standpoint	立場|観点
creepy	むずむずする|はう|はい回る
aerobic	好気性の
gladiator	剣闘士
modal	様式の|様態の|形式上の|形態上の
ratification	批准|承認
ooh	アア|ウー|オー|ワー|アッと驚く
vial	ガラスびん|水薬びん
lucent	光る|輝く
orthopedic	整形外科の|整形外科
familiarity	親密
groovy	いかす|かっこいい
erroneous	誤った|誤っている
conceal	の中に身を隠す|隠す|を秘密にする|に潜伏する
histogram	ヒストグラム|柱状図|棒グラフ(=a bar chart)
ism	イズム|学説|主義
ophthalmology	眼科学
paddy	水田|稲
invocation	祈り|発動|呼びかけ|(関数の)呼び出し(＝call)
cracker	かんしゃく玉|クラッカー
renegade	背教者|脱党者|変節者|裏切り者|背教の|裏切りの
fumble	不器用に手で捜す|手探りする|探し回る|いじくり回す|口ごもる
ironic	皮肉の好きな|皮肉な|反語の|反語的な|皮肉を言う
shred	断片|破片|ぼろ切れ|ほんの少し|少量|ちぎれる
unsupported	支持されていない
fugitive	変わりやすい|逃亡者|脱走者|亡命者|放浪者|脱走する|逃亡する|さまよう
foreword	はしがき|序文
payoff	賄賂|利益|支払|収益|献金
faire	放任
medley	ごたまぜ|寄せ集め|メドレー
conversely	逆に
transgender	性転換の
upwards	=upward
pong	ポーンという音|嫌なにおい|悪臭|ポーンという音を立てる|アドリブで言う|悪臭を放つ
loosely	しまりがなく|ゆるく|大まかに
hertz	ヘルツ
firefighter	消防士
digestion	消化
puck	(アイスホッケーの)パック
propulsion	推進(力)
allotment	割当て|分配
compassionate	あわれみ深い|哀れに思う|情け深い|同情的な
catastrophic	悲劇的な
misdemeanor	軽罪|軽犯罪
silky	絹のような
niece	めい|姪
reusable	再使用|再利用できる
inversion	逆にすること|転倒|転置|転換|反転|(文法)倒置(法)
actuarial	保険計理(士)の|(もと法廷の)記録係(書記)の
horseshoe	蹄鉄|馬てい鉄|馬蹄|U字形の(もの)
godfather	名づけの父|マフィアのボス
cram	詰込み勉強(をする)(cram school予備校)|無理に詰め込む
lament	悲しむ|嘆く
erectile	直立できる|勃起性の
timeliness	適時性
contender	(スポーツでタイトルをねらう)選手|競争者|チーム
pageant	ページェント|野外劇|華麗なもの|虚飾|誇示|出し物
obstetrics	産科学|産科
rapper	ラッパー|ラップ歌手
glitch	突然の故障|不調|困ったこと
malfunction	うまく作動(機能)しない|不調|機能不全
chemically	化学的に|化学反応により
storefront	店先|店頭
segregation	人種差別|分離
superannuation	老齢退職;老朽|退職者年金
overcast	曇った|憂鬱な
revisit	再訪問(する)
cabaret	キャバレー
silica	シリカ|珪土
pilgrimage	巡礼|聖地巡り
graveyard	墓地
presume	あえて～する|を推定する|と思い込む|と仮定する|想像する|思う
pax	(ラテン語でpeace平和)|強国の支配による平和|親睦の接吻|Pax Romana(ローマ支配による平和)|(子供の遊びで一時中断の)タイム|(子供のけんかで)仲直り
pun	しゃれ(を言う)|ごろ合わせ
conjecture	推測する|推測
tummy	(幼児語)おなか|ポンポン
pervasive	普及する|広がる|全面的に広がる
anabolic	同化作用の|(同化は小さな部品から分子を構成する代謝過程|大きな分子を分解して細胞呼吸に用いる「異化」から得られるエネルギーによって起こる)
syllable	音節
dyer	染め物屋
naturalist	動(植)物学者|博物学者|自然主義者
knowingly	しりた顔で|わざと
sag	下がる|下落する|たわむ|垂れ下がる|沈下する
capitalize	を利用する|につけ込む|を大文字で書く|資本化する|投資する
transverse	横断する|横の|横断の|横軸の|横軸
meteor	いん石|流星|隕石
uniformly	変わらずに|一様に|一律に|均等に|変化なく
salesperson	セールスマン(nonsexist)
piedmont	山麓地帯
yin	陰|陽(yang)に対するもの
outlying	境界外にある
filthy	不潔な|非常に汚い|みだらな
marvelous	驚嘆すべき|不思議な|驚くべき|素晴らしい
vigorous	精力的な|活気のある|元気な|力強い|強制的な
boredom	退屈
exponent	解説者|指数|説明者|解釈者
gopher	ジネズミ(北米産)|ほりねずみ|食用ガメ(米国南部産)
downstairs	階下に
concordance	用語索引
cheerful	気持ちのよい
snip	はさみ切る|(～を)はさみでちょきんと切る|ちょきんと切り取る|少量|断片
spherical	球状の|丸い|球の|球形の
intracellular	細胞内の
favourable	(=favorable)
bullock	去勢牛|去勢雄ウシ|去性雄ウシ
overdrive	オーバードライブ
billiard	玉突きの|ビリヤードの
momma	ママ
needy	貧窮している|非常に貧乏な
unseen	見られない|まだ見たことがない|見知らぬ|目に見えない|即席の
piazza	広場|市場|ベランダ|回廊
notepad	メモ用紙|はぎ取り式ノート
optimism	楽天主義|楽観主義
unusually	いつになく|異常に|著しく|一風変わって|非常に|ひどく
impotence	インポテンス|性的に不能の
constable	警官 
depletion	使い尽くすこと|枯渇|減損|減価償却
wrangler	口論する人|言い争う人
alligator	アメリカワニ|ワニ皮
intravenous	静脈内の|静脈(注射)(の)
hereafter	今後(は)
remit	怒りを和らげる|を送る|税を免じる|軽減する|支払う
ballast	(鉄道･道路の)砂利|道床|バラス|(船の)底荷|脚荷|バラスト
flask	フラスコ|鋳型
fragmentation	分解|断片化
paranormal	超常能力がある人|超常現象|パラノーマルな|科学的に説明できない|超常的な
generosity	物惜しみしないこと|寛大な行為
akin	血族の|血族で|似通って|類似して
adversary	相手|敵|反対者|敵対者
aqueous	水の|水性の
canister	缶|金属容器
coma	(kóʊmə)pl|comae(-miː)|(天文)コマ|彗星の頭部で核の周囲の星雲状のもの|(植物学)種髪(しゆはつ)ワタなどの種子の綿毛|(医学)昏睡(状態)
gangster	悪党
smother	を窒息させる|覆い隠す|もみけす|濃い煙|大混乱
presumption	見込み|推定|仮定|推定の根拠|無遠慮|でしゃばり
preferable	より好ましい|ましな
ironically	皮肉に
vowel	母音|母音字
billet	革ひも|鋼片
hottie	湯たんぽ
adrenaline	アドレナリン|刺激剤|神経伝達物質またはホルモンとして働く
hone	(技術などを)磨く|(かみそりなどの)砥石(でとぐ)|(hone one's skills腕を磨く)
snowman	雪だるま
mammalian	哺乳類の|ほ乳動物(の)
rascal	いたずらな人|悪党|ごろつき|卑しい
meteorology	気象学
maniac	狂人|熱狂家|～狂
pristine	初期の|原始時代の|素朴な|清純な|自然のままの|元の|原始的な
interception	妨害
auditory	耳の|聴覚
apricot	アンズ|アプリコット|アンズ色
applause	称賛|拍手喝采|声援
medically	医学的に
trait	特性|特|特色|特徴|習性|一筆
melanoma	黒色腫
picturesque	絵のように美しい|人目をひく|表現力に富んだ
grader	(合成語で)～年生
resent	を不快に思う|憤慨する|恨む
trough	凹型(=concave)|溝|管|気圧の谷|桶|木鉢
brood	ひとかえりのひな鳥|(動物の)ひと腹の子|思案する|くよくよ考える　3|(雲|暗闇などが)たれこめる|おおう
secrecy	秘密性|秘密|秘密主義|秘密にしておくこと
remand	再拘留(する)|送り返す|(人に)帰還を命ずる|(裁判の)差し戻し|再拘留者
shovel	シャベル
fertile	肥沃な|生産力の豊かな
plausible	もっともらしい|口先のうまい
eruption	噴火|爆発
interlock	組み合わせる|連結する|結合する|組み合う|抱き合う|連結|連動
spaniel	スパニエル犬
fahrenheit	華氏|華氏温度
oneself	自分自身|自ら
abbreviation	略語|省略|短縮
mite	ダニ|ごく小さいもの|(かわいそうな)子供|(少額)寄付
intersect	横切る|横切って二分する
broom	ほうき|掃く|エニシダ(植物)
anomaly	例外|変則|異常|変則的なもの|異形|偏差
flatbed	フラットベッド|平台
expressive	表現力に富む
punctuation	句読|句読法|句読点
frontal	前額骨|前部の
havoc	(自然などの)大破壊|大混乱
ubiquitous	至る所にある|遍在する
genie	童話で|人間の姿になって願い事をかなえてくれる精霊|魔神(A devil|Satan)|コーランにあり|人間や動物の形で人類に影響するとイスラム教徒に信じられている精神(=jinn)
arsenic	ヒ素|(ヒソ|砒素)|元素記号As|灰色ヒ素(金属ヒ素)|ロウ状の柔らかい黄色ヒ素|黒リンと同構造の黒色ヒ素の3同素体がある|リンに似た物理化学的性質を示し|毒性の由来になっている
synonym	類義語|同意語
facilitation	(〜を)容易にすること|促進させること《+『of』+『名』》
vantage	有利|優越|優勢な地位|(古)利益
mobilization	動員|(富などの)流通
rupture	破裂(させる)|裂け目|不和|国交断絶
yer	あなたの
cutoff	切断|遮断|決算日
discontinue	廃止する|中止する
eel	ウナギ|鰻
glaze	ガラスをはめる|つや出し
colloquium	非公式会議
abatement	軽減;緩和;〈C〉減価|減額
triad	三つ組|3人組|三和音|三価元素
daycare	デイケア|保育園
undercover	秘密の
transnational	多国籍企業|国家を越えた|国境を越えた|多国籍の|国という枠組みを超えた
motorway	(UK英)高速道路
clog	の動きを妨げる|ふさぐ|動きを妨げる|詰まらせる|邪魔者|おもり|木靴
obscene	わいせつな|反道徳的な
shaman	シャーマン(呪術者|巫女|祈祷師|語源はツングース語)
continual	繰り返される
polymorphism	ポリモーフィズム|オブジェクト指向プログラミング言語の性質のひとつ|「多相性」「多様性」などの意
axial	軸の(ような)|軸の方向の
topographic	地理的
outweigh	上回る
majordomo	(昔のスペインやイタリヤの貴族・王家などの)召使頭|執事
imaginative	想像力に富む
watchlist	ウォッチリスト
camper	キャンパー|キャンピングカー(和製英語)
khaki	カヤック|(カヤック競技|kayaking)
camouflage	カムフラージュ|迷彩|偽装
numb	の感覚をなくす|感覚を失った|麻酔をかける|まひした|にぶい|麻痺した|痺れた
argentine	銀の;銀色の|銀;銀色
fuss	大騒ぎする|大騒ぎ|空騒ぎ
aft	船尾に|後部に|尾翼の方に
trombone	トロンボーン
masquerade	仮面舞踏会|仮面でおおう|仮装する|虚構|ふりをする
uptown	山の手へ
subparagraph	副段落
chaplain	公共施設付きの牧師|施設付きの司祭
rectal	直腸の
silently	黙って|静かに
impartial	公平な|片寄らない|偏らない|公明正大な
turbulence	乱気流|騒乱|混乱|社会不安
trampoline	トランポリン
tyranny	暴虐行為|暴虐|暴政|圧制|専制|虐待|専制政治
adept	熟達して|名人
tamper	不正取引をする|に干渉する|買収する
urology	泌尿器科|泌尿器科学
aforementioned	前述の
obese	でっぷり肥えた|肥満体の|肥満
verge	接する|ふち|へり|端|境界
legitimacy	合法性|正系|正統|妥当性|嫡出|適法|道理にかなっていること
zoology	動物学
enigma	解きにくいなぞ|謎|なぞの人|不可解なもの|なぞ
unwilling	気が進まない|いやがる|不本意の|いやいやながらの|反抗的な
deduct	控除する
velcro	ベルクロ・マジックテープ・（商標）Velcro
playmate	遊び仲間|遊び友達|子供の遊び友達
paranoid	偏執性の|偏執症の(患者)の|偏執(誇大妄想)的な|偏執症患者
dizzy	目まいのする|めまいのする|目が回る|当惑した|面食らった
tweed	ツイード服地
sinister	不吉な|邪悪な|不幸な|縁起の悪い|(盾の紋地の)左側の(向かって右)|(左側は不吉と考えられていた由縁)(反)dexter
disappearance	消失|消滅|失踪
perish	を殺す|滅びる|死ぬ|消滅する|悪くなる|堕落する
crosse	クロス(ラクロス(lacrosse)競技用のラケット)
phosphorylation	リン酸化反応
helpless	無力な|無力の|自分ではどうすることもできない
innovator	革新者
neonatal	新生児の
racquet	ラケット
fundamentalist	根本主義|原理主義|根本主義者
reaper	刈り取る人|刈取り機
depiction	描画
proctor	代理人|代訴人|試験監督者
revoke	取り消す
bridesmaid	花嫁の付き添い|花嫁の付き人|花嫁付添いの若い女性
labyrinth	迷路|迷宮
cosmopolitan	世界主義の|世界的な|世界を家とする|全世界的な|世界人|国際人
pulley	滑車|ベルト車|せみ
cyst	膿胞|胞嚢|嚢胞(のうほう)
sassy	生意気な
ribosomal	リボソームの|(ribosomeを参照)
masturbate	自慰行為をする
pancreatic	膵臓の
receptacle	貯蔵所|容器|置き場|花床|コンセント
fiduciary	信用上の|信託の|受託者|被信託者
digger	掘削機|鉱員
collectable	収集価値のあるもの|マニアが収集するもの
shortfall	不足|不足分(額)
craze	の気を狂わせる|怒らせる|大流行|熱狂
suitcase	スーツケース
bulge	ふくらませる|膨らむ|ふくらみ|ふくらむ|出っ張る
straighten	をまっすぐにする|まっすぐになる|整える|整備する
imposition	賦課物|税|負担|詐欺|ぺてん|(印刷)整版
demise	死|死亡(する)|崩御|逝去|消滅|終焉|権利譲渡|賃貸する|譲る
tactic	順序の|方策
voicemail	ボイスメール
snowy	雪の|雪の多い
contextual	前後関係上の|文脈上の
teleconference	テレビ会議
wisely	賢く|賢明に|抜け目なく|賢明にも
neutrino	ニュートリノ
atrium	アトリウム|心房|房(ｃｆ|ventricle心室)
superficial	うわべだけの|表面の|平方の|皮相な|(息が)浅い
fret	腐食する|むしばむ|苛立たせる|いらだち|苦悩|稲妻模様|(雷文)浮彫り
cryptography	暗号法
tubular	管状の|尿細管の
cupboard	食器だな|食器棚|戸棚
ultrasonic	超音波の
intergovernmental	政府間の
croft	(屋敷続きの)小農園;(家畜数頭を飼育する程度の)小牧場|(小さな)小作地
coherence	首尾一貫性|首尾一貫
druid	ケルトの魔術士|(キリスト教化以前の古代ケルト族の)ドルイド僧
elliptical	楕円形の
dino	ディノ|恐竜(の)
burglary	夜盗行為|強盗|泥棒
flashback	(記憶などが)突然過去に戻る|(光が)照り返す
tributary	貢献者|属国|(川の)支流
scalp	頭皮|小利潤|(転売による)利ざや|人に恥をかかせる|戦利品
attire	に盛装させる|衣装
derrick	油井やぐら
respectful	敬意をもつべき
haiku	俳句|Japanese poem of seventeen syllables
ascend	のぼる|上る
yummy	おいしい|すてきな|素晴らしい
externally	外部から
fluffy	けばの
retardation	遅延|妨害
lyme	ライム病の|(lime果物のライム|lymeライム病|rhyme押韻)
solitary	孤独の|ひとりの|一人だけの|孤独な|めったに人の訪れない
bathtub	浴槽
pecan	(植物)ペカン|ピーカン(北米産ヒッコリーの一種)
confinement	限ること|限定|制限|監禁
perturbation	心の動揺|ろうばい|混乱|摂動
ado	骨折り|騒ぎ|騒動
orderly	秩序のある|整然とした|規律正しい|命令の|当番兵|(病院の)付き添い
chronograph	クロノグラフ(時間を図表として記録する装置)
sandstone	砂岩
everlasting	永久の
shawl	ショール|肩掛け|にショールをかける
citadel	とりで|城|より所
endocrine	内分泌の|内分泌腺
agony	苦痛|煩悶
fanny	(俗)お尻
polyethylene	ポリエチレン(系)|PE|エチレンが重合した|最も単純な構造をもつ高分子で|容器や包装用フィルムをはじめ様々な用途に利用される|合成樹脂化学の基本物質
bootleg	(酒などを)密輸する|密売(する)|違法の|不正な
ammo	弾薬(=ammunition)
slough	堕落のふち|泥沼|ぬかるみ|湿地
hearth	暖炉の前|炉|炉床|炉辺|家庭|火床
ruling	支配する|統治する|決定|判決|有力な|一般の|主たる|目下の
quadrant	四分円|象限
mantra	マントラ|真理を表す秘密の言葉|呪文|持論|主義|信念|モットー|スローガン
geophysics	地球物理学
microscopic	微視的な|顕微鏡でやっと見えるほどの
broccoli	ブロッコリ
delinquent	非行の|罪を犯した|怠慢な|義務を怠る|職務怠慢の|非行少年
linker	リンカー(モジュールのリンクを行なうプログラム)|linkage editor|link editor
embryonic	胚に関する|胎児の|胚の
ascent	上昇|昇進|上り
graceful	しとやかな|優美な|上品な|素直な
intimacy	仲の良い|親密|親しい|個人的な|私事の|精通した
shellfish	貝
brink	瀬戸際|縁|頂|最高点|水ぎわ|水辺|間ぎわ
putter	(米語)ぐずつく|ぶらつく
nebula	(複数形)nebulae|nebulas|星雲|尿の白濁|角膜片雲
epsilon	(第5ギリシア文字)エプシロン|Ε|ε|(電算)極微量
salinity	塩分|塩度
exhaustive	徹底的な|網羅的な|枯渇させる|消耗的な
astrophysics	天体物理学|宇宙物理学
windmill	風車|かざぐるま(=pinwheel)
conceive	考える|思い付く|想像する|妊娠する
eject	追い出す
inferno	地獄(のような光景･場所)
devotional	信心の|礼拝の|祈りの
meaningless	無意味な|目的のない|無益な|つまらない
negligible	とるに足らない|無視できる
moron	まぬけ|馬鹿|アホ|軽度精神薄弱者
hutch	ハッチ|檻
grub	掘り起こす|掘返す|地虫
prong	(フォークなどの)とがった先|(フォーク|角などで)刺す|貫く
mentality	心情|知力|知性|心理|思考方法
axel	axle|車の車軸|アクセル(=acceleratorスケートのジャンプ)
expandable	伸び得る|拡張できる|発展性の
censor	検閲する|検閲官|批評者|非難者|潜在意識の抑圧
bourne	(=bourn)細流|小川
distract	(気持ち･注意)をそらす|迷わす|心をかき乱す
slender	ほっそりした|不十分な|細長い|わずかな|薄弱な
reliably	確実に
bartender	バーテン(=barman|UK英)|(bar+tender(世話人))
multidisciplinary	多くの学問領域にわたる
relapse	退歩|ぶり返す|再び陥る|(病人が)再び悪化する|逆戻りする
ventricular	心室の
singleton	一つづつ起こるもの|別物|(トランプ)一枚札(の手)
evoke	呼び出す|(記憶など)を呼び起こす|(感情･記憶などを)呼び起こす
villager	村人|田舎の人
signify	を意味する|を示す
rapport	調和|調和する
transferable	譲渡可能
loco	ロコソウ(有害な豆科植物)|ロコ病(家畜の脳病)
frown	顔をしかめる|難色を示す|眉をひそめる|しかめ面|不満|怒りを表す
husky	殻の(多い)|しゃがれ声の|(声が)ハスキーな|がっしりした(人)|ハスキー犬(Siberian husky)
paycheck	給料支払小切手|給料
bland	人当たりがよい|穏やかな|当たり障りのない
rouse	の感情を高ぶらせる|の目をさまさせる|人を奮起させる|目を覚ます|起きる|覚醒|激励者
yup	yes|ヤップ|ヤッピー(young urban professionals|Yup)
fixation	定着
foreground	(風景･絵画の)前景|最前面|表面|最も目立つ位置
abigail	腰元|侍女
disgust	に嫌気を起させる|嫌にならせる|嫌悪感|嫌悪
lighten	の色を薄くする|軽くなる|明るくなる|を喜ばせる|楽になる|晴れ晴れする|軽減する|明らかにする
viscosity	粘度
immunoglobulin	免疫グロブリン|炎症や悪性腫瘍がある際血液中に増加し|免疫の中で大きな役割を担っている
counterfeit	にせもの|にせ札|偽造品|偽造する
outlay	経費|支出
terminus	(複termini) 終点|終着駅(=terminal)
fibrosis	繊維症|繊維形成|線維症
braid	組ひも|さなだひも|飾りモール|三つ編み(の髪)|編んだ髪|おさげ(ひもや髪を)編む
pluck	を引き抜く|(羽を)むしり取る
marten	テン(の毛皮)
fungus	(複数形)fungi|真菌類|菌類|かび(mushroom|toadstool|mildew|moldを含む)
wrestler	レスラー|レスリング選手|組み打ちする人
swat	ぴしゃりと打つ
impede	妨げる|邪魔する
parametric	パラメーターの
kickoff	キックオフ|開始
sweetie	甘いもの
flatware	皿類;(特に)銀食器
torment	に肉体的苦痛を与える|を困らせるを苦しめる|を悩ます|苦労の種|苦痛|苦悩|拷問
parenthood	親であること
anarchist	無政府主義者
hitter	打者
morph	変形する|形態を変える(morph|morphing)
lobe	耳たぶ(earlobe)|丸い突出部|(解剖)脳葉|肺葉|肝葉など|(植物)葉などの裂片
sable	黒貂|クロテン(の毛皮)
outset	手始め|発端
doubtful	あいまいな|疑わしい|不確かな
inflow	流入|流入物|流入量|受領される|流入する
consultative	相談の;諮問の
insecure	不安な
simmer	今にも爆発しようとしている|ぐつぐつ煮える
divert	方向転換する|転換する|転送する|(注意など)をそらす
elasticity	弾性|弾力性
unload	(荷を)おろす|から積み荷をおろす
normative	規範的な
spade	スペード|踏鋤(すき)|鋤
longtime	積年の|長い間の|長年の
versatility	多用途性
fem	female|feminine
intricate	複雑な
crore	1000万(=100lakhs)
repression	抑圧|弾圧|抑制|制止|(抑圧された)感情
kudos	名声|栄誉|威信|賞賛
vim	精力|気力|活力
rivalry	競争|対抗|競走
irrespective	に関わりない
poo	うんち(幼児語)
incubation	孵化
orchestral	オーケストラの|オーケストラ的な
microfilm	マイクロフィルム
artifact	加工品|人工物|工芸品
topography	地形学|地勢学
locust	イナゴ|バッタ|セミ(cicada)
goalie	ゴールキーパー
tangent	接する|接線の|接線|接面
afterward	あとで|後に
elusive	理解しにくい|わかりにくい|密やかに暮らす
speculative	投機的な|理論的な|推論的な|思惑の|危険な
geologic	地質学の
whey	乳汁の水分|乳しょう