television	テレビ
membership	会員資格|一員であること|会員数|会費|会員|メンバーシップ
pressure	圧力|圧すること|押すこと|圧縮|圧搾|電圧|苦難|苦痛|(するように)圧力をかける
stone	石材|石|小石
normal	普通の|平均的な|標準の|典型的な|平均値
advance	前進|進歩|前進する|を前進させる
accept	受け入れる
football	フットボール(ラグビーやサッカーの総称)
promote	を促進する
instead	その代わりに
permit	を許す|認可(書)|免許(証)
lawyer	弁護士|法律家
entire	全部揃った|全部の|全体の|まったくの
educational	教育上の
cook	(を)料理する|料理人|コック
fitness	適当|健康
partner	パートナー|仲間|共同出資者|相棒|と提携する
gain	もうける|得る|を増す|利益|増加
republic	共和政体|共和国|～団体|～社会
improvement	進歩|改善
jump	跳ぶ|急増する|飛びかかる
boat	船
likely	ありそうな|しそうな|思われる|適当な|有望な|起こりうる
patch	つぎはぎ|継ぎ|傷当て|あてをする|に継ぎを当てる|を継ぎ合わせて作る
debt	おかげ|恩義|借金|負債|借り|債務
exercise	を訓練する|影響を及ぼす|権利を行使する|課題|実行|運動|体操|練習|稽古|学課|機能試験|動作試験
morning	朝|午前
wear	身につけている
faculty	能力|才能|教授団|機能
publication	出版|出版物|発表
photography	写真術|写真撮影(業)
multi	マルチ(の)
feed	にエサをやる|を養う|エサを食う
achieve	を達成する|を完成する
variety	多様性|変化|多種|変化に富むこと|相違|種類
election	選挙
assistance	援助
fair	公正な|合法的な|有望な|平均の|きれいな|まっすぐ|快晴の
father	父
path	小道|通路|細道|散歩道|進路|方針
chemical	化学作用による|科学薬品|化学の|化学薬品
apple	リンゴ
concept	概念|構想
northern	北部出身の|北の|北から吹く|北部方言
cup	カップ|茶わん
pacific	平和的な|平和を好む|穏やかな|平穏な
mini	ミニスカート|小型のもの
winter	冬
laptop	ひざ置き型の|小型で携帯可能な|ラップトップの
dark	暗い
behind	〜の後ろに
aim	をねらう|めざす|目的|意図|purpose
train	列車|訓練する
hire	賃貸しする|雇う|賃借りする|借り賃
core	のしんを抜く|磁気コア|中心|核心
yourself	あなた自身
column	コラム|特別記事|囲み記事|論説|欄|支柱|縦の行
prevent	させない|を妨げる|を防ぐ
outdoor	戸外の
transport	を運ぶ|を夢中にさせる|輸送|輸送機|運搬|運送|囚人護送船|輸送機関
internal	本質的な|内の|内部の|体内の|内在的な|国内の
fuck	性交する(卑語)
otherwise	別のやり方で|さもなければ|その他の点では
signal	信号(を送る)|合図(する)
youth	若者|若さ|若いひと|青春時代
except	〜を除いて
transportation	配送機関|運輸|運搬手段
mm	ミリメートル|millimeters
cock	オンドリ(自惚れた動物の象徴)|(水道などの)蛇口|コック
correct	訂正する|正しい
politics	政治|政治学|政策|政務|政略
representative	駐在員|Rep|下院議員
route	の道順を決める|道|通路|路線|ルート|経路
argument	議論|主張|引き数(=parameter)
define	定義する|定める
lord	君主|貴族|(大文字で)～卿|支配者|神|領主|主人|権威|威張る|おやまあ
minister	大臣|公使|聖職者|召使い|仕える
evaluation	評価額
pretty	きれいな|かわいい
unless	もし〜でなければ|〜でない限り
presentation	提出|示された状態|贈呈|呈示|献呈|進呈|贈呈品
mine	わたしのもの|鉱山|炭鉱|(a diamond mineダイヤモンド鉱山)|機雷|地雷
expand	を拡大する|増大する|膨張する
medium	媒体|中ぐらいの|中間の
flat	平らな|きっかり|階
edge	刃先じりじりと追いやる
maintenance	メインテナンス|維持|主張|整備|保守管理
maybe	たぶん|ひょっとすると
attempt	を試みる|襲う|企てる|企画|試み|攻撃
economy	経済|経済組織|節約
capacity	引受能力|容量|力量|収容能力|資格|収容力|地位|容積|耐荷重
recommend	を推薦する|を勧める
fat	太った|肥満(者)|脂肪|脂身|脂質
southern	南方の|南の|南へ行く|南からの
chance	機会|可能性|偶然
merchant	商人|小売商人|取引先|商業の|(俗)～狂
temperature	温度|気温|寒暖|体温|熱|気質
ride	に乗る|に乗っていく
remote	人里離れた|遠い|遠く離れた|隔たって|関係の薄い|へんぴな
etc	その他
visual	視覚の|視力の|目に見える
progress	前進する|進行|前進|進歩|発展|向上|普及|進む|進歩する
square	正方形(の)|四角(の)|平方(の)|きちんとした|公平に|広場|公園|を適応させる
incest	近親相姦
poor	貧しい|かわいそうな
diet	国会|議会|正式会議|食品|食餌療法|規定食|ダイエット
minimum	最小限度|最小限|最低限
benefit	利益|ためになる|恩恵|便宜|給付|給付金
workshop	職場|仕事場|作業場|研修会|講習会|工場
campus	キャンパス|校庭
throughout	〜のいたるところで
platform	(党の)綱領|主義|プラットホーム|演壇|教壇|乗降口|壇|政策の基本プラン
waste	を浪費する|浪費|廃棄物
itself	それ自身
fee	手数料|料金
bird	鳥
crime	犯罪|罪
virtual	事実上の|実質的な|虚像の|仮想の
wire	針金|金属線|電信|電報|を針金で結ぶ|に電報を打つ
external	外の|外部の|外側の|外用の|形式的な|外見|外面|外部
gear	装備|道具|歯車|ギア
implementation	実行|完成|履行
delete	削除する
min	分
complex	コンプレックス|強迫観念|固定概念|合成物|複合体|コンビナート|総合ビル|複合の|複雑な
rise	上がる|のぼる|起こる
installation	装置|設備|軍事施設|基地
steel	スチール|好敵手|鋼鉄|剣|硬さ|鋼製
separate	切り離す|を引き離す|を区分する|別個の|個々の
import	を輸入する|輸入|輸入品
wrong	まちがった|故障して|具合が悪い
sub	潜水艦|補欠
fashion	ファッション|流行|はやり|方法|やり方|つくり|種類
chief	重要な|係長
diamond	ダイヤモンド(4月の誕生石)|ひし形|(トランプ)ダイヤ(の札)|(野球)内野|球場
cycle	周期|周波
village	村|村落
sequence	連続|続発|系列|連続(するもの)|結果|順序
launch	(新造船を)進水させる|発射する|始める|進水|発射|打ち上げ|艦艇大型ボート|ランチ
enhance	向上させる|(質･能力)を高める|増す
reserve	を取っておく|を予約する|蓄え|遠慮
dress	に着物を着せる|衣服を着る|正装する|ドレス
permission	許可
assist	列席する|手伝う
secretary	秘書|書記|長官|書記官
civil	市民の|ていねいな|礼儀正しい|国家の|文明の
duty	任務|義務|本分|職務
branch	枝|枝状のもの|部門|分野|支店|枝を出す|分化する|拡張する
truck	トラック|運搬者|手押し車|トラックの|交換する|取り引きする
electric	電気の
dry	乾燥した|無味乾燥な|面白くない|退屈な|乾かす|辛口の(酒)|(俗)禁酒
flag	旗で信号する|しおれる|衰える|薄らぐ
exist	存在する
lab	研究所|laboratory
sleep	眠る
cruise	周遊観光船|航行する|巡航する|歩き回る
writer	筆者|著者|作者
coast	沿岸|海岸|順調に進む|海岸に沿って航行する|惰性で動く
touch	に触れる|手触り
finally	ついに
detail	詳述する|列挙する|細部|詳細|詳説|建築の細部
adventure	冒険|投機
fail	失敗する|失望させる|しくじる|不足する|欠乏する|期待を裏切る
unknown	未知の|知られていない|未経験の|計り知れない|未知の人
participate	参加する|加わる|の気味がある
worth	値打ちがある|に値する|価値|相当量の|財産
spend	お金を使う|(時)を過ごす
phase	局面|相|段階|1つの姿|面|位相|を段階的に計画する
musical	音楽の|音楽的な|音楽好きの|ミュージカル映画
concern	関心を持つ|重要である|影響する|関心ごと|事件|心配|関連|重要性
skip	(授業を)さぼる|スキップする|はね回る|軽く跳ぶ|縄跳びをする|を軽く跳び越す
fully	すっかり|完全に|全く|十分に|まるまる
dead	死んだ|死んでいる|活気のない
describe	(言葉で)説明|描写する
judge	を判断する|を裁判する|裁判官|審判員
restaurant	レストラン
profit	の利益になる|恩恵を受ける|(金銭的)利益|収益|利潤|得
currency	通貨|流通|通用すること|流布|貨幣
explore	を探検する|を探求する
bottom	根拠とする|基づく|水底|船底|根底|下部|下側
vision	視力|視覚|見ること|幻|想像力|先見の明|見通し
handle	をあつかう|にさわる|取っ手
teacher	先生
worker	労働者|肉体労働者|仕事をする人|研究者|働きバチ|勉強する人
essential	非常に重要な|必須の|絶対必要な|エキスの|不可欠の|本質的要素|要点
moment	瞬間|時期|重要性
peace	平和
traditional	伝統的な
fiction	想像|小説
competition	競争
motion	動き|運動|動作|動議|合図する
avoid	を避ける
creative	創造力のある|創造的な|独創的な
proposal	申し込み|提案|プロポーズ
designer	デザイナー|設計者
icon	聖像|像|肖像|イコン|偶像|アイコン
campaign	キャンペーン|運動|軍事行動|政治運動|競争|作戦行動|従軍|勧誘|遊説(する)
wife	妻
replace	に取って代わる|を取り替える|(=take the place of)|をもとの場所に戻す
contribute	に貢献する|の一因となる|寄付する|提供する