hydroxy	ヒドロキシ|ハイドロキシ|水酸化(である状態)
petal	花弁|花びら
mapper	a clerk who marks data on a chart
uneasy	心許ない|不安な|心配な|楽でない|窮屈な
infidel	信心しない|異教徒の
shalom	シャローム(ユダヤ人のあいさつ･別れの言葉)
dynamo	ダイナモ|発電機|精力的な人
shipwreck	難破(船)|挫折|難破する
truce	中止|中断|休戦|停戦|停戦協定
buyout	買い占め
taunt	あざける|なじる
spew	吐く|噴出する|にじみ出る|反吐(ヘド)
ebb	引き潮|衰退|干潮|減退|衰退期
defamation	中傷|名誉毀損|悪口
proteomics	the branch of genetics that studies the full set of proteins encoded by a genome
daredevil	がむしゃらな人|向こう見ずの人|命知らず|向こう見ずな|命知らずの|無謀な
fiend	悪魔(=devil|daemon|Satan|fiend)
numerically	数値的に
decoy	おとり|囮
hilbert	ヒルベルト
sexton	寺男|会堂管理人|墓掘り男|(ユダヤ教)堂守
coercion	威圧|強制
expend	金銭を使い果たす|使い果たす|消費する|時間を費やす|労力を浪費する
mindful	気をつけて|忘れないで
hitherto	これまで(は)|いままで
goalkeeper	ゴールキーパー
armament	軍備
circumference	周囲|円周|境界線
responsibly	責任を持って
bolivian	a native or inhabitant of Bolivia|of or relating to or characteristic of Bolivia or its people
downright	徹底的な|全くの|純然な|素直な|全く|率直な|完全な(に)
flatten	たいらになる|打ちひしぐ
sled	そりで行く|小型そり|そりに乗る
caprice	気まぐれ|きまぐれ|むら気|気まま
futurama	フューチュラマ|31世紀の地球を舞台にしたジオラマ|1939年ニューヨーク万博に展示され人気を博す|テレビアニメとして1999以降放送された
centerfold	(雑誌などの)2ページ見開き|折込みページ
marinade	マリネ|マリネに漬けた肉･魚|マリネに漬ける
prosthesis	人工的補助物(義足等)
spammer	大量の迷惑メールを送りつける人
quiver	おののく|震え|矢筒|揺れる|震える|を震わせる
echelon	段階|レベル
maturation	成熟
letterman	学校スポーツにおいてレター表彰を受ける運動選手
refractive	屈折の
grader	(合成語で)～年生
contentious	議論好きな|論争的な|異論のある|係争の
fairytale	童話
intercollegiate	大学間の|大学対抗の
zithromax	アジスロマイシン
dispel	追い散らす|追払う|払い去る|晴らす
snowball	雪玉(を投げつける)|雪だるま式にふくれる|カンボク
emancipation	奴隷解放|解放|解脱
duchess	公爵夫人|女公爵|公妃
captivity	捕われの身|監禁|捕らわれ
haw	サンザシ(の実)
distrust	信用しない|疑惑|疑う|不信
bravery	勇敢|勇気
hilltop	丘の頂上
wiccan	a believer in Wicca|of or relating to Wicca
sincerity	誠実|率直さ
hairless	毛のない
belonging	happiness felt in a secure relationship; "with his classmates he felt a sense of belonging"|happiness felt in a secure relationship
hydrolase	加水分解酵素
unchecked	チェックしない
latte	カフェ・ラッテ
regionally	地域的に
trample	踏みつけること|を踏む|踏みにじる
symbolize	を記号で表す|を象徴する
tradeoff	同時に満たしえない幾つかの条件の取捨についての考量|トレードオフ|交換条件|見返り
liturgical	礼拝式の
exogenous	外因性の|外来栄養の
daydream	白昼夢
apar	South American armadillo with three bands of bony plates
fluency	なだらかさ|流暢
heretic	異端者
quarrel	四角い鏃の付いた矢|紛争|口論|反目|不和|争う
conceivable	考えられる
parlour	応接室
flashpoint	一発触発の危機|引火点
breakaway	離脱(した)|分離(的な)
oneness	(思想・信念・目的などが)一つであること;同一性|単一性
glimmer	ほのかに見える|かすかな光|微かな光
renounce	要求を正式に放棄する|をやめる|捨てる|を否定する|を拒否する
incompatibility	両立しがたい(相反する)こと|性格の不一致
climber	登山者|はい登る植物(ツタなど)|出世主義者
recoverable	取り戻せる|元に戻せる|(体が)回復できる|全快できる
headband	ヘッドバンド
intellectually	知的に
wort	麦芽汁(ビールの原料)
lactose	ラクトース|乳糖
competitively	競争的に
microcomputer	マイコン|超小型コンピュータ
iol	a clear plastic lens that is implanted in the eye; usually done when the natural lens has been removed in a cataract operation|a clear plastic lens that is implanted in the eye|usually done when the natural lens has been removed in a cataract operation
spreader	バターナイフ|散布機
feral	野生の|野にいる|野生化した|野獣のような|凶暴な
neurosurgery	神経外科
guise	ふり|見せかけ|服装|変装
impatient	せっかちな|しきりに～したがる|～に耐えきれない
aquamarine	藍緑色|藍玉(緑柱石の一種|3月の誕生石)
oligonucleotide	オリゴヌクレオチドは20塩基対かそれ以下の短いヌクレオチド(DNAまたはRNA)の配列
readout	(コンピューターなどから)読みだした情報
sou	スー(フランスの5サンチームまたは10サンチーム銅貨)|つまらないもの
epitope	エピトープ|抗体が認識する抗原の一部分のこと
fright	恐怖|驚き
authorise	授権|認可|認許
confine	閉じ込める|制限する|監禁する|境界
physiotherapy	=physical therapy
laird	地主|人名
libel	誹謗する|名誉毀損
parka	パーカ|毛皮ジャケット
objectively	客観的に
billabong	a stagnant pool of water in the bed of a stream that flows intermittently|a branch of a river made by water flowing from the main stream only when the water level is high
calla	(サトイモ科)カラ|ミズイモ
tablecloth	テーブルクロス
pare	の皮をむく|(爪)を切る|を削り取る|を削減する
mitochondria	ミトコンドリア|mitochondrionの複数形|細菌・藍藻以外のすべての生物の細胞中に見られる糸状または球状の細胞小器官|呼吸に重要な働きをする
hoard	貯蔵(する)|買いだめ(する)
usmc	海兵隊|米国海兵隊
deflect	(思考など)をゆがめる|そらせる
arrhythmia	不整脈
cervix	頚部
barrister	バリスター(法廷弁護士) 
samoan	a native or inhabitant of the Samoan Islands|of or relating to Samoa or its people or language or culture; "Samoan fishing industry"|of or relating to Samoa or its people or language or culture
cremation	火葬|焼却
sewerage	下水設備;下水処理|=sewage
culvert	(道路･鉄道などの下を通る)カルバート|排水溝
mantis	かまきり(強欲|残酷の象徴)
sterilization	不妊にすること|断種(手術)|殺菌|消毒
ovation	熱烈な歓迎|大かっさい
carpal	手根骨の|腕骨の|腕骨
avenger	復讐者
sequencer	データまたはプログラムを決められた順序(シーケンス)に振り分けるハードウェア|ポリマー中のモノマーのシーケンスを決定する装置|他
undocumented	文書化されていない
poncho	ポンチョ|ポンチョ風のレインコート
pricey	金のかかる
gloomy	憂うつな|暗い|薄暗い|悲観的な|うっとうしい
encapsulate	カプセルに包む|(事実･情報などを)要約する
evacuate	避難する|撤退する|疎開する|立ち退かせる|明け渡す|避難|退去|撤退
wordnet	ワードネット|ワードネット|プリンストン・ワードネット|英語ワードネット
crackle	ぱちぱちいう音|ぱちぱちと音をたてる
nutritious	栄養の
marguerite	マーガレット(花の名|白菊)|人名
cautiously	慎重に
dressage	(馬の)調教|調馬
phylogenetic	系統発生の
gait	足並み|歩きぶり|足取り|歩調|歩行|歩様|進行
morbid	ゆううつな|病気の|病的な|憂うつな|恐ろしい|不健全な
emitter	放射体|エミッタ(トランジスターの電極)
rubble	破片|瓦礫
cheeky	頬のよく発達した|生意気な
arco	(of instruments in the violin family) to be played with the bow
proponent	提案者|弁護者|擁護者|支持者
barricade	妨害するもの|障害物|バリケード(を築く･で囲む)|戦場
truthful	誠実な|正直な|本当の
eastside	of the eastern part of a city e.g. Manhattan; "the eastside silk-stocking district"|of the eastern part of a city e.g. Manhattan
corsica	コルシカ|コルシカ
mammary	おっぱい|乳房の|乳房状の
talisman	護符|お守り|不思議な力のあるもの
rehearse	リハーサルをする|習熟させる|繰り返して言う
avionics	航空電子工学
roadrunner	ミチバシリ(北米産のホトトギス科の鳥;地上をよく走る)
minimization	最小化
linearly	直線的に
incarceration	監禁|投獄|幽閉
poignant	感動させる|するどい|痛烈な|心が痛む
troupe	一座|一団
punishable	罰すべき
placenta	胎盤
transpose	置き換える
salient	顕著な|突き出た|噴出する
bradbury	ブラッドベリ
disperse	分散させる|散らす|散乱させる|解散させる|分散する
walleye	角膜白斑;外斜視|(また walleyed pike)北米産の目玉の大きい淡水魚
selectivity	選択性
shorty	ちび|短い服|背の低い人|丈の短い
projectile	発射する
fluff	(ラシャなどの)けば|綿毛|ふわふわしたもの
fission	分裂|核分裂|(fission核分裂|fusion核融合)
cobble	(靴を)修繕する|急いで作り上げる|丸石(を敷く)
nth	n倍の|何番目か分からないほどの|最も新しい
prologue	プロローグ|前口上|序幕|序言
mammography	マンモグラフィ|乳房X線撮影法|撮影装置
scavenger	死肉をあさる動物|清掃動物|くず拾い|掃除人
ordeal	厳しい試練|苦しい試練|試罪法|神明裁判
hydroxide	水酸化物
communicable	伝達可能な
enzymatic	酵素による
submissive	服従的な|従順な
anew	再び|新規に
commandment	(神の)おきて|戒律
undetermined	未決定
yah	Yes|やあ-い
cochin	コーチン|アジア産の肉用の鶏
disproportionate	不つりあいな
bally	(UK英)ひどい
sawmill	製材工場|製材所|大型製材のこぎり
wither	しおれさせる|しぼむ|枯れる|衰退する|弱る
carving	彫刻物|彫刻(術)
gallant	勇ましい|勇敢な|雄々しい
exponentially	急激に|幾何学級数的に
dura	硬膜
recoil	しりごみする|はね返り|後座する|退却する|畏縮する|ひるむ|跳ね返る|反動する
boomerang	ブーメラン|やぶへびの議論(攻撃)|投げた人の所へ戻る
meow	ネコが鳴く|ニャー|猫の鳴き声
canteen	食堂|売店|食品売店
serenade	セレナーデ(を奏する･歌う･演奏する)
familiarize	親しませる|慣れる
hysterectomy	子宮切除
biologically	生物学的に
prepay	前払いする
venerable	尊敬に値する|神聖な|いわれのある
federalist	北部連盟支持者|連邦主義者|連邦主義
admirable	賞賛すべき|立派な
octane	オクタン(石油に含まれる炭化水素の一つ)
alb	アルバ(司祭がミサで着る祭服)
formalism	極端な形式主義|形式主義|形式論|形態心理学
brittle	壊れやすい|堅いがもろい|傷つきやすい|砕けやすい
girly	女の子らしい|(girlieは性的|蔑称的)
rationality	純理性|合理性
politely	ていねいに|礼儀正しく|丁寧に
soapbox	石鹸を詰める木箱|(街頭演説のための)演壇用の箱
ingenious	工夫に富んでいる|器用な|精巧な|独創的な
revel	大いに楽しむ|享楽する|凝る|酒盛りをする
insole	靴の敷き皮
mascara	マスカラ|まつげ染め
artichoke	朝鮮アザミ|アーティチョーク(食用)
elongation	延長|延長線|伸び|伸長|離角|離隔
torsion	ねじれ
madman	気違い|狂人
blunder	不注意な失敗|大失敗(する)|つまずく|やり損なう
albumin	(ælbjúːmən)アルブミン|可溶性たんぱく質の総称|血清アルブミン|卵アルブミン|乳アルブミンがある|グロブリンと共に2種の血漿タンパクの1つ|アルブミン濃度は肝機能の指標
banshee	家族に死人のでることを泣いて予告する女の幽霊
sari	サリー|インド･ネパール･スリランカ･バングラデシュ･パキスタンなど南アジア地域の女性が着用する民族衣装
somatic	(精神に対し)身体(上)の|肉体の
summation	合計(すること)|要約
blemish	傷つける|欠点|汚点|にきび|吹き出物
antiviral	抗ウイルス薬
absorbent	吸収できる
prelim	予選|予審|下検分|予備試験
hiatus	(空間の)隔たり|(時間の)空白|隙間|切れ目|割れ目|ひび|中断|休止|欠落
enrol	入れる
publicize	を公表する|宣伝する
spurious	偽の|私生児の|もっともらしい
gloom	薄暗くなる|暗がり|薄暗がり|陰気|沈んだ様子
aikido	合気道
angelic	天使のような
astrological	占星術の
nobility	高貴の生まれ|高潔さ|貴族
noncompliance	違反
ashore	岸に|浜に|陸上に
swimmer	泳ぐ人
raccoon	アライグマ
linotype	ライノタイプ(タイプライター式に活字を打ち出す機械;商標名)
marge	マーガリン|(人名)Margaretの省略形
goliath	移動式大起重機|ゴリアテ(Davidに殺されたペリシテ族の巨人)|巨人|力持ち
wanderer	歩き回る人|さまよう人|放浪者|さすらい人|邪道に踏み込んだ人|歩き回る動物
thrush	鵝口瘡(がこうそう|カンジダという真菌により舌やほおの粘膜に白い斑点ができる病気)|ツグミ(鳥)
legislate	法律を制定する
stringer	(鉄道の)まくら木|縦げた
deliverable	配送品|配達可能な|到達可能な
badness	正しくないこと|悪いこと|正常でないこと|不正確なこと
vulgate	(the V～)(4世紀末翻訳されたラテン語訳聖書)ウルガタ(の)|(v～)定本|(the v～)俗語|非標準語
westerly	西の|西方への|西からの
baritone	バリトン(歌手)|男声中音|(次の順に高くなる|bass|baritone|tenor|alto(女声)|treble(女声soprano)
lakeshore	湖岸
herr	ハー|ハー
wok	中華鍋
sorcery	魔法 
repel	に抵抗する|を追い払う|を押し返す|を拒絶する|はねつける|追い払う|はじく|いやがらせる|反発する
edema	水腫|浮腫
confidently	確信して|自信を持って|大胆に
blackbird	ブラックバード
restrain	抑制する|を押さえる|を制止する|防止する
dangerously	危険なほど
carotid	頚動脈
scraper	どろかき|こする人|スクレーパ
childish	子供らしい
janitor	(学校や施設の)用務員|管理人|門番
quickie	急いでする行為|急ごしらえのもの|ウイスキー一口|短時間のセックス
priesthood	司祭職
jagged	ぎしぎしした|ぎざぎざの|鋸の歯のような|凸凹の
aster	キク科のシオン属の植物|星状体
dispersal	散乱|分散|離散|伝播
overt	明白な|公然の|あからさまの|表立った
verbally	言語で|に関して
complexion	形勢|外観
supercomputer	スーパーコンピューター
chenille	シュニール|シュニール糸|シュニール織物|(芋虫から紡いだ毛虫糸)
dehydration	脱水症状
undeclared	(課税対象物品が)税関未申告の|(戦争など)宣戦布告なしに
mow	刈る|干し草の山
burrito	ブリトー(肉・チーズなどを小麦粉のトルティーヤで包んだメキシコ料理)
cliche	(陳腐な)決まり文句|月並みな考え
incompleteness	不完全
dearly	愛情を込めて
suggestive	思わせぶりな|示唆的な
sedimentation	沈降
optometry	検眼|視力測定
attendee	出席者
gypsum	石膏|硫酸カルシウム(CaSO4)|(=plaster)
baroness	男爵夫人;男爵にあたる女性の爵位
winning	決勝の|勝利|勝った
handshake	握手
transponder	トランスポンダー(特殊信号を受け|自動的に返信するように設計された電気機器)
imaginable	想像できる|考えられる
dawg	仲の良い友達
dystrophy	栄養失調|異栄養(症)|ジストロフィー
kingfisher	カワセミ 
predatory	略奪する|肉食(性)の
descendant	子孫|後裔
instalment	=installment
dupe	だます|かつぐ
dismal	気味の悪い|陰気な|陰欝な|暗い|憂欝な
cirrus	絹雲(けんうん)
kilometer	キロメートル
topple	倒れる|ぐらつく|倒す|よろけて倒れる
progeny	結果|子供たち(children)|子孫(offspring)|後継者|直系の人(the immediate descendants of a person)
ellipse	長円形|楕円(だえん)
arboretum	植物園|樹木園|森林公園
corrosive	腐食させる|腐食性の|皮肉たっぷりの|腐食剤
neuropathy	神経障害
dammit	くそ|こんちくしょう
rollback	統制による物価･賃金･利率引き下げ政策
choker	首飾り|カラー|短いネックレス
jazzy	ジャズ的な|ジャズ風の|狂騒的な|活気のある|はでな
cantor	主唱者|先詠者|先唱者|独唱者|朗詠者
boron	硼素(ほうそ)(非金属元素;化学記号は『B』)
reluctantly	しぶしぶ|いやいや
stoop	かがむ|腰が曲がる|を曲げる|品位を落とす|ポーチ
jetty	突堤|防波堤|桟橋|pier|漆黒の
saute	(仏語)ソテー(にした･する)(にする)|少量の油で強火でいためること･またはその料理
centrifugal	遠心性の|遠心的な
authorship	著述業
piercing	ピアスをする|つんざく|大声の|甲高い|骨身にこたえる|洞察力のある
mallard	マガモ(の肉)
craving	渇望|切望|have a craving for chocolate(欲しくてしかたがない)
hitman	a professional killer who uses a gun
decidedly	明らかに|議論の余地なく
apathy	無感動|感情鈍麻|無関心|冷淡
mercantile	商業の|商人の|重商主義の
orphanage	孤児院|孤児
rectifier	整流器
islet	小島|非常に小さい島|隔絶されたもの･場所
bearded	あごひげを生やした|かぎのついた
cytokine	サイトカイン
greasy	グリースを塗った
tactile	触覚の|触覚を有する
cinematography	映画撮影術|映画撮影法
carnage	大虐殺|殺戮
skier	スキーヤー
ingenuity	発明の才|創意|独創性
histone	真核生物のクロマチン(染色体)を構成する主要なタンパク質
ischemia	虚血
snug	(場所･人が)暖かく心地よい|気持ちのいい|快適な|こざっぱりした|こぎれいな|ぴったりあった|(収入が)ささやかながら不自由しないだけの
diverge	分岐(する)|(意見などが)異なる|相違|逸脱
hibiscus	ハイビスカス
rheumatology	リウマチ学
rattan	トウ|籐
waterbury	ウォーターベリー
peruse	を精読(熟読)する|を読む|をよく調べる
panhandle	フライパンの柄
hectic	興奮した|熱狂的な|(仕事などが)非常に忙しい
exhibitionist	自己顕示欲の強い人|露出狂
subliminal	意識下の
enchantment	魔法
calmly	静かに
transferase	トランスフェラーゼ|転移酵素|付加酵素
horribly	恐ろしく
rut	轍|細長いくぼみ|定例|発情|さかり|性的に興奮する
pry	てこ|(てこなどで)動かす|覗く
tylenol	タイレノール|ジョンソン・エンド・ジョンソン社が販売する解熱鎮痛剤
gaseous	ガスの
displace	取ってかわる|免職する
tremble	震動する|(体が)震える|身震いする|おののく|揺れ動く|そよぐ|おののき
frisbee	フリスビー
zephaniah	a Hebrew minor prophet of the late 7th century BC|an Old Testament book telling the prophecies of Zephaniah which are concerned mainly with the approaching judgment by God upon the sinners of Judah
plethora	過多|過度|(a plethora of problems多くの問題)|(医学)多血症|赤血球過多症
rejoin	に再会する|再結合する|応答する
cabriolet	1頭立て2人乗りほろ馬車
wiretap	盗聴する
pang	発作|激痛|心の痛み
sherpa	シェルパ(山の案内人|荷の運搬人)|国際会議の裏方を務める官僚
signer	署名者
retiree	引退者|退職者
anthropological	人類学(上)の
stork	コウノトリ
homebrew	自家醸造ビール
stereotype	ステレオタイプ|鉛版|を定型化する
escalade	an act of scaling by the use of ladders (especially the walls of a fortification)|climb up and over; "They had to escalade canyons to reach their destination"|climb up and over
edd	ed.d.
concurrency	同時実行|同時実行
machinist	機械工
biologic	生物学(上)の|生物学的な|血がつながった|実の
disqualification	失格
situational	場面の|状況倫理の
phonebook	電話帳
inactivity	活動してない|無活動
grassy	草でおおわれた|草のはえた
billionaire	億万長者
clumsy	無器用な|不格好な|不器用な
slander	悪口|中傷|を中傷する|名誉毀損
ascendant	上昇する
sorta	(sort of)|いくらか|(類似語 kinda)
biosphere	バイオスフェア|生物圏|生活圏
federalism	連邦主義(制度)
manipulative	整体の
spaceship	宇宙船
sarcasm	皮肉|当てこすり
colitis	大腸炎
unincorporated	組み込まれていない
parchment	羊皮紙|羊皮紙文書|卒業証書
cryogenic	低温貯蔵
homologous	相同の
aversion	大嫌い|嫌うこと|嫌悪|反感
uphill	上方に向かって|上り坂の|坂を上って|上りの|上向きの|困難な|骨の折れる|(反|downhill)
symptomatic	微侯となる
nuance	(仏語)ニュアンス(微妙な差違|陰影|色合い)
bipartisan	二党の|二派の|二大政党提携の|超党派の
rhodium	ロジウム(金属元素;化学記号は『Rh』)
preseason	シーズン前
spitfire	スピットファイアー|火を吐くもの|癇癪持ち
rejuvenate	若返らせる|若返る|(格式語)元気を回復させる
bahasa	インドネシア語
fuselage	(fjúːsəlὰːʒ)(仏語) (飛行機の)胴体|機体
ember	燃えさし|残り火
hoot	ホーホー鳴く|お笑い|冗談|(否定文で)ちっとも(at all)
windscreen	windshield 1
unfit	適当でない|不適当な|不向きな|不適当にする|無資格にする
flemish	フラマン語|フラマン語
requester	依頼者|請求者
subscript	下に書いた|下付きの(記号･数字･文字)|添数|添字
modernism	現代的思考(精神･特徴)|現代風|近代主義
loin	腰|(獣類の)腰肉
alienation	疎遠|疎外|遊離|疎隔|譲渡|遠ざけること
locket	ロケット(首飾りにつける) (飛ぶロケットはrocket)
reddish	赤みを帯びた
kodiak	コディアック羆
wye	the 25th letter of the Roman alphabet
hypnotize	催眠術をかける
hexadecimal	of or pertaining to a number system having 16 as its base
scissors	はさみ
flounder	あがく|もがきながら進む|じたばたして深みにはまる|ヒラメ
nematode	線虫
benevolent	慈悲深い
analyser	アナライザー|アナライザ|分析機器|分析計|分析器
manger	かいばおけ
housing	住宅|住宅供給|家|2保護するもの|覆い|馬衣|馬飾り
abate	の勢いを減らす|和らげる|やわらぐ|おさまる
limbo	不確定な状態|忘却|煉獄(地獄と天国の間にありキリスト教に触れる機会のなかった人が行くとされる)|リンボーダンス
eon	測り知れない長い年月|10億年|永劫　eons ago大昔(に)|ずっと前に
margarine	マーガリン|人造バター
anecdotal	逸話的な
accusation	告発すること|非難|告訴|告発
ischemic	虚血性の
scarecrow	かかし
steed	馬|軍馬
bisque	貝類･鳥肉･野菜のクリームスープ|2木の実のはいったアイスクリーム
grouse	ライチョウ|不平を言う|雷鳥の類
shears	large scissors with strong blades
decorator	装飾者
harmonious	調和の取れた|和声の|協和的な|調子のよい|調和した|仲のよい|むつまじい
leukocyte	白血球
modernisation	近代化|現代化
tuff	凝灰岩|すごい|抜群の
wisp	小さい束|の一片|小さくか細い人
symmetrical	均整のとれた|左右対称の|対称の|左右対称
modality	様相|法性
liberalisation	自由化|緩和
ornate	飾りたてた|華麗な
midwife	助産婦|産婆
odour	(UK英)香り|匂い|臭気|芳香|気配
appellee	被上訴(控訴)人
uniformed	制服を着た
multidimensional	多次元
veer	変える|変る
keg	小さい樽(small cask or barrel)|主にアルミニウム|鉄|木でできた円筒状の容器|小さい樽に入っている量
esophageal	食道の
neocon	a conservative who subscribes to neoconservatism
murmur	つぶやき|不平の声|かすかな音|ささやく|ざわめく
infraction	違反|違反行為
supple	をしなやかにする|柔順な|柔軟な|素直な|追従的な|曲げやすい
sativa	大麻
lawfully	合法的に
trademarked	(of goods and merchandise) labeled with proprietary (and legally registered) identification guaranteeing exclusive use; "trademarked goods"|(of goods and merchandise) labeled with proprietary (and legally registered) identification guaranteeing exclusive use
adjuvant	アジュバント|主剤に対する補助剤|補助薬|免疫増強剤|抗原増強剤|補助|補助療法の意
potable	(水)飲用に適した
antidepressant	抗うつ剤
heparin	ヘパリン|特に肝臓や肺に多くある抗凝血成分
bodywork	(車の)車体
girdle	ガードル|帯を締める
proline	プロリン|アミノ酸の一種
enclave	飛び領土|包領|(他民族の中に孤立する)少数民族集団|飛び地
swipe	大振りで打つ|強打する|盗む|かっぱらう|強打|大振り|がぶ飲み
tunic	古代ギリシア･ローマ人が着た膝上まで届く上衣
snoopy	こそこそのぞきまわる|せんさく好きの
commensurate	同じ大きさの|同量の|同一基準の|釣り合った|比例した
gab	むだ口を聞く
disbelief	疑惑
unqualified	資格のない
chlamydia	クラミジア|クラミジア
relativistic	相対性理論の|(物理で)相対論的速度の
dork	馬鹿|間抜け(卑語)
mantel	炉棚
jeweler	宝石職人
insecticide	殺虫剤
undisclosed	未公表
anima	(ラテン語)アニマ|魂|生命|息
embody	具体化する|統合する
rebuttal	反駁|反証
fanfare	ファンファーレ|虚勢
dido	ふざけ|おどけ|いたずら
unravel	(疑問が)解明する|明らかになる|(糸･謎)をほぐす
beak	(肉食鳥の)くちばし(=bill|beak|pecker|nib|neb)|(水差しの)飲み口|(カメなどの)口先
stepper	ステッパ|パルスモータ|ステッパ
chou	シュークリーム
revolve	回転させる
muzzle	沈黙させる|口止めする|(動物の)鼻口部|口輪|鼻|口輪をはめる|鼻づら|銃口
probationary	試用(見習い)期間の|執行猶予の|《米》仮及第の|仮進級の
fiche	=microfiche
juror	陪審員|juryの一員
scamp	悪漢
goggle	(〜に)目をぎょろつかせる|(〜を)目を丸くして見る《+『at』+『名』》|〈C〉(目を丸くした)凝視|《複数形で》ゴーグル(オートバイやスキーなどのときにかける防塵(ぼうじん)めがね
waite	ウエイト
shoemaker	くつ屋|靴屋
lingua	舌|舌状器官
antidote	解毒剤|対策|矯正手段
museo	美術館|博物館のスペイン語(およびラテン系言語)
monomer	モノマー(単量体)が少数結合した重合体がオリゴマー(oligomer)|ダイマー(dimer|二量体)|トライマー(trimer|三量体)|テトラマー(tetramer|四量体)等|多数の重合体はポリマー(polymer)
jackass	米国テレビ映画名|馬鹿|アホ
dampen	くじく|湿らせる|鈍らせる
gratefully	感謝して
divergent	互いに異なる|分岐する|それている
standoff	行き詰まり|deadlock|孤立|(試合など)引き分け|孤立して|離れている(こと)|よそよそしい(さ)
donut	ドーナッツ(米|donut)
libido	フロイド心理分析から|性欲|性衝動
fortnight	2週間
paseo	遊歩道
outburst	ほとばしり|(感情|ガスの)爆発|突発|噴出
diam	口径|差し渡し|差渡|直経|差しわたし|直径|渡り|径|差渡し|さし渡し
emigration	(国外への)移住|海外への移民|(集合的)移民
conscientious	良心的な|誠実な
endometriosis	子宮内膜症
ecclesiastical	教会の|聖職の
belvedere	見晴らし台|展望台|望楼
acetyl	酢酸を構成する有機基(CH3CO-)|アセチル基|アセチルと呼ばれる
basalt	玄武岩
boomer	(一時的な)人気者|熱烈なファン
deceit	詐欺
perinatal	周産期の
tangle	をもつれさせる|を紛糾させる|を罠にかける|けんかする|混乱|もつれ|ごたごた
creamer	クリームすくい取り皿|クリーム生成用冷蔵庫|クリーム入れ|クリーム分離器
mountainous	山の多い|山地の|山のような
rudder	かじ|方向舵
unforeseen	予知しない|不慮の
dachshund	ダックスフント(犬)
streptococcus	連鎖球菌
heathen	異教徒|異邦人|野蛮人|未開人
orthodoxy	正統
partake	加わる|参加する|の性質が幾分ある
trailblazer	先駆者|開拓者
placeholder	記入子|代理人|記入子
fatality	不幸|死亡(者数)|運命|致死(率)
kaleidoscope	万華鏡
recyclable	リサイクル可能な
baud	ボー|変調速度の単位
iguana	イグアナ
rigidity	頑固さ
bane	破滅(のもと)|死|悲嘆|苦悩
soulful	魂のこもった
authoritarian	権威主義の|独裁主義の|独裁主義者
rive	裂く|割れる
brig	奇形|奇人|熱狂者|麻薬常用者
spiel	(物を売ろうとして)まくしたてること
serendipity	思わぬものを偶然発見する才能|掘り出し上手
follower	随行者|信者
sequentially	連続して
roost	休み場所|(鳥が)とまり木にとまる|ねぐらにつく
provenance	起源|起こり|由来
trotter	速足で歩む人|人の足
intermission	休憩時間|中絶|中止|休止
alumina	アルミナ|礬土(ばんど)|酸化アルミニウム
tether	(牛･馬などをつなぐ)つなぎなわ(鎖)|(能力･財力･忍耐などの)限界|範囲
indenture	契約書|証書|年季奉公をする
ary	ary|(接尾辞)|…の|(人|場所)の意味の形容詞･名詞を作る
dysfunctional	機能不全の
bulletproof	防弾の
pique	(自尊心を傷つけられての)立腹|不機嫌|out of pique|腹立ちまぎれに|(動詞)怒らせる|I was piqued by her refusal|断わられてしゃくにさわった
flue	引き網|煙突|排気筒
stenosis	狭窄症
acadia	the French-speaking part of the Canadian Maritime Provinces
reciprocity	互恵主義|再保険交換(保険用語)
ventilator	換気するもの|換気扇|換気窓|送風機
opportunistic	日和見主義の
pantheon	パンテオン
streamer	流れるもの|吹き流し|飛行機雲|飾りリボン
facelift	美容整形術(を行う)|(部屋･建物の)化粧直し|改装(をする)
pedicure	ペディキュア|足治療|足治療医|にペディキュアを施す
oscilloscope	オシロスコープ(電気の変化を曲線で観測する装置)
discontent	不満な|不満
perseverance	忍耐|根気強さ
overpayment	払い過ぎ
catalonia	カタロニア地方
pharmacological	薬理学(薬物学)の
adversity	不幸|逆境|困窮|不幸なできごと|災難
telemedicine	遠隔治療
yorktown	ヨークタウン|ヨークタウン
curfew	夜間外出禁止令|門限
rook	不当な代金をとる|ぺてん師|ミヤマガラス
academically	学究的に
conqueror	征服者
retardant	緩速剤(化学反応速度を減じる物質)|遅らせる
buildup	(兵力･体力･産業)増強|強化|(資材)蓄積|(物語)盛りあがり|交通渋滞
chiffon	シフォン|絹モスリン|婦人服の飾りレース
agreeable	好ましい|矛盾のない
centrum	椎体|中
armory	兵器工場
blackmail	脅迫|恐喝|ゆすり|武力による脅し
bennington	ベニントン
fathom	の水深を測る|推し量る|見抜く
borrowing	借金|借りること|借用語
hrt	hormones (estrogen and progestin) are given to postmenopausal women; believed to protect them from heart disease and osteoporosis|hormones (estrogen and progestin) are given to postmenopausal women|believed to protect them from heart disease and osteoporosis
palazzo	豪壮な公建築物(個人邸宅)|宮殿|殿堂
figurative	比喩的な(=metaphorical)
checkbook	小切手帳
chromatin	染色質(細胞核にある染色しやすい物質)
sulfide	硫化物
panzer	(ドイツ軍の)装甲車|戦車
mezzanine	中二階|中二階さじき席|中2階
toot	警笛を鳴らす|(ラッパを)吹く|飲み騒ぐこと|(俗)コカイン(の吸入)
wabash	ウォバシュ
chronologically	年代順に
indemnification	賠償(金)|補償(金)|保証|弁償|免責
mmol	ミリモル(=millimole)|濃度を表す方式|溶液1L中の溶質をモル数を使って表した単位が1mol/Lで|その10(-3乗)mol=1mmol
stimulator	刺激装置
axon	(解剖)軸索(アキソン)|軸索突起(神経細胞から伸びた突起|細胞本体から神経衝動を伝える)
vendetta	復讐|長期にわたる不和|抗争|かたき討ち
wherefore	それ故に
unpopular	人気のない|不評判の|はやらない
apportionment	分配|配当|下院議員数(連邦税)の州割当て
lifeguard	監視員|救護員|護衛(者)|親衛隊|水泳場の看視員|排障器|lifeguardとして勤める|の生命を守る
beowulf	the legendary hero of an anonymous Old English epic poem composed in the early 8th century; he slays a monster and becomes king but dies fighting a dragon|the legendary hero of an anonymous Old English epic poem composed in the early 8th century|he slays a monster and becomes king but dies fighting a dragon
sneaky	卑劣な|卑怯な
undiscovered	未発見
coda	コーダ|(楽曲･楽章)終結部
boson	any particle that obeys Bose-Einstein statistics but not the Pauli exclusion principle; all nuclei with an even mass number are bosons|any particle that obeys Bose-Einstein statistics but not the Pauli exclusion principle|all nuclei with an even mass number are bosons
synthetase	合成酵素
spatially	空間的に
detract	(評判･価値など)を減らす|落す|悪く言う|減ずる
delft	デルフト焼き|スズ釉の彩色陶器|白地に青の模様のものが多い
pram	(主に英･口語で)乳母車(=stroller)|PRAM（パラメータRAM|Apple社のMacシリーズ内蔵の半導体メモリ)
boswell	ボズウェル|ボズウェル
marginally	わずかに|限界的に
prostaglandin	プロスタグランジンは|プロスタン酸骨格をもつ一群の生理活性物質|強い生理活性を持つ
communicative	話し好きな
grunge	不潔なもの、汚いもの|（ファッションで）グランジ (わざと汚れた感じにする); グランジロック (わざと汚い格好で演奏する：シアトル発祥・音も汚いです：Nirvana、Pearl Jamなどが代表)
chastity	純潔|貞節|上品|簡素
curio	骨董品(=antique)
carney	見せ物|carney complexカーニー複合(遺伝子関連用語)|異なる遺伝子の突然変異により発生する
sheepskin	羊皮(の服)|羊皮紙|卒業証書
stoner	an attacker who pelts the victim with stones (especially with intent to kill)
unify	統一する|一様にする
obnoxious	嫌いな|いやな
diligently	勤勉に|念入りに
throwback	時代遅れ
glam	(=glamour)魅力的な|グラマーな
marvellous	驚くべき|不思議な|素晴らしい|驚嘆すべき
groin	(解剖学)鼠蹊(そけい)|腿の付け根
reinvent	改革する
sideshow	小事件|余興
illogical	非論理的な|不合理な
stinger	刺す動物･植物|(動物の)針|とげ|(植物の)刺毛|痛撃|皮肉
sneaker	スニーカー|卑劣な人
cartwright	カートライト|車大工
minimalist	(政治権力･目標を)最小限に抑えようとする人
touchscreen	タッチスクリーン
cellulite	lumpy deposits of body fat especially on women's thighs etc.
esquire	人にesquireの敬称を使う|殿|様|同伴する男
pacemaker	歩調調整者|脈拍調整器
orbiter	オービター|巡回するもの|人工衛星
lodging	に下宿する|宿泊|下宿屋
elucidate	明らかにする|はっきりさせる|解明する|説明する
thc	テトラヒドロカンナビノール
carburetor	気化器(エンジンの)
cartography	地図製作[法]
layman	信徒でない人|専門家でない人|素人|門外漢
zeitgeist	時代精神|時代思潮
nickelodeon	セント映画|セント劇場(nickel=5cent)
shaggy	毛深い|毛むくらじゃの|むさくるしい|毛羽立った
astronomer	天文学者
incompetence	無能
mishap	不幸|不運|災難|不運な事故
midsize	中型の
opera	オペラ|歌劇
precipitate	を早める|促進する|を沈殿させる|沈澱物
tassel	(飾り)房|房毛
slag	鉱滓(こうさい|鉱石から金属を除いたかす)|スラグ|かなくそ|けなす|淫乱な女
beastie	小動物
yucca	イトラン(植物)
metamorphosis	変身|変形|著しい変化|変態|変性
swain	求婚者|愛人
obstructive	じゃまな|閉塞性の
redline	discriminate in selling or renting housing in certain areas of a neighborhood
tentatively	暫定的に
retroactive	効力がさかのぼって|遡及効果のある|過去に遡る
atherosclerosis	アテローム性動脈硬化(症)
casually	何気なく|偶然|思いがけなく
demography	人口統計学
outcast	見捨てられた|追放された者
frat	男子生徒|男子学生の社交クラブ(fraternityに由来)
lanai	ベランダ
sprocket	鎖歯車の歯|=sprocket wheel
divulge	漏らす|明かす|公表する|暴露する
zig	ジグザグ
arcane	不可解な|少数の人だけが理解できる|神秘的な
planetarium	プラネタリウム
impractical	実際的でない|非実用的な
decentralization	集中排除|(中央)集権排除|分権化|中央分散
judaica	historical and literary materials relating to Judaism
tropicana	トロピカーナ|熱帯の
combustible	燃えやすい|可燃性の|可燃性
peavey	a stout lever with a sharp spike; used for handling logs|a stout lever with a sharp spike|used for handling logs
fluoxetine	フルオキセチン
quicksilver	水銀 (=mercury|hydrargyrum|Hg)
effortlessly	楽々と
gargoyle	ガーゴイル|樋嘴(ひはし:ゴシック式の教会の屋根などにある怪獣の形をした雨水の落とし口)|奇妙な形の彫像|(建物付属の)怪人像
bower	木陰|亭|あずまや|婦人の私室
lii	being two more than fifty
malignancy	悪性腫瘍
iridium	イリジウム(金属元素|元素記号Ir)
deferral	延期|繰延べ|据え置き|徴兵猶予
informally	非公式に
underwriter	保険引受人
sarcastic	皮肉な|皮肉の|当てこすりの|皮肉|あてこすり
chimpanzee	チンパンジー
alphanumeric	英数字の(文字)
verso	(本の)左ページ
disinfectant	殺菌剤|消毒剤
swab	ぞうきんぼうき|掃除する|モップでふく|消毒綿で手当てする
cherub	ケラブ|智天使|(9天使中の第 2 位で|知識を司る翼のある愛らしい子供) (pl|cherubim|形容詞cherubic)|愛らしい幼児
whirlwind	つむじ風|旋風|嵐|めまぐるしさ|激烈さ|性急な
sluggish	鈍い|不振の|不活発な|怠惰な|緩やかな|停滞した
molar	分子の|Molar concentration(モル濃度)|濃度の表示形式(1L中の溶質をモル数で表したもの|単位はmol/L) 2|臼歯(の)|かみ砕く
lorry	貨物自動車|トラック|トロッコ
mainstay	メインマストを支える綱|大黒柱
coy	恥ずかしがりの|内気な|恥ずかしそうなふりをする|引っ込んだ
sorghum	やけに感傷的なもの|サトウモロコシ(のシロップ)
dietitian	栄養士|栄養学者|食事療法士
flowchart	フローチャート
phony	偽の|まやかし(の)|いんちき(の)|偽物|ぺてん師
resubmit	submit (information) again to a program or automatic system
counteract	の影響を弱める|妨げる
amorphous	一定の形を持たない|不定形の|まとまりのない
hickey	にきび|あざ|キスマーク(和製英語)|継ぎ手|あれ|例のやつ
swag	みやげ品|花飾り|貴重品|盗品|密輸品|だらりと垂れる|沈む|ゆすぶる
diffuser	baffle that distributes sound waves evenly|optical device that distributes the light of a lamp evenly
touchstone	基準|試金石
cyanide	シアン化合物|シアン化物|青酸カリ
sunroof	(自動車の)日よけ屋根
mousse	ムース|卵とクリームで作られるクリーミーなデザート
shameful	恥ずべき|下品な
breakage	破損
archaic	古風な|すたれた|古風の
deafness	難聴
hypocrite	(hípəkrìt)偽善者|猫かぶり
syphilis	梅毒
brisk	活発な|元気のよい|小気味のよい|爽快な
vigilance	警戒|用心|不眠症|不寝番
palmyra	tall fan palm of Africa and India and Malaysia yielding a hard wood and sweet sap that is a source of palm wine and sugar; leaves used for thatching and weaving|tall fan palm of Africa and India and Malaysia yielding a hard wood and sweet sap that is a source of palm wine and sugar|leaves used for thatching and weaving
cyclin	サイクリン|真核生物の細胞において細胞周期を進ませるために働く蛋白質
chum	親友|仲良し|仲間|同室者
epithelium	上皮
bitterness	にがさ
storybook	童話の本
opiate	アヘン剤|鎮痛剤|麻酔剤
brill	ヨーロッパ産のヒラメ
webbing	帯ひも(つり革・馬の腹帯などに用いる);スラックスのベルト
lovingly	かわいがって|愛情をこめて|優しく
onslaught	突撃|猛攻撃
msec	ミリ秒
bribery	贈収賄|汚職
drizzle	小雨が降る|霧雨が降る|霧雨
untested	テストされていない
mockingbird	マネシツグミ(北米南部産)
jot	簡潔に書き留める|書き留める|メモする
hearst	ハースト
nutmeg	ナツメグ(香辛料)|ニクズク(の木･種子)
gauss	ガウス(磁力の強さのcgs単位)
precautionary	予防の|用心のための
artistry	芸術性
repaint	塗り直し|塗り直したもの|にペンキを塗り直す
wholesome	健康によい|健康的な|健康そうな|健全な
seaweed	海草|海藻
azores	アゾレス諸島
vegetative	生長する|生長に関する|植物(性)の|無為徒食の
salamander	サンショウウオ|(ギリシャ神話)火の精|火中にすむという伝説の怪物(火トカゲなど)
macho	たくましい|男らしい|男気を見せる
reeve	議長|執事|代官|滑車を通る|にロープを通す|の間を縫って行く|穴に通して結び付ける|穴に通す
willful	計画的な|故意の|がんこな|わがまま|わがままな|強情な|わざとした
grandeur	雄大|壮大
staphylococcus	ブドウ球菌
trinket	安物の宝石
dermatologist	皮膚科専門医|皮膚科学者
ladybug	テントウムシ(=ladybird)
financier	財政家|財務官
whereabouts	(人･物のおよその)所在|位置|居所|どのあたりに
smelly	臭い
ephemera	(昆虫)カゲロウ(=mayfly)|カゲロウのように短命なもの|はかないもの
testicular	精巣の
doubtless	疑いのない
cabana	(海辺やプールサイドの)簡易更衣所|小屋
mortuary	葬儀場|死の|死体置き場|遺体安置所
weaponry	(集合的に)兵器類
cryptic	隠れた|秘密の|神秘的な|あいまいな|なぞめいた
primus	監督長|1番目の|最年長の|首位の|第一の
logbook	航海(航空)日誌
cholera	コレラ
dissociation	分離(状態)|分裂|解離
reposition	蔵置|整復|格納|蓄積|蔵置き|入庫|蔵入|倉入れ|蔵入り|庫入れ|移動|動かす|整復
fungicide	殺菌剤
permeate	(pˈɚːmièɪt)|に浸透する|に広がる|に充満している|普及する|に行きわたる
midsummer	真夏|夏至
radiologist	レントゲン技師|放射線医(師)|放射線学者
detriment	損害
crispy	ちじれた|ぱりぱりの
pail	手おけ|バケツ|手桶|ペール(円筒型容器)
bullion	金塊|銀塊|純金･純銀の延べ棒|純金|金モール
hateful	憎しみに満ちた|憎い|憎むべき|ひどくいやな
rata	比例の|比例する
grumpy	不機嫌な
journalistic	(しばしばけなして)新聞雑誌記者流の|新聞雑誌的な
imputation	(罪を)帰する(負わせる)こと|非難|そしり|汚名
bagel	ベーグル|ドーナツ型の堅いロールパン
repatriation	本国送還
stratum	(複数形)strata|stratums|地層|層|単層
swoop	さっと舞い降りる|(空から舞い降りて)飛びかかる|をひったくる|不意の襲撃|急襲(する)|急降下
solidify	凝固させる|固める
leftfield	(野球で)左翼|レフト;左翼手の守備位置
linebacker	ラインバッカー(守備の選手)
letting	property that is leased or rented out or let
custard	カスタード(牛乳･卵･砂糖などでつくった菓子･料理)
flipper	水かき
fundamentalism	根本主義|原理主義
psychosis	精神病
humankind	人間|人類
causeway	(低地に土を盛り上げた)土手道|(敷石などによる昔の)舗装道路|街道(石灰で舗装された道が原義)
vino	ブドウ酒|ワイン
gable	切妻
lifter	重量挙げ選手
wield	を扱う|(権力など)を行使する|(影響など)を及ぼす
yeats	ウィリアム・バトラー・イェイツ
zucchini	ズッキーニ(西洋カボチャの類)
enthusiastically	熱心に
leek	ニラ|にらねぎ(洋種のねぎ)
chiral	3次元の図形や物体や現象がその鏡像と重ね合わすことができない性質(例|左右の手)をキラリティー(chirality)といい|キラリティがあることをキラル(chiral)という
multiculturalism	多文化主義
keats	キーツ
cuddly	抱きしめたいような|愛らしい|抱きしめたくなるような
bookworm	読書家|クラスで一番勉強のできた子供のあだ名|勉強好き|ガリ勉
detach	引き離す|取り外す
unmarked	ノーマーク(和製英語)
underside	裏面
joyous	とてもうれしい
tantra	any of a fairly recent class of Hindu or Buddhist religious literature concerned with ritual acts of body and speech and mind|doctrine of enlightenment as the realization of the oneness of one's self and the visible world; combines elements of Hinduism and paganism including magical and mystical elements like mantras and mudras and erotic rites; especially influential in Tibet|doctrine of enlightenment as the realization of the oneness of one's self and the visible world|combines elements of Hinduism and paganism including magical and mystical elements like mantras and mudras and erotic rites|especially influential in Tibet
diocesan	監督管区の|教区の
stylistic	文体の
lysine	リジン
androgen	男性ホルモン物質
catapult	発射する|カタパルト
grossly	肉眼で見て
cranky	ぐらぐらする
splint	へぎ板|副木|添え木|つぎ板
paparazzi	パパラッチ(ゴシップメディア)
wristwatch	腕時計
stanza	連|節|一ヶ所での興行期間|一区切り
fell	獣の皮|外皮|獣皮|毛革|毛皮|皮|伏せ縫い|極悪|兇悪|無情|無慈悲|残酷|無道|残忍|非道|むごたらしい|陰惨|打倒す|張り倒す|薙倒す|打っ倒す|ぶっ倒す|なぎ倒す|薙ぎ倒す|薙ぎたおす|倒す
phenol	フェノール|常温で白色の有機化合物|(和名は石炭酸)|毒性･腐食性あり|触れると薬傷をおこす|有機合成化学工業の重要な原料|コールタールから分離するかベンゼンから合成
hilly	起伏の多い
nonstick	(フライパンなどが)こげつかない|テフロン加工の
auger	らせん形のきり(大工用でT字型の柄がついている)
origami	折紙|折形|折り形|折り紙
yeti	=Abominable Snowman
umbilical	へその緒|供給管|必須の接続線|命綱|へその緒で結ばれた 緊密な関係の
bosom	胸|内部|胸部|胸中|胸裏ふところ
foray	略奪を目的として侵略する|略奪する|不意打ち|手出し
imperialist	帝国主義の
untrue	真実でない|虚偽の|不誠実な|不正確な
loeb	ローブ
waveguide	導波管
angiotensin	アンギオテンシン|アンジオテンシン
shimmer	ちらちら光る|かすかに光る|きらめき|ゆらめき
etch	エッチング|食刻する
potluck	あり合わせのもの
autonomic	自律神経の
relive	追体験する
shaper	作り人|メーカー|作手|メーカ|作る人|製作者|製造者|作り手|作人|メイカー|形削り盤
larval	幼虫の
resettlement	移転|引っ越し
mistakenly	誤って
posit	仮定(する)|肯定的に仮定する|置く
radiative	(光・熱を)放射する|発光する|発熱する
intimately	親密に|親しく|詳細に|深く
excretion	排泄|排出
vacate	あける|明け渡す
bioassay	生物検定|バイオアッセイ
polymerization	重合
bandwagon	楽隊車|人気のあるグループ|馬が引っ張って動かす大きな楽隊車のこと|時流
burrow	に穴を掘る|(うさぎの)穴|潜伏する
snuggle	すり寄る|寄添う|心地好く横たわる|をすり寄せる|を抱きしめる
vane	風見|風向計|翼|(風車タービンの)羽根|移り気の人
afar	遠く(farの方が一般的)
shaolin	少林寺拳法
dugout	塹壕(=foxhole)|防空壕|(野球)ダッグアウト(選手控え所)
prudence	慎重|思慮|分別|細心|抜目なさ|つつましいこと
hypnotherapy	催眠療法
gingerbread	ショウガ風味のケーキ|安ぴか物(飾り)
tasteful	風雅な|審美眼のある|趣のある|上品な
redshift	赤方偏移
hillbilly	(アメリカ南部の)田舎者|山の住民
colonialism	植民地主義|植民地化政策
decanter	栓付きガラスビン
virtuoso	名人|巨匠|名演奏家|音楽の大家
guarantor	保証人
colosseum	《the C-》(また『the Coliseum』)コロシウム(ローマの円形大競技場)|=coliseum 1
emptiness	空|空しさ|空虚|空腹|無意味
backorder	繰り越し注文(処理や納期などが将来に繰り越された注文)
dada	ダダ|ダダイズム|兄貴|父方の祖父|(幼児語)father|パパ(da-da)
hastily	あわてて|急いで
ful	a family of languages of the Fulani of West Africa and used as a lingua franca in the sub-Saharan regions from Senegal to Chad; the best known of the West African languages|a family of languages of the Fulani of West Africa and used as a lingua franca in the sub-Saharan regions from Senegal to Chad|the best known of the West African languages
invader	侵入者
shaky	震える|揺れる|当てにならない|不安定な
unethical	汚い|道義に反する|倫理に反する|倫理にもとる|非倫理的な
coagulation	凝固
tun	大樽|醸造桶|注ぐ
powerfully	強烈に
archdiocese	archbishopの管区
resection	切除
anaconda	アナコンダ|大ヘビ
thirdly	3番目に|第三に
plumb	おもり|垂直の|鉛錘|の深さを測る|を垂直かどうか調べる|(口)全くの
plenum	物質が充満した空間|充満|充実|全員出席の会議|総会
keyless	(時計が)巻きねじの不要な;竜頭(りゅうず)巻きの
translocation	転座
deliverance	救出
unfairly	不当に
choreographer	振付け師
fiasco	大しくじり|大失敗
calico	キャラコ(インド産の平織りの綿布)|更紗|calico cat 三毛猫(tortoiseshell cat)
vamp	継ぎはぎ|継ぎを当てる|ボランティアの消防士|即興伴奏|男たらし|不当な攻撃をする|しょっぴく|徒歩で行く|逮捕する
grumble	ぼやく|ぶつぶついう|不満|不平|ゴロゴロ鳴る
colossus	巨像|巨大な物|巨人
hyphen	ハイフン
tarp	タール塗り防水布|防水帆布|防水キャンバス
paramilitary	(団体など)軍補助的な|準軍事的な
frivolous	浅はかな|軽率な|つまらない
indecent	破廉恥な
dishonesty	嘘|詐欺|不正|不正行為|不正直|不誠実
schilling	シリング(オーストリアの通貨単位)
oppressive	圧制的な|圧迫する|非道な
agnostic	不可知論の|独断的な意見にとらわれない|寛容な
structurally	構造的に
auntie	(幼児語)おばちゃん
moray	ウツボ(魚)
substation	変電所;分署|派出所;分局
homeownership	家を持つこと
optimist	楽天家
incite	刺激する|励ます|煽る|扇動する|引き起こす
glycine	アミノ酢酸|タンパク質を構成するアミノ酸の中で最も単純な形を持つ|別名グリココル
sharpness	鋭さ|鋭敏|鮮明
esophagus	食道
unlicensed	無免許の
adenocarcinoma	腺癌
defiant	挑戦的な|反抗的な|傲慢な
ibuprofen	(医)イブプロフェン|非ステロイド系消炎鎮痛剤
audiology	聴力(覚)学(聴覚障害の治療などを扱う)
forint	フォリント(ハンガリーの貨幣単位)
sidestep	(決定･問題など)を避ける
falter	よろめく|ためらう|口ごもる|よろめき|ためらい
privy	内々関与して|関知して|(特に水洗でない)便所|屋外便所
mildew	白カビ|白かび(を生じる･はやす)|うどん粉病(菌)
ponce	女々しい男|ひも|たかる
perjury	偽証(罪)
buster	ベビーブームのあとの世代の人|破壊する人|(よびかけで)おい
vigilant	油断のない|用心深い|眠らずに注意している
pronto	早くしなさい|急いで
eerie	不気味な|薄気味の悪い|異常な
kannada	a Dravidian language spoken in southern India
hectare	ヘクタール(10|000m2=100are)|略号ha
netball	a team game that resembles basketball; a soccer ball is to be thrown so that it passes through a ring on the top of a post|a team game that resembles basketball|a soccer ball is to be thrown so that it passes through a ring on the top of a post
tourmaline	電気石|トルマリン(宝石の一つ)
holographic	自筆書類の
calibre	(caliberの英国式綴)才能|銃などの口径
padlock	ナンキン錠|南京錠
salaam	(イスラム教徒間の)挨拶|額手の礼|敬礼|礼の言葉|敬礼する|挨拶をする
clockwork	ぜんまいじかけ|時計じかけ
affliction	苦悩|不幸|悲嘆|苦痛
fertiliser	肥やし|肥料|肥
geometrical	幾何学的な
priory	小修道院
realist	現実主義者|写実主義作家|実在論者
bandage	包体|包帯