quadruple	4倍の;4重の;4部(4人)から成る|4倍|4倍の数(量)|4倍になる|〜‘を'4倍にする
hipster	ジャズファン|物知り|進んだ人|ヒップスター
bronchitis	気管支炎
innkeeper	宿屋の主人
yolk	羊毛脂|卵黄|黄身
gestation	妊娠|懐胎|妊娠期間|立案|計画を練ること|その期間
characterisation	描出|写生文|描写|特徴づけ
foreskin	陰茎の包皮|(植)種子の包皮
puke	吐く|吐いたもの
nibble	少しずつかむ|(獣･魚が)少しづつかじる|気のあるふりをする
unbelievably	信じれないほど
farce	笑劇|茶番劇|ばかげたもの
annihilation	(ənὰɪəléɪʃən)|全滅|崩壊|無効化|消滅
hora	ホーラ|ルーマニア･イスラエルの輪になって踊るダンス
butyl	ブチル
forested	森林に覆われた
unrivaled	無類|比類のない|無敵|唯一無二
diligent	勤勉な
randomness	ランダム性
woolf	ウルフ
daw	コクマルガラス(ヨーロッパ産の光沢のあるガラス)|=jackdaw
misinformation	誤報
chlorophyll	葉緑素
microfiche	マイクロフィッシュ
stretcher	担架|伸ばす人(物)
egress	出口|出ていくこと
concave	凹(おう)面の|くぼんだ|へこませる
porcupine	ヤマアラシ(=hedgehog)|麻すき機
contestant	競争者
snell	厳しい|鋭い|厳しく|敏捷に|利口に|はりす(に付ける)
dietetic	食事の|栄養(学)の
believable	信じられる
anesthesiology	麻酔学
forthwith	ただちに
prescriptive	慣例による|規定する|規範的な|指令を与える|時効取得された
oat	オート麦|エンバク(燕麦)|カラス麦
rupiah	ルピア|インドネシアの通貨単位
divination	占い|易断|予言|予知
curiously	物珍しそうに
fullness	充満|十分|肥満|(音色などの)豊かさ
subsidize	補助金を与える|を援助･助成する
melatonin	メラトニンはホルモンの一つ|不眠症などの睡眠障害の治療や|不妊症の治療に利用される|動物では脳の松果腺から分泌される
pied	(色)まだらの|雑色の
shocker	ホラー映画
brutally	残忍に
nutcracker	山烏の類|クルミ割り器
cess	運
electrochemical	of or involving electrochemistry
slalom	回転競技|スラローム
transmittal	伝送
powerless	力の無い
slurp	ずるずるする飲み食いの音|音をたてて飲食する
populace	庶民|民衆|住民
deliberation	熟慮|慎重さ|(pl|)審議|討議|審理
monolithic	一枚岩の|巨大な|融通のきかない
valence	結合価|原子価|価電子帯
luster	輝き|つや|栄誉|光沢のある毛織物|シャンデリア|渇望者|好色者|に光沢を付ける
prophylaxis	予防
alkali	アルカリとは|水に溶解して塩基性(水素イオン指数(pHが7より大きい)を示し|酸と中和する物質の総称
hangout	すみか|たまり場|行きつけの所
unstructured	体系化されていない
habitual	習慣的な|習慣による|不断の|常習的な|習慣性の
canto	小説などの編･章
draught	(drˈæft)|(draftの英国式綴)|為替手形|すきま風|下絵
extradition	(犯人)引渡し
jerky	乾燥肉|ぐいと動く|がたがた動く|つっかえがちの|(米)ばかな|ぶざまな
proportionate	比例した
algo	アルゴリズム
statistician	統計学の専門家
fdr	フランクリン・ルーズベルト|フランクリン・デラノ・ルーズベルト|ルーズベルト
inhale	吸い込む
corkscrew	らせん状の(に進ませる)|コルク栓抜き
drifter	流れ者|漂流者
autopilot	自動操縦装置
acidity	酸性度|酸味
formaldehyde	ホルムアルデヒド|有機化合物の一種で最も簡単なアルデヒド|毒性が強い|防腐･消毒剤
lavatory	洗面台|便所|トイレ
hemlock	ヘムロック(毒にんじん)|毒にんじんから採った毒
bodyguard	ボディーガード
heave	力をいれて持ちあげる|あえぎ|胸が波打つこと
huddle	集まる|身を寄せ合う|(ごちゃごちゃに)集める|秘密会議|密談
decompose	分解する|腐敗させる
metallurgy	冶金学|冶金
rigor	厳格さ|厳しさ|厳格|厳密|精密|正確|苦しさ|悪寒|寒気|硬直
felon	重罪犯人
argon	アルゴン|元素記号はAr
hooray	=hurray
carefree	のんきな|苦労のない
biotin	ビオチン|ビタミンB群に分類される水溶性ビタミンの一種で|ビタミンB7(VitaminB7)と呼ばれる
delicacy	おいしいもの|美味|珍味|ごちそう
marconi	マルコーニ
fluctuation	変動|動揺
journeyman	(徒弟奉公を済ませた)一人前の職人
bandana	バンダナ
monstrous	ぞっとするような|怪物のような|馬鹿げた|ひどい|巨大な
stetson	ステットソン(フェルトのカウボーイ帽)
incinerator	焼却炉|ごみ焼却炉
continuance	連続
commemoration	記念
erupt	噴出させる
germination	発芽
attrition	摩耗|摩擦|消耗|摩滅
proverb	ことわざ|諺|格言|通り言葉|たとえ|なぞ
mercenary	傭兵|欲得ずくの|報酬目当ての
wearer	着用者|携帯者|使用者|すりへるもの
convocation	召集
brocade	にしき
straddle	足をふんばる|両足を広げる|大股に歩く|広げる|日和見する|爆撃する
bioterrorism	バイオテロリズム
murderous	殺人の|残忍な|非常に困難な
anaesthesia	感覚がない|感覚喪失
equivalency	等価
mahjong	マージャン|麻雀
wretched	哀れな|あさましい|いやな|ひどい|みじめな
feeble	かよわい|弱々しい
interstellar	恒星間の
decadent	退廃的な|頽廃的な|頽廃期の|デカダン派の
kitchenette	簡易台所
unsurpassed	卓絶した
birdhouse	家の形をした鳥の巣箱
yap	ほえる|おしゃべり|がみがみしゃべる|キャンキャン|犬の鳴き声
sandpiper	イソシギ(細長いくちばしと脚をした海岸の鳥)
typeface	活字面
uppercase	大文字
cirrhosis	(肝臓)硬変(症)
metrology	測定学
gourd	ヒョウタン|瓢箪
hideous	見るも恐ろしい|ぞっとする|忌まわしい|胸が悪くなる
abreast	並んで|並行して
intuitively	直観的に
tonnage	容積トン数|総トン数
connexion	=connection
stoneware	炻器(せつき)(粘土製の堅い粗末な磁器の一種)
pathogenic	病原となる
columbine	オダマキ(植物)
caseload	(裁判所･行政機関･病院などの一定期間の)取扱い件数
riverfront	リバーフロント|川沿いの散策地
dumbbell	ダンベル|鉄亜鈴|(俗)のろま
blockage	障害物
pompano	コバンアジ(北米・南米産の食用魚)
decency	礼儀正しいこと
papal	ローマ教皇の;ローマカトリック教[会]の
mutter	つぶやく|ささやき|不平|ブツブツ|しゃべり声
nepa	type genus of the Nepidae: typical elongate-oval water scorpions
palais	宮殿|ダンスホール|フランス政府庁舎|邸宅
inductor	インダクタンス
verifier	ベリファイア
positional	位置の
arouse	刺激する|起こす|喚起する|奮起させる
charlestown	a former town and present-day neighborhood of Boston; settled in 1629|a former town and present-day neighborhood of Boston|settled in 1629
frag	(手投げ弾で)〈気にくわぬ上官〉‘を'粉々にしてやる|襲う
hydrolysis	加水分解
minibus	マイクロバス|小型バス
existential	実存の|存在に関する
sweaty	汗にまみれた|汗のような|汗まみれの
fiercely	獰猛に
hysteria	ヒステリー
shew	=show
retort	言い返す|しっぺ返しする|加熱蒸留器|レトルト食品
illiterate	読み書きのできない|文盲の|教育のない|無学の
cytoplasm	細胞質
insistence	強い主張|断言|無理強い|執拗|強調|強要|主張
phage	ファージ|細菌を宿主にするウイルス|細菌を食うものの意|(=bacteriophage)
sedimentary	堆積岩
timesheet	timecard
handkerchief	ハンカチーフ
answerer	応答者
intelligently	知的に
tableau	活人画|劇的画面
densely	こんもり|濃く|密集して
untranslated	翻訳されていない
rudd	European freshwater fish resembling the roach
daffodil	ラッパスイセン|水仙
semaphore	シグナル|手旗信号|信号装置|手旗で知らせる|手旗で送る
arousal	目覚めさせること|奮起
fraternal	友愛の|兄弟の
benthic	底生
sorter	分類する人|分類機
specialisation	専修|分化|特化|専門化|専門|専業|專門
eloquent	雄弁な
wondrous	驚くべき
bridle	馬勒(おもがい･手綱の総称)|添え金|馬靱をつける|反り返っていばる
inhaler	ブランデーグラス|吸入者|吸入麻酔器|空気濾過器
hyperbolic	双曲線の
acoustical	of or relating to the science of acoustics; "acoustic properties of a hall"|of or relating to the science of acoustics
occlusion	閉塞|咬合
pleasurable	愉快な
condone	大目に見る|見逃す|容赦する|ゆるす
armband	腕章
postman	郵便集配人
stapler	ホッチキス(和製英語)
lucerne	=alfalfa
emir	(アラビアの)首長|エミール(マホメットの子孫の尊称)
quid	1ポンド|噛み煙草の一回分
rockabilly	ロカビリー
kinship	親類関係
detain	引き留める|待たせておく|拘留する
loudspeaker	拡声器
decedent	死者|昔人|亡き人|枯骨|物故者|亡者|無き者|不帰の客|死亡者|彼方者
paraffin	パラフィン|石ろう|パラフィンを塗る
stead	代理|助け|利益
spook	幽霊|おばけ|スパイ|びっくりさせる
petro	石油の
strainer	ろ過器|こし器|引っ張る人
fondue	フォンデュ|フランスを中心とするヨーロッパ一円のチーズ鍋料理
limiter	(electronics) a nonlinear electronic circuit whose output is limited in amplitude; used to limit the instantaneous amplitude of a waveform (to clip off the peaks of a waveform); "a limiter introduces amplitude distortion"|a nonlinear electronic circuit whose output is limited in amplitude|used to limit the instantaneous amplitude of a waveform (to clip off the peaks of a waveform)
reappear	再びあらわれる
reflexology	the study of reflex action as it relates to the behavior of organisms|massage to relieve tension by finger pressure; based on the belief that there are reflex points on the feet, hands, and head that are connected to every part of the body|massage to relieve tension by finger pressure|based on the belief that there are reflex points on the feet, hands, and head that are connected to every part of the body
centerline	中心線|センターライン
subconscious	潜在意識(の)
incandescent	白熱の|光り輝く
capstone	かさ石|冠石
workday	平日の|平日|仕事日|勤務日|1日の就労時間
hidalgo	(スペイン語)下級貴族
condensate	凝縮|濃縮|凝集
firewood	まき
watergate	ウォーターゲート事件
brawl	乱闘|喧嘩|騒ぎ|口論する|どなりたてる|(衆目の中での)騒々しいけんか･口論
waistband	ベルト|腰のベルト
kepler	ケプラー
aural	耳の
magneto	マグネト|高圧磁石発電機
lawless	法律を守らない|非合法の|無法の
caldera	カルデラ
passer	通行人|試験合格者|ボールをパスする人
thermodynamic	熱力学的な
anion	anion(化学)|陰イオン
gout	痛風
disambiguation	clarification that follows from the removal of ambiguity
bittersweet	ほろ苦い(さ)|楽しくてつらい
sabbatical	(S～)安息日の|安息日にふさわしい|(s～)安息休暇(休暇年度)の(= ～ year)
inhuman	冷酷な
epistemology	(哲)認識論
geranium	ゼラニウム(植物)
spanner	スパナー|スパナ
indentation	ぎざぎざ(をつけること)|へこみ|(海岸線などの)湾入
bevel	斜角|(厚板ガラスなどの端に切った)斜面|角度定規|傾斜した|斜めの|〜‘に'斜角をつける|'を'斜めに切る
rundown	(野球用語)挟殺(走者が塁と塁の間に挟まれること)
bankroll	融資する|資金を出す
talker	おしゃべりな人
shipbuilding	造船
fulfilment	充足感|達成感|実現(主に英|頻度低)
foggy	霧がかかった|霧の深い|霧の多い
mystique	神秘性|奥義
gentile	異邦人
trousers	ズボン|(pantsが圧倒的に多用され|trousers|slacksがほぼ同等)
rationalize	正当化する|合理化する|理屈づける
concomitant	付随物|付随する|両立する
sepia	イカ墨|セピア色|暗褐色|セピアの|暗褐色の(皮膚をした)
practicality	実用性
disobedience	不服従
nephrology	the branch of medicine concerned with the kidney - its development and anatomy and physiology and disorders
ewe	雌羊
squamous	扁平な|鱗片状|落屑性の|鱗屑状の
triumphant	勝ち誇った|勝利を得た|成功した|意気揚々とした
superbly	見事に
typeset	活字に組む
chianti	キャンティ
domestically	国内で
moat	堀|堀で囲む
whomever	whoeverの目的格
footpath	(歩行者用の)小道|歩道
insufficiency	不十分
slicer	薄く切る人|(パン・肉などを切る)薄切り機|スライサー
unplanned	計画外の
mucosa	粘膜
millet	キビ|アワ
lactate	乳酸塩|乳を分泌する|乳汁を分泌する
shia	シーア派
pelvis	骨盤
papaya	パパイア(の実)
cognac	コニャック
profane	神聖を汚す|不敬な|世俗的な|異教の
bedspread	ベッドカバー
scourge	悩みの種|災い|災害の元|苦しめる
hourglass	砂時計|水時計|水時計で測った時間|漏刻|くびれた|漏刻形の
bbl	barrel
pagoda	仏塔|パゴーダ
antiretroviral	抗レトロウイルス薬
pollack	タラ(魚)
enumerate	列挙する|数える|数え上げる|～の一つ一つの名を挙げる|列挙
regress	逆行
trimmer	trimする人･もの|手ごわい人|ごまかしを言う人|素晴らしいもの|一級品
blindly	盲目的に
unintentional	故意でない
repertory	repertoire|貯蔵庫|(知識･事実などの)蓄積|宝庫
submenu	階層メニュー|サブメニュー|カスケードメニュー
conveyancing	財産譲渡に関する法律
marshmallow	マシュマロ|ウスベニタチアオイ
aeroplane	飛行機
hah	=ha
conductance	伝導度
halibut	オヒョウ(の身)|ハリバ|寒海魚|カレイに似た大型魚
sump	水などを集める穴;汚水だめ|(坑底の)水だめ|集水坑|(エンジンなどを)油だめ|油つぼ|《英》=crankcase
romp	ふざけまわる|はね回る|跳ね回る|走り回る|(スポーツなどで)楽勝する
silverware	銀器|食卓用銀製品
lymphatic	リンパ管
refrigerant	冷却剤(アンモニアなど)|解熱剤
goody	(goodies複数形で)おいしいもの|キャンディー|菓子|アイスクリームなど|特別に魅力のあるもの|(間投詞|特に子供が)すごーい! うれしい! (人名|姓)グディ
northerner	北部地方の人|北国の人|北部の人
countenance	に暗に賛成する|表情|外見
pedometer	歩数計|万歩計
shatter	を粉々にする|を打ち砕く|を台無しにする
gist	主旨|要点|骨子
tomahawk	トマホーク|北アメリカのインディアンが使う斧(おの)
alumnus	《米》(特に男子の)卒業生|同窓生
wad	詰め物(をする)|を丸める|小さい塊|固まり|束|札束
archeology	考古学|archaeology
hadith	ハディース|スンナ
hyperactivity	活動過剰
deforestation	森林伐採|山林開拓|伐採
perverse	つむじ曲がりの|ひねくれた(=crooked)|道理に反する|思いどおりにならない
shearer	シアラー(羊の毛を刈る鋏|人)
dickey	ワイシャツの胸当て|(婦人服の)前飾り|小鳥
backside	後部|しり
tiller	耕運機|耕作者|農夫|舵柄
eukaryotic	真核生物の|(動物|植物|菌類|原生生物など|身体を構成する細胞の中に細胞核を有する生物|真核生物以外の生物は原核生物と呼ばれる)
husbandry	農業|耕作|畜産(=animal husbandry)|飼育|節約|管理|cf|husbandman農場を経営する人(a person who operates a farm)
visibly	目に見えて|明らかに
defunct	現存しない|故～|今は亡き～
broiler	ブロイラー|若鶏
trellis	格子|格子垣
layoff	一時帰休
crunchy	ザクザクと音がする|バリバリ噛む|ジャリジャリする|歯ごたえが良い|しゃきしゃきしている
dodger	ぺてん師|小さいビラ
merciful	慈悲ぶかい|情け深い|慈悲深い|安堵を与える
lollipop	棒付きキャンディー|ペロペロキャンディー
sulphate	硫酸塩
nance	お釜|ホモ
springtime	春(の)|春期
euphoria	幸福(感)|多幸|上機嫌|陶酔
acuity	鋭さ
conifer	針葉樹|球果植物
lockdown	the act of confining prisoners to their cells (usually to regain control during a riot)
racecourse	競争路
reunite	再び結合する|仲直りさせる(する)
formulary	定式|薬局方
impressionist	印象派の)画家)|物まね芸人
caballero	(スペイン語)紳士|騎士|乗馬者
jurist	法学者
uncanny	気味の悪い
mane	たてがみ|ふさふさした髪
neurotransmitter	神経伝達物質
enlighten	啓蒙する
eatery	レストラン|簡易食堂|軽飲食店|軽食堂
intramural	〈スポーツ・授業など〉学内だけの|(反|extramural)
deteriorate	悪化させる|低下させる|堕落する
vise	(主に英)万力(米ではvice)
neve	万年雪に覆われた雪原|粒状万年雪
mulligan	(米)mulligan stew|マリガンシチュー|肉または魚と野菜のごった煮
noxious	不健全な|有害な
sledge	(また『sled』)《米》(荷物運搬用の)大型そり|《英》=sled1|〜‘を'そりで運ぶ|そりに乗る|そりで行く
trove	収集|(大事なものの)集積|バンク|大事な物を集めている場所|発見されたもの
drowsiness	嗜眠(しみん|意識障害(意識混濁)の程度のひとつ|昏眠ともいう|放っておくと眠ってしまい|強い刺激を与えないと覚醒し反応しない状態)
overhang	におおいかぶさる|の上にかかる|の上に突き出る|差し迫る|突出
reachable	到達可能な
radioactivity	放射能|(空気中の放射能atmospheric radioactivity)
howdy	ハウディ|こんちわ|やあ
eastward	東方へ
haggard	やつれた
northward	北に向かって|北に向かう|北方|北に向いた|北方への|北方へ
archeological	考古学の
logarithmic	対数の
sandalwood	白檀材|ビャクダン
shoebox	a structure resembling a shoebox (as a rectangular building or a cramped room or compartment)|an oblong rectangular (usually cardboard) box designed to hold a pair of shoes
godly	信心深い
spire	芽を出す|尖塔|渦巻|尖頂
distillation	蒸留
decontamination	浄化|汚染の除去
loyalist	忠臣
kimono	着物(日本の伝統衣装)
picky	えり好みをする|(味などに)うるさい|ひどくこせこせした
consort	配偶者|仲間にする|を連合させる
raisin	干しぶどう|レーズン
bibl	biblical|bibliographical
bobcat	ボブキャット|北米産のヤマネコ
freehand	(絵などを)(器具の助けを借りずに)手でかいた|手がきで
bastion	とりで(となる人･もの)|要塞|稜堡(りょうほ)|防衛
sunburst	(雲間から差す)強烈な日光|光り輝く宝石(装飾品など);日輪型花火
gawker	a spectator who stares stupidly without intelligent awareness
nameless	名もない|無名の|匿名の|父のない
sociologist	社会学者
copywriter	広告案内作者
numerator	(数学)分子|(例文|分子が分母と等しいか分母より大きい分数 a fraction whose numerator is equal to or greater than its denominator)
musically	音楽的に
voltaire	ヴォルテール|フランソア・マリー・ヴォルテール
indebted	感謝している|thankful|負債がある
groundhog	マーモット(marmot)|ネズミに似た動物
reinstate	(秩序などを)元に戻す|回復する
knack	こつ
alienate	遠ざける|疎遠にする|(財産など)を譲渡する
spay	卵巣を取り去る
gammon	たわごと|でたらめ|ごまかし
android	人造人間
canola	菜種油|アブラナ
reincarnation	再生|生れ変り
reproducible	再現可能な
mislead	誤り導く|誤った方向に導く|悪事に誘いこむ|欺く
bogota	ボゴタ
housekeeper	家政婦
hysterical	ヒステリーの
disinfection	消毒
perfusion	パーフュージョン|(医)灌流|毛細血管やそれに準ずる機能血管系の血流を表わす用語
postseason	ポストシーズン
negation	否定
covey	(母鳥と群居する)一群
donne	ダン
dauphin	《しばしばD-》ドーフィン(昔のフランス皇太子の称号)
takeoff	離陸
hangman	絞首刑執行人
modernist	現代主義の|近代主義者|現代主義者
elastomer	エラストマー(ゴムのような弾性物質)
ominous	不吉な|不気味な|縁起の悪い|前兆となる
socialize	をグループ活動で行う|を社会主義化する
dictation	書き取り
adorn	飾る|decorate
databank	データバンク
livery	そろいの服|衣類 ex|the livery of grief (woe) 喪服
adrenergic	アドレナリン作動性の
baseman	(野球)～塁手
conte	(仏語)コンテ|デッサン|素描用のクレヨン|コント|風刺や皮肉に富んだ小話|寸劇
subtlety	微妙な考え|微妙|希薄|巧妙
reprimand	叱責(する)(rebuke)|懲戒(する)|戒告
piccolo	ピッコロ|小型管楽器
basilica	(古代ローマの)公会堂|その様式の教会堂
virtuous	高潔な|有徳の|徳の高い|貞潔な|貞淑な
memento	形見|記念の品|みやげ|土産|記憶|思い出
sib	(síb)|血縁者|親類の人
incapacity	無能
overkill	やり過ぎて
mylar	a thin polyester film
seep	しみ出る|滴下する|漏れる|浸透する|小さな泉
interlink	〜‘を'つなぎ合わせる|連結する
heartbreak	胸が裂けるほどの悲しみ|悲嘆|断腸の思い|悲痛
effortless	たやすい|楽な
hydroelectric	水力電気の|水力発電の
cranial	頭蓋の
hindsight	あと知恵|(銃の)後部照尺
friendliness	好意|親切|親善|親睦|友情
invincible	無敗の|征服されない|克服しがたい|無敵の
resonator	共振器
criticise	批判する
cramp	足が攣る(つる)|こむら返り|He had his right leg cramp|束縛する|かすがい|締め具
erratic	一定しない|不安定な|突飛な
barrage	連続|連打|連発
spousal	配偶者の
neurobiology	神経生物学
wham	バシッ|ドシン|ガーンなどの強打･衝撃を表す
barm	パン種|麹|イースト|酵母
meltdown	融解|原子炉の炉心溶融
tact	機転|如才なさ
deduce	推論する
circulatory	(血液の)循環上の
takeaway	=carryout
rebuke	人を責め咎める|戒める|非難する|なじる|懲戒|抑制|叱責(する)
unrecognized	認められていない
affectionate	愛情深い
translational	翻訳の
ingest	摂取する
unimportant	重要でない|ささいな|取るに足らない
standout	すばらしい人(もの)|傑出した人(もの)
interstitial	間質(臓器に固有の細胞群に対し|その間に入り込む結合組織などを指す|血管|神経|膠原繊維など)|隙間の
bayonet	銃剣(で刺す)|バヨネット(銃器に銃剣を装着する装置)
zoological	動物学(上)の
helical	螺旋(らせん)|螺旋状の
norse	ノルウェー|ノース|ノルディック|ノース|ノース|ノース
pseudonym	偽名|匿名|筆名|ペンネーム
graze	牧草を食う|擦れる|放牧する|生草を食う
supersonic	超音速の(機)|超音波(の)
foothill	山すその丘陵|山麓地帯
payee	支払い先
causation	引き起こすこと|因果関係|因果説|原因|原因として働くこと
deciduous	抜け落ちる|脱落性の|落葉性の
photosynthesis	光合成
knockoff	模造品
precaution	予防|予防策|用心|警戒
empirically	経験的に|経験に基づいた
stethoscope	聴診器
philanthropic	博愛の
verity	真実
lichen	地衣類(岩や木につくコケ)|地衣
critter	生き物|動物|人|家畜|(神話の)奇妙な動物
dogwood	ハナミズキ|アメリカヤマボウシ
exorcism	悪魔払い|魔除け|厄払い
endoscopy	内視鏡検査
airliner	大型旅客機|定期旅客機
peregrine	流浪性の|遍歴中の|海外居住者|巡回の|広く分布している|出口|小売店|コンセント|ハヤブサ(鳥)
cutaneous	皮膚反応
lumen	ルーメン|(1candelaの点光源が立体角1steradianに放出する光束強度)
infrequent	まれな
rump	(動物の)しり|(牛の)腰肉|残りかす|残党
mam	mamma|mother
impeccable	欠点のない|非の打ちどころのない|完全な
oblige	強いる|余儀なくさせる
abscess	膿瘍(のうよう)|生体組織内に|崩壊した好中球由来の分解酵素で化膿性炎症が生じ|膿を持った空洞ができた状態
cyclist	循環説主張者|自転車乗り
milieu	(仏語|中間の意)|環境|境遇
sunburn	を日焼けさせる|日焼けする|(炎症を起こした)日焼け
rota	当番表|ロタ島(Rota Island)|ミクロネシアにある米国の自治領|人口約3000人
sealant	密封剤(封ろう・接着剤など)
rightful	正当な
fjord	フィヨルド(= fiord)|ノルウェー語で「入り江」という意味で|氷河に侵食された谷の下流部が海水に覆われたもの
nettle	苛立たしいもの･こと|いらいら(させる)|イラクサ(で刺す)
bimbo	(見かけはいいが)頭の弱い･身持ちの悪い女|オシャレと男性にのみしか関心がない女性
extracurricular	課外の
pious	信心深い|偽善的な|宗教的な|敬虔な
undeveloped	未発達の|未開発の
undisputed	争う余地のない|明白な|確実な
tonal	音色の|色合いの|色調の|調子の
antecedent	先行詞|先だつ
psychoanalysis	精神分析
hesitant	ちゅうちょする
poco	(音楽などで)やや少し
bough	大枝|主枝|(branch幹(trunk)から出る枝|bough大枝|twig小枝|spray葉や花がついた小枝)
candlelight	蝋燭の光
embankment	堤防|土手
spanking	(歩調)活発な|威勢のよい|(風)強い|すごく立派な|すてきな
pretreatment	前処理
ejection	追放
pessimistic	悲観的な|悲観(厭世)主義の
flashy	一時の|服装などが派手な
lurk	待ち伏せする|(胸中に)潜む|潜伏する|忍んで行く
winnebago	ウィネベーゴ湖|ウィネベーゴ湖
coexist	共存する
shortwave	短波(の)
duster	掃除人|雑巾
quaternary	四つ一組み(の)|四元素(四基)から成る|(地質学)第四紀(の)
buzzard	ヒメコンドル|ノスリの類
overboard	船外に
hobbyist	a person who pursues an activity in their spare time for pleasure
faithless	あてにならない|信仰のない|不実な|不貞な
monorail	モノレール
coolidge	クーリッジ
blasphemy	不敬|冒涜
prerogative	特権を持つ|大権|特権|特典
stateroom	個室|特別室
overuse	過度の使用|酷使|乱用|使い過ぎる|乱用する
potpourri	ポプリ|混合曲
barrio	(米国の)スペイン語通用地域
leafy	葉に覆われた|葉の多い|葉のような
passionately	情熱的に|熱烈に|激しく|激怒して
proposer	提案者|発起人|申し込み人
absurdity	不合理|不条理
needlepoint	ニードルポイント
dolor	悲しみ|嘆き
ehrlich	エールリヒ
contig	DNA配列断片を重ね合わせて (アライメントして) できる配列断片群を指す|単語「contiguous」に由来
vernacular	その土地特有の(ことば)
cyborg	サイボーグ
adagio	(音楽で)ゆるやかに|アダージォの曲(楽章)
lowdown	真相|内幕|非常に低い
lusty	たっぷりの|強壮な|元気な|力強い|大柄な
threonine	スレオニン|アミノ酸の一種|必須アミノ酸の1つ (=THR)
encephalitis	脳炎
bock	(ドイツ製)黒ビール
papyrus	パピルス(紙)|カミガヤツリ|パピルス写本
disrespect	失礼
prioritise	assign a priority to; "we have too many things to do and must prioritize"|assign a priority to
anamorphic	アナモルフィック
expel	(害虫を)駆除する|駆逐する|を追い出す|を追放する|を放出する|発射する
vex	いらいらさせる|なやませる|困らせる|苦しめる|討論する
coenzyme	コエンザイム(酵素名)
cinematographer	撮影監督
nutty	に熱中して
vermilion	朱色の|朱色
weekender	週末旅行者
linearity	直線性
inadequacy	欠点|不十分|不足|不適当|不備|無能
endlessly	延々と
hasty	早まった|急ぎの|軽率な|急いだ|迅速な
batik	ろうけつ染め
dexterity	器用さ
chieftain	指導者|(山賊などの)首領
diesis	a character used in printing to indicate a cross reference or footnote
sumatra	a mountainous island in western Indonesia
recitation	暗唱|朗読
macular	黄斑の
atrophy	衰退|(栄養不足などによる)萎縮症|委縮する
stratification	(地質学)|成層|層理|層化
resumption	再開|回復|回収
bidirectional	双方向の
starfish	ヒトデ
abet	扇動|扇動する|(悪事)をけしかける|教唆する
trifle	(金･時間･精力などを)を浪費する|粗末にする|とるに足らないこと|わずかの金
congestive	うっ血性
etymology	語源|語源学|語源的意味
seedling	若木|苗(木)|実生の苗木
erasure	ぬぐい消すこと|抹消|削除個所(語句)|消した跡
mariposa	マリポサ
underserved	行き届いていない
crumb	かけら|パンくず|パンの中味
admixture	混合物(剤)
elmwood	hard tough wood of an elm tree; used for e.g. implements and furniture|hard tough wood of an elm tree|used for e.g. implements and furniture
welles	ウエルズ
gujarati	a member of the people of Gujarat|the Indic language spoken by the people of India who live in Gujarat in western India
seascape	海げしき|海景画
leno	絡み織り
sida	large genus of tropical subshrubs or herbs some of which yield fibers of mucilaginous substances
predictability	予測可能性
pajama	パジャマ|ゆるいズボン
gestational	妊娠の
riel	the basic unit of money in Cambodia; equal to 100 sen|the basic unit of money in Cambodia|equal to 100 sen
zocor	シンバスタチン
ecotourism	自然観光ツアー|エコツアー
prematurely	時期尚早に
fueling	給油|燃料補給|燃料供給
frail	こわれやすい|もろい|虚弱な|か弱い|意志薄弱な|はかない
hatchet	手おの|手斧|ておの|(=ax)
awfully	ひどく|非常に|すごく|とても(veryのインフォーマルな言い方)
mayflower	5月に咲く花(特にイギリスではサンザシ･米ではイワナシ)
seatbelt	シートベルト
jumpstart	starting an automobile engine that has a weak battery by means of jumper cables to another car; "my battery was dead so I had to get a jumpstart from my neighbor"|starting an automobile engine that has a weak battery by means of jumper cables to another car|start (a car engine whose battery is dead) by connecting it to another car's battery|start or re-start vigorously; "The Secretary of State intends to jumpstart the Middle East Peace Process"|start or re-start vigorously
legalize	合法化する
corneal	角膜の
cordial	心からの
shriek	叫ぶ|悲鳴|悲鳴をあげる|かん高い声で言う|金切り声|かん高い声
macaroni	マカロニ|(俗)イタリア人|イタリア風のしゃれ者
swank	見せびらかし
starlet	売出中の若手女優|小星|小さい星
chromatic	色の|色彩を用いる|半音階の
gambit	手初め|開戦の手|手始め|いとぐち|切出しのことば|話題|策略|作戦
disassemble	分解される|バラバラになる|散らばる|分解する|取り外す|バラバラにする
drinker	酒飲み|飲む人|家畜用の給水機
horney	カレン・ホーナイ
dumpster	(有蓋･無蓋の四角い鉄製大型ゴミ容器|機械操作で清掃車にゴミを移す)|ダンプスター
bellow	大声でどなる
schoolhouse	校舎
maar	マール
creationism	創造説(宇宙や生命の起源を創世記に書かれた「創造主なる神」に求める考え方)
preempt	相手を封ずる|先制する|先取する|先買権で購入する
nimbus	(宗教画などの)後光 ・光輪・(人・もの・場所にただよう)輝かしいふんい気; 後光 （halo）・光輪; 栄光;雨雲
ige	one of the five major classes of immunoglobulins; present primarily in the skin and mucous membranes|one of the five major classes of immunoglobulins|present primarily in the skin and mucous membranes
nog	ノッグ(英国の強いビール)|eggnog
firsthand	直仕入れの|直接の|直接に
accretion	(発育･付着･包含などによる)増大|付着|融合|合体
turbidity	混濁|濃密
atf	the law enforcement and tax collection agency of the Treasury Department that enforces federal laws concerning alcohol and tobacco products and firearms and explosives and arson
zzz	グーグー(いびきの音)
trier	tryする人|いつも最善を尽くす人|サンプル抽出器|検査員|試験装置|陪審員忌避審判官
ano	a Palestinian international terrorist organization that split from the PLO in 1974; has conducted terrorist attacks in 20 countries; "in the 1980s the Fatah-RC was considered the most dangerous and murderous Palestinian terror group"|a Palestinian international terrorist organization that split from the PLO in 1974|has conducted terrorist attacks in 20 countries
brothel	売春宿
leisurely	ゆっくり(と)|急がない
minnow	ヒメハヤ|小魚
cardiologist	心臓内科医
loki	ロキ
mayonnaise	マヨネーズ
kava	カバ
transect	横断する
briar	いばら
limitless	無限の|広々とした|限りない|果てしない|青天井の
possum	ポッサム|有袋類フクロギツネ科(豪|ニュージーランドに分布)|袋に子を入れて運び|危険になると死んだふりをする|オポッサムは有袋類オポッサム科で南北米大陸に分布)|別の種
preventable	予防可能な
bumpy	(道路)でこぼこの|(車･旅行)がたつく
aleph	アレフ
mongoose	マングース
separatist	分離主義者|分離派の人
mullet	ボラ
collate	対照する|のページ順をそろえる|の落丁調べをする
acceptability	受容性
ventricle	(心臓の)心室 (cg|atrium心房)
constitutionally	憲法上
disapproval	反対意見|非難|不可とすること|不賛成|不承認|不満
hawker	行商人|鷹匠|飛翔中獲物を捕る虫
visualisation	視覚イメージ
powerboat	モーターボート
counterpoint	対位法(で作･編曲する)|対旋律|対照的な要素(で強調する)
unlucky	不運な|不首尾の|不吉な
ketchup	ケチャップ
gush	ほとばしり出る|噴出|勢いよく流れ出ること
alimony	(離婚後･別居後に夫が妻に与える)生活費|扶養料
viscous	粘着性の|粘りけのある
sundial	日時計
volley	ボレーで打ちかえす|いっせいに飛ぶ|いっせい射撃|(質問･悪口の)いっせい放射|連発
reinvestment	再投資
unambiguous	明瞭に|はっきりと|clearly
headhunter	首狩りを行う未開人|人材を引き抜く人
handicraft	手先の熟練
emphysema	(èmfəzíːmə)|気腫|(特に)肺気腫
rejuvenation	再生|復活|若返り|一新
atelier	アトリエ|仕事場|製作室|画室
aver	断言する|であると主張する
burley	バーレー種の葉タバコ(特に米国Kentucky州とOhio州南部で栽培される)
cynic	皮肉屋
bestow	与える|授ける|を贈る|利用する
fissure	裂け目|割れ目|亀裂|ひび|分裂
unheard	聞こえない
scouse	船員用シチュー|スカウス
interment	埋葬|土葬
cairn	ケルン(記念塚)
nomadic	遊牧の|cf|nomad(遊牧民)
wrongdoing	悪事
immerse	没頭させる|浸す|沈める|つける
meson	中間子|(クォークおよび一つの反クォークで構成された不安定な亜原子粒子)
racetrack	競技場
decompression	減圧
galena	ガレナ|方鉛鉱(PbS|硫化鉛)
inactivation	不活化
vespa	ベスパ
olfactory	嗅覚の|嗅官の
prognostic	予後の
thinly	まばらに|やせて|希薄に|細く|弱く|薄く|トラック競技の選手|ランナー
thd	博士
arable	耕作に適した|耕作可能な|耕された|耕地
parallelism	並列処理|並行|類似|比較|対応
brut	(ぶどう酒が)甘味のない|辛口の
candlewood	any of several resinous trees or shrubs often burned for light
contaminate	汚染する|汚す
windfall	(収穫前に風で落ちた)果物|予期せぬ収穫(主に遺産)|棚ぼた|勝利投手
stingray	アカエイ
myeloma	骨髄腫
evaporate	蒸発する|を乾燥させる|(むなしく)消える|脱水する|気化する
chevalier	騎士|義侠的な人|勲爵士|最下位の貴族
centaur	ケンタウロス(上半身は人間で下半身が馬のギリシア神話の怪物)
osteopathic	整骨医の
vividly	いきいきと|活発に|あざやかに
wildflower	野生の花|野草
npa	新人民軍
excavator	掘る人;発掘者|掘削機
merino	メリノー羊(種)
mew	猫の鳴き声|ニャーニャー
jello	(米)ジェロー(フルーツゼリー)
suffrage	選挙権|投票|選挙
barium	バリウム(金属元素・化学記号はBa)
junta	(クーデター後の)軍事政権|臨時政府|暫定政府|(スペイン･南米)議会|会議
hydrophobic	疎水性の
prim	とりすます|堅苦しい
talkie	トーキー|発声映画
returnable	返却できる|返還すべき
mnemonic	記憶の(を助ける)
resuscitation	救急蘇生法
chaise	軽装2人乗り2輪馬車
appraise	の価値を決める|を見積もる|評価する|見積もる|値踏みする|査定する
baguette	四角形カット|長方形カット|細長いフランスパン
beater	ビーター|泡立て器|(ミキサーの)回転する刃|打つ人|勢子|打ちたたく器具|(ドラムの)ばち|下宣伝員
phospholipid	リン脂質
lute	丸い胴を持つギターに似た弦楽器(14-15cに多用)
synchrotron	シンクロトロン(電子加速装置)
fledgling	未熟な|駆け出しの|創業まもない
rainwater	雨水
comrade	同僚|仲間
mouthful	一口|口一杯|1口分|一口分|少量
reducer	還元剤|還元剤
fireside	炉ばた
verifiable	検証できる
bacterium	バクテリア
zb	a unit of information equal to 1000 exabits or 10^21 bits|a unit of information equal to 1000 exabytes or 10^21 bytes|a unit of information equal to 1024 exbibytes or 2^70 bytes
refrigerate	冷却する|冷やしておく
serialization	連載
tenderloin	テンダーロイン|ヒレ肉|盛り場|不法の街
watchman	夜警|ガードマン(和製英語)
eigenvalue	固有値
signet	印鑑|認め印|signet ring(印鑑のついたリング)
inconvenient	不都合な|不便な|不利な|迷惑な|厄介な
seacoast	沿岸|海岸
preside	統轄する|議長をつとめる|司会する|主宰する
harass	悩ませる|困らせる|(繰り返し)悩ます|攻撃する
chancery	(また『court of chancery』)《米》衡平法裁判所|chancellorの職|《英》大法官府|大法官裁判所|公記録保管庁
garb	服装
positron	陽電子(ポジトロン) (Positron Emission Tomography|PET|陽電子放射断層撮影)
specifier	指示子
jute	黄麻(おうま)|インド麻|ジュート|ツナソ|ジュート(ツナソ)の繊維(帆布・南京袋・ロープなどの材料)
accentuate	目立たせる|を強調する
tum	トン|ポン|ドン|ドラムの音|ポロン|ボロン|弦楽器の音|ポンと鳴らす|弾く|(幼児語)おなか|ポンポン(=tummy)
spellbind	呪文で縛る|魅する
prophesy	予言する
faerie	妖精の国|おとぎ話の世界
byproduct	副産物
reorganize	再編する|(企業などを)再建する
tasteless	趣のない|まずい|無味の|味がない
ploy	策略|計略|遠征
instructive	教訓的な
shingle	小さな看板|屋根板|小看板|を屋根板でふく|を短く刈る
mathematically	数学的に
catamaran	いかだ舟|ガミガミ女
iconic	象徴的な
ravine	峡谷|山峡|渓谷
rife	(好ましくないものが)豊富な|広まって
cornea	角膜
eld	年|高齢|老い|老年|老年期|老齢|老いらく|年頃|年|齢|年令|年齢|歳
sectarian	宗派の|派閥の
catalysis	触媒作用
orifice	(管･煙突･傷などの)開口部|穴|口(opening)
chatterbox	おしゃべり(な人)
polystyrene	ポリスチレン(樹脂)
amon	アーメン
intelligencer	知的な考え|インテリジェンサー(雑誌名等)
submersible	潜水用の|水中に沈めうる|潜航できる|潜水艦(艇)
pluralism	多元論|兼職|複投票|複数制|社会的多元主義
benefactor	恩人|恩恵を施す人|保護者|後援者
exertion	権力を用いること|努力|力を出すこと|力の発揮
tetanus	破傷風|破傷風性けいれん
neuromuscular	神経筋の
caribe	ピラニア
pita	ピタパン(地中海沿岸|中東|北アフリカで広く見られる食文化)
hiker	ハイカー|架線工事作業員|町の保安官|徒歩旅行者
maul	大きな木製の槌|かけや
frigate	フリゲート艦
osmosis	浸透性|浸透作用
expedient	好都合の|ご都合主義の|政略の|方便|急場しのぎの方法
clandestine	秘密の|内々の|人目につかない
outrigger	アウトリガー|舷外材|アウトリガー付きボート|クラッチ受け
recalculate	計算し直す
porosity	〈U〉有孔性|通気性|〈C〉多孔率
isomorphism	同形
chiropractor	脊柱指圧(調整)療法師
vibrational	振動性
obsidian	黒曜石|十勝石
unduly	過度に
exacerbate	激化させる|悪化させる|怒らせる|憤激させる
intoxication	陶酔|酔い
chargeable	責任(罪など)を負わねばならない;(〜を)負う《+『with』+『名』》|《補語にのみ用いて》(負担・費用などが)(〜に)負わされる《+『on』+『名』》
tampon	(生理用)タンポン|止血栓
culmination	最高点
lense	レンズ
theoretic	理論的
sleazy	薄っぺらな
transcribe	転写する|書換える|を書き写す|を複写する|を筆記する
seashore	海浜|海岸
onstage	ステージ上の
pinky	子指|小指|ピンキー
copolymer	共重合体(2種類以上の単量体の重合による高分子化合物)
urethane	ウレタン
invertebrate	脊椎のない|無脊椎動物(の)|気骨のない
anagram	アナグラム(単語または文中の文字をいくつか入れ替えて全く別の意味にさせる遊び) cf|palindrome(回文)
rebellious	反抗する|反逆する|反抗的な|(病気など)治療しにくい
tastefully	趣味がいい
pairing	組み合わせ|対合
yike	キャッ|小型電動バイクの名
obscenity	わいせつ
cultivar	栽培品種
eyelash	睫毛(まつげ)
teammate	チームメート
diseased	病気の|病的な
grandparent	祖父母
demonic	悪魔的な|魔力をもった
curie	キュリー(放射能の古い単位|今はベクレス)|キュリー夫人の名に由来
nrl	the United States Navy's defense laboratory that conducts basic and applied research for the Navy in a variety of scientific and technical disciplines
unman	〜‘の'勇気をくじく|〜'を'めめしくする
dahlia	ダリア(キク科ダリア属の多年生草本植物)
causality	因果関係
bountiful	贅沢な|気前のよい|豊富な
lossless	characterized by or causing no dissipation of energy
traversal	トラバース|横断
andean	relating to the Andes and their inhabitants
spectroscopic	分光器の|分光器による
metalworking	金属細工術
filly	雌の子馬
clomid	クロミフェン
gobble	がつがつ食う|ガツガツ食べる様子
entrant	新入者|(競技などの)参加者
paperweight	文鎮
telescopic	望遠鏡の;望遠鏡で見た|(目など望遠鏡のように)遠くが見える|遠目の利く|(望遠鏡のように)伸縮自在の|たたみ込み式の
gratuity	チップ(tip)|心付け|祝儀|プレゼント|贈り物
retribution	仕返し|報復|報い
onshore	陸に向かって|陸上で|陸に向かっての|陸上の
nacho	ナーチョ|ナッチョ(メキシコ料理)
gad	ほっつき回る|遊び歩き(く)|(間投詞)まあ!|とんでもない! 3|たがね|GAD|Generalized Anxiety Disorder(全般性不安障害)
sleepless	眠らない|眠れない|不眠の|油断のない
kinesiology	the branch of physiology that studies the mechanics and anatomy in relation to human movement
glorify	栄光を与える
piglet	子豚
audiophile	オーディオファン|ハイファイ愛好家
taupe	暗灰色(茶・黄・紫色がかった灰色)|暗灰色の
seawater	海水
slur	いい加減に扱う|を中傷する|を不明瞭に発音する
lek	レク(アルバニアの貨幣単位)
knuckle	げんこつ|指のふし|指関節
carotene	カロチン(ニンジン・トウガラシなどに含まれる炭化水素)
wobble	よろよろする|(左右に不規則に)揺れる|動く|クラクラ|よろめく様子
dimer	モノマー(単量体)が結合した重合体がオリゴマー(oligomer)で|数に応じダイマー(dimer|二量体)|トライマー(trimer|三量体)|テトラマー(tetramer|四量体)|ペンタマー(pentamer|五量体)と呼ぶ
dysplasia	形成異常|異形成
azalea	ツツジ|アザレア|サツキ
printmaking	版画刷り|版画製作
overdraft	（銀行の）当座貸越（金額）・((預金者側から見れば「借」越し)); （手形の）過振(かぶり)
reconstructive	再建的
conciliation	なだめること|斡旋|和解
glycerol	グリセロール|グリセリン
dalmatian	ダルメシアン
impunity	罰を受けないこと|刑をうけないこと
chaperone	chaperon|(社交界に出る若い婦人の)付添い婦人|に付き添う
infernal	地獄の|ひどい
defamatory	中傷的な
succulent	汁の多い|多肉多汁の植物
ordinal	順序の|順序を示す|目の|(分数fractionの)序数(ordinal number)
bassoon	バスーン|ファゴット(低音の木管楽器)
liaise	(おもに軍隊・企業で)(〜と)連絡をつける(保つ)《+『with』+『名』》
momentary	瞬間の|瞬間的な|絶え間のない|束の間の
dandelion	タンポポ
slat	スラット|細長い薄板|板石|細長の薄板|羽根板|肋骨|に羽根板をつける
psychologically	心理的に
fasten	動物を囲いこむ|固定する|締める|しがみつく
interdependence	相互依存
serpentine	ヘビのような|曲がった|ずるがしこい|曲がりくねった物
hanging	つるすこと|絞首刑|壁紙
therefrom	そこから;それから
microtubule	微小管
fend	(剣|攻撃など)をかわす|防ぐ|扶養する|生活する
elitist	エリート主義の|エリート主義者|エリート(自認者)
parabolic	たとえ話の(ような)|比喩的な|放物線の
boreal	北風の|北の|北方の
aardvark	ツチブタ(アフリカ産のアリクイの一種)
arbitrage	さや取り|利ざやを稼ぐ手法
prowess	武勇|勇敢
hydrodynamic	流体の力に関する;流体力学の
convergent	一点に集まる
whistleblower	内部告発
sedation	鎮静状態
manhood	成年|成人であること|男子であること|男らしさ
gyro	ジャイロ(ギリシャ風サンドイッチ)
minibar	sideboard with compartments for holding bottles
oblivious	記憶していない|忘れっぽい|気づかないで|忘れさせる
highschool	高校
roughness	でこぼこ|荒ごしらえ|荒れ|荒れている所|荒削りな所|荒天|雑な部分|粗いこと|粗雑|粗野|不作法|乱暴
crucible	るつぼ
metronome	メトロノーム(音楽の拍子(ひょうし)をとる器具)
destructor	廃物焼却炉
wilco	了解(無線通信で受信したメッセージの応諾を示す言葉|will complyの短縮形)|バンド名
mutiny	暴動|反乱|反逆|暴動を起こす
cauliflower	ハナキャベツ|カリフラワー
feudal	封建制度の|封建の
unbearable	耐えられない|忍びがたい|我慢できない
cask	樽|桶(に入れる)
thermocouple	熱電対
bass	男声最低音|(次の順に高くなる|bass|baritone|tenor|alto(女声)|treble(女声soprano)|バス(魚類|スズキの類)
acceptor	認められたもの
pul	100 puls equal 1 afghani in Afghanistan
needlework	刺しゅう|針仕事|縫い物
mozzarella	モッツァレッラ
magpie	カササギ|おしゃべり
teardrop	涙の一しずく
urchin	ウニ|わんぱく小僧|いたずら坊主|子供|少年|悪ガキ
exhilarate	〈人〉‘を'うきうきさせる|陽気にさせる
endoscopic	of or relating to endoscopy
appreciative	鑑賞眼のある|感謝する
innumerable	数えきれない
leer	流し目(で見る)
disproportionately	偏って
noticeably	著しく
tet	テト川
volumetric	容積測定の
atonement	償い
extant	(古文書|記録などがまだ)現存している|現存の|実在の|今なお失われずに残っている
hyperplasia	過形成
mysteriously	神秘的に|不思議に|わけがありそうな様子で
byline	(記事タイトルの下の)筆者名を記す行|署名記事を書く|副業|アルバイト
wayward	きまぐれな|わがままな|強情な|予想外の
legit	=legitimate
redness	赤み
douche	(仏語)灌水(かんすい)|注水器
dreamland	ユートピア|眠り|夢の国|理想の国
rouble	=ruble
illustrious	すぐれた|傑出した|秀抜な|高名な|著名な|輝かしい|はなばなしい
fishy	魚臭い|いかがわしい
cringe	ぺこぺこする|媚びへつらう|(恐怖などで)すくむ|萎縮する|縮み上がる
automaton	自動化|ロボット化
freelancer	=freelance
quack	いんちきな|いかさまの|騒音|偽医者|ほらふき|ガーガー|アヒルが鳴く|アヒルの鳴き声
materiel	(仏)物質的材料|(軍の)物的装備
cooperstown	クーパーズタウン
leasehold	借地;借地権
aorta	大動脈
hetero	(ギリシア語)ヘテロ|異性愛の
upsilon	(第20ギリシア文字)ユプシロン|Υ|υ
sizable	相当の大きさの
filmy	(カーテン・氷など)非常に薄い|薄い膜のような|(湯気などで)うっすらとおおわれた
timid	おくびょうな|おずおずした|気の弱い|内気な|臆病な
grandstand	特別観覧席
afterlife	晩年|来世
encroachment	蚕食|侵略|浸蝕|浸蝕地
fuchsia	フクシア|非常に鮮やかな赤紫色のこと|アカバナ科の植物フクシアにちなんで名づけられた|後にマゼンタと名づけられ|フクシャとマゼンタはしばしば同一視される
matinee	(仏語)(演劇などの)昼興行|マチネー
magically	不思議に|てきめんに
skywalker	スカイウォーカー
thyself	なんじ自身(を|に|で)
wristband	(シャツなどの)そで口|カフス|(腕時計などの)バンド
nigh	近くに|近い
therewith	それとともに|それで|その後ただちに
contravention	違反|違反行為|軽犯罪|反対|反駁
realignment	再調整|再編成
sucrose	ショ糖|白糖
populous	人口の多い|人口密度の高い|人の多い
modesty	しとやかさ|控え目|謙遜|適度
cortisol	副腎皮質ホルモンの一種|炭水化物|脂肪|タンパク代謝を制御する生体に必須のホルモン
affix	添付する|貼る|捺す|加える|添加物|接辞
zest	風味|熱意|熱心|強い興味|レモンの皮|趣を与える
sumptuous	ぜいたくな|贅沢な|高価な|豪華な
chronically	慢性的に
unenforceable	not enforceable; not capable of being brought about by compulsion; "an unenforceable law"; "unenforceable reforms"|not enforceable|not capable of being brought about by compulsion
noone	誰も
rotc	ＲＯＴＣ|予備役将校訓練部
fisheye	of or relating to a fisheye lens
buzzer	ブザー|汽笛|サイレン|ブンブンいう虫
oaxaca	オアハカ
tracksuit	トラックスーツ(運動選手用の保温着)
wayside	路傍|道端|路傍の|沿道
spotless	しみのない|欠点のない
rediscover	再発見する
playtime	遊び時間
shogun	将軍
gerontology	長寿学