newspaper	新聞|新聞紙
capable	手腕のある|能力のある|有能な|ができる
advice	助言|忠告|アドバイス
discipline	訓練する|規律|訓練
vol	本などの巻(かん)|volume|(vol|と表示)
finding	発見|結論|(裁判官|陪審)認定|決定|裁定|結果|事実認定|付属品類
assist	列席する|手伝う
careful	注意深い
visual	視覚の|視力の|目に見える
obligation	負担|恩義|義務|債券|債務|義理|お陰
educational	教育上の
arrive	到着する
aspect	面|様子|外観|性状|顔つき|姿|(文法)動詞の相|アスペクト
stomach	食欲|胃|腹|好み|～したいという気持ち
carbon	炭素(非金属元素)|元素記号C|カーボン紙
weather	気候|天気
specifically	明確に|特に
bow	(発音 bάʊ) おじぎ|おじぎをする|屈伏する|服従させる|へさき|船首|犬の鳴き声(bow-wow)|(発音 bóʊ)弓
differ	異なる
priest	聖職者|司祭|祭司|奉仕者
smooth	なめらかになる|ならす|円滑な|なめらかな|滑らかな|滑らかにする
embrace	抱きしめる|包含する|捕える|囲む|抱擁|包囲|容認|(遠回しに)性交
van	コンテナ|大型有蓋トラック|バン|小荷物車|先頭|先導者
regional	局地的な|地域|地区
district	区|地区|区域|地域|地方
flight	飛行|(飛行機の)便
fat	太った|肥満(者)|脂肪|脂身|脂質
unknown	未知の|知られていない|未経験の|計り知れない|未知の人
sick	病気の
outcome	結果|成果
finance	財務|財政|賄う|資金を調達する|財政学
liquid	不安定な|液体(の)|流動性の|流暢な|透明な
mirror	鏡|模範|映す
resolution	決議案|決議|決定|決心|決意|決断|転換|変換|分解|分解能
fluid	変りやすい|流動性の|流体(の)|流動体
examination	試験|調査
parent	親
reflection	反射|反映|熟考
crack	〜にひびを入れる|割る|神経が参る|コカイン|パリッ|ピシッ|雷の音
darkness	暗がり|暗さ|無知|失明|秘密
fault	過失|誤り|欠点|過ち|責任|断層
secondary	二流の|衛星|代理人|第2の|二次的な|補助的な|(学校･教育が)中等の
commitment	献身|傾倒|約束
territory	販売区域|領土|地域|地方|分野|領域|縄張り
extreme	極端な|非常な|極度の|過激な|最後の|窮境|危機|最後の手段
phrase	言いまわし|言葉遣い|成句|熟語|慣用句|語法|句
reward	褒美|報奨|報酬|償い|謝礼|懸賞金|に報いる
sudden	突然の
extra	割増料金|割増の|余分の|余計な|特別の|号外|余分に|臨時の
cluster	かたまり|束|一団|群集|(花|果実の)房|群がる|房になる
session	セッション|立会い時間|開会|会期|集まり
reply	返事をする|答える|返事|答え
software	ソフトウエア|利用法
participation	関与|参加|加入|にあずかること
plot	(陰謀など)を企てる|構想をねる|地区|小区画の土地|脚色|筋
widely	広く|大きく
sing	(を)歌う
gentleman	男のかた|紳士|例の男|諸君
distinct	はっきりした|全く異なる
stable	安定した|不変の|断固とした|しっかりした|馬屋
proof	証明|証拠|試験|論証|に耐える|検査済みの|保証付きの|校正刷り
defense	防衛|防御|弁護|被告
leg	足
gently	育ちがよく|穏やかに|徐々に
distinction	区別
visible	明白な|目に見える|明らかな|今手元にある
dose	(薬の)一服|投薬する
sell	売る|売れる
wet	を濡らす|湿る|に小便をする|濡れた|保存された|酔った|雨降りの|禁酒反対者|湿気
poem	詩
fill	満たす
union	労働組合|結合|合同|連合国家|連邦|組合|英国国旗|同盟
functional	機能の
milk	牛乳|ミルク
incident	起こりやすい|ありがちな|出来事|事件(ささいに見えるが大きな外交問題に発展するような)
tension	緊張|伸張|緊迫|電圧|張力
commonly	一般に|通例|下品に|粗野に|通俗に|普通
hurry	急ぐ|を急がせる|急ぎ
exception	例外|除外|異論|異議
collective	全体的な|共同の|集団の
lift	解除する|向上させる|持ち上げる|高揚|昇進|助力|リフト
parallel	平行の|平行線|類似点|と平行する|と似ている
facilitate	容易にする|促進する|楽にする
communicate	知らせる|通信する|伝達する|伝える
rare	まれな|めずらしい|特別すぐれた|(空気など)希薄な
schedule	表に作る|予定する|一覧表|予定(表)|スケジュール
honor	名誉(となるもの)|光栄|尊敬|栄誉を授ける
arrest	逮捕する|引き止める|阻止する|逮捕(=apprehend)
switch	スイッチ|スイッチを切り換える
connect	をつなぐ|関係づける|つながる|link
bill	法案(legislation)|ビラ|紙幣|100ドル(紙幣)|起訴状|請求書|番組|くちばし
slight	わずかな|軽微な|細い|かよわい|軽視する|ばかにする|なおざりにする|軽視|無礼|侮辱|冷淡
plain	明白な|質素な|率直な|(味が)あっさりした|平原|平野
sacrifice	いけにえにする|犠牲になる|供え物|いけにえ･犠牲|を犠牲にする
candidate	候補者|～しそうな人|志願者|志望者
rural	rural|都会(urban)に対し|田舎(いなか)風の|田園の
stroke	をなでる|ストローク|一撃|打撃|発作|(脳)卒中|一回の動作|(ペン･筆などの)一筆
naturally	生まれつきに|自然(天然)に|生来|もちろん
typical	典型的な|独特の|象徴的な|を象徴する|特有な
mid	中間の|中央の|中部の|の(最)中に
traffic	交通|交通の
insight	洞察(力)|見抜く力|眼識
immediate	すぐ隣の|直後の|即座の|当面の
pool	水たまり|小さな池|ため池|貯水池|生産連合|企業連合|共同投資|チーム対抗
marry	結婚する
snow	雪
preparation	準備|用意
brand	汚名を着せる|商標|焼印を押す
wealth	豊富|富|裕福|財産
somewhere	どこかに|ある時|何時か|およそ
estate	財産|地位|社会上の地位|地所|不動産権|土地|私有地|生活状態|遺産
mix	混ぜる|交際する|混ぜて作る|混ざる|混合
trail	跡をつける|引きずる|の後を追う|(人･動物が通ってできた)道|痕跡|航跡|手掛かり|裁判|公判
apartment	アパート
crop	刈り込む|群れ|産出高
primarily	主として|第一に|最初に
protest	異議の申し立て|に抗議する|抗議|異議|主張|言明|断言
blame	を非難する|のせいにする|非難|責任
expense	支出
delivery	配達|配信
cash	現金にかえる|現金|現金および預金
twice	2倍|2度|2回|2倍に
tiny	極めて小さな|ちっぽけな|ちっちゃな|非常に小さい|小さな
reasonable	道理にかなった|思慮分別のある|適度な|妥当な
diagnosis	診断
pale	色を失った|青ざめる|青白い|(色に関して)薄い|迫力がない|薄くなる|見劣りする
storage	保管|貯蔵(所)|記憶|蓄電|保管料|記憶装置
club	クラブ|部
considerable	少なくない|かなりの|相当の|重要な
composition	構成|創作|作文
exhibit	展覧する|公開する|展示品|展示する|証拠
minister	大臣|公使|聖職者|召使い|仕える
entrance	入口
principal	重要な|主要な|第1の|元金の|主役|支配者|校長|社長|主犯|第一債務者
engine	エンジン
quantity	量的な|分量|量|数量|額|多量|音量|期間
net	網|ネット|クモの巣|インターネット|正味の
mere	単なる|ほんの
photo	写真|写真にとる
sugar	砂糖スプーン一杯|砂糖|角砂糖一個
minimum	最小限度|最小限|最低限
awareness	認識|意識性
cat	ネコ
introduction	紹介|導入|序論
passion	激情|熱情|感情|熱中
customer	得意先|客|得意客|注文の
happiness	幸福|幸せ|適切さ
structural	構造(上)の
peak	頂点|峰|最高点|先端|を最高にする
accident	天災|偶然|事故|災難
emphasis	強調|重要性
storm	突入する|強襲する|嵐(が吹く)|暴風
camera	カメラ
consistent	不変の|矛盾のない|一致した|両立する|矛盾しない|首尾一貫した
ease	慎重に動かす|そっと位置を移す|楽にする|安楽|軽減|気楽|容易
thy	汝の|なんじの|そなたの
west	西
select	を選ぶ
equally	同等に
won	ウォン(韓国･北朝鮮の通貨単位)|winの過去･過去分詞
dad	お父さん|パパ
shake	を振る|震える|を動揺させる
building	建物
linear	線状に伸びる|線の|直線の|長さの|線形の
perfectly	完全に|申し分なく|まったく
transaction	処理|取り扱い|取り引き|取引|報告書
virtue	長所|徳|美徳|善|貞節|美点|効力|きき目
wonderful	すばらしい
yard	庭
vast	広大な|巨大な|莫大な|巨額の
movie	映画
subsequent	それに続く|その後の|次の|後に来る
gesture	身振り|手ぶり|ジェスチャー
tomorrow	明日
spin	を回転させる|一走り|を紡ぐ|を吐く|回転させること|落下|世論操作|情報操作|前向きにいい面を強調する
temple	こめかみ|神殿|神殿･寺院|教会|殿堂
meat	肉|食事|要点
cock	オンドリ(自惚れた動物の象徴)|(水道などの)蛇口|コック
defeat	を打ち負かす|beat|敗北|失敗
grant	を認める|を与える|(願い)をかなえてやる|交付|補助金
mg	ミリグラム|質量の単位|0|001グラム
odd	奇数の|余りの|～余り|残りの|時々の|片方の|半端な|妙な|変な
pace	歩み|一歩|歩調|速度|歩幅|歩き方|(を)ゆっくり歩く|歩調を整えて歩く
era	年代|紀元|時代|段階
zero	0|ゼロ
landscape	の風景を美化する|庭師をする|景色|風景画
excellent	優秀な|優れた|卓越した
deserve	を受けるに足る|に値する
enterprise	進取の気性|計画|企て|仕事|事業|企業
evolution	進化(論)|発展|展開|考案|旋回|放出
smart	スマートな|利口な|ずきずき痛む|苦悩|厳しく|痛み|苦痛
quietly	静かに|落ち着いて|平穏に
apparently	明らかに|見たところでは
owe	負う|おかげだ|借りている
conference	協議|相談|会議|協議会
currently	現在(のところ)(at present)|(世間)一般に
blind	盲目の|無感覚の|行き場のない|理解できない|見えなくする|日除け|ブラインド
defend	防衛する|守る
wound	傷つける|心の傷|wind(巻く, 吹く)の過去･過去分詞
deliver	配達する|配信する|渡す|(講義など)をする