loony	頭がおかしい
foreplay	(性行為における)前戯
mutate	変化する|突然変異する|母音変化する
whimsy	気まぐれ|物好き|奇抜な言葉･行動
voluptuous	官能的な|なまめかしい|肉欲にふける
complacent	自己満足の|満足そうな|悦に入って|ひとりよがりの
hardworking	勤勉な|よくはたらく
antagonism	敵意|反対
unaccompanied	連れのない|ただひとりの;(〜に)伴われない《+by(with)+名》|(音楽演奏が)無伴奏の
uhh	うう
maximization	最大化
absenteeism	長期欠勤|無断欠勤|常習的欠席
quantifiable	定量化できる
leptin	レプチン|脂肪細胞によって作られ|飽食シグナルを伝達し|エネルギー消費増大をもたらし|肥満の抑制や体重増加の制御の役割を果たすホルモン
penalize	罰する
isometric	等大の|等距離の
retraction	引っ込ませること|取り消し|撤回
loveless	愛のない;愛させない;かわいげのない
demarcation	境界|分界|区分|管轄|縄張り|限界
cerebrospinal	脳脊髄の|中枢神経系の
impure	澄んでいない|混ざり物のある|不純な
gridiron	=grill{名}1|《米》フットボール競技場
innermost	最も奥の|深く心に秘めた|心底の(=inmost)
rumba	(スペイン語)ルンバ|キューバの民族舞踊音楽
wry	ゆがんだ|皮肉たっぷりな|こじつけた|曲がった
spunk	(口)勇気|気力
confocal	共焦点
alms	施し物|信施|施し|慈善
meditative	瞑想的な
pica	異食症|栄養価の無いもの(土・紙・毛・氷・チョークなど)を無性に食べたくなる症候|小児と妊婦に多い|(picaはラテン語でカササギ)
quell	鎮圧する|抑えつける|止める|鎮める|抑える
equivalently	同等に
incase	=encase
stringed	弦のある;《複合語を作って》;弦の
gaucho	ガウチョ(南米|特にアルゼンチンの草原地方のカウボーイ;インディアンとスペイン人の混血人が多い)
evasive	回避する|言い逃れの|回避的な
factorial	要因の|階乗の
ferment	混乱|酵素|発酵する･させる|沸き立たせる|刺激する
guesswork	当てずっぽう|当て推量
replete	十分に備えた|充満した
inconceivable	想像もつかない
failing	に失敗する
calmodulin	カルモジュリンカルシウム結合タンパク質|(多種類のタンパク質に制御を行うため|様々な細胞機能に影響を与える)
mausoleum	陵|廟|大霊廟|壮大な墓|みたまや|みささぎ
anklet	(靴の)留め革|足首までの短いソックス
claret	クラレット(フランス産の赤ぶどう酒)|赤紫色|赤紫
beholder	見る人
determinism	決定論
normality	常態|標準的なこと
unsung	詩歌によってほめたたえられない
ingot	(金属の)鋳塊|鋳棒
mitogen	マイトジェン|分裂促進因子|有糸分裂促進剤
intensification	強化|増大
carafe	ガラス瓶
liver	肝臓|レバー|きも|茶褐色|の生活者
mistletoe	ヤドリギ
tryout	適性試験|テスト|オーディション
surmise	推測(する)
stagecoach	駅馬車|郵便馬車
manageability	扱いやすいこと|処理しやすいこと
soundproof	防音の|〈部屋・建物など〉‘を'防音する
bramble	イバラ(植物)
homogenous	均質な
policyholder	保険契約者
tidewater	潮水(海岸・河口に差してきた潮水)|海岸地方
expendable	消耗の
follicular	濾胞(ろほう)|動物の組織にある完全に閉じた袋状の組織
shiner	宝石
gonorrhea	淋病(病名)
lawmaker	立法者|legislator|(国会)議員
flavorful	風味豊かな
cosponsor	(議案の)共同主唱者(提案者);共同スポンサー|〜‘の'共同主唱者(提案者)になる|共同スポンサーになる
polyacrylamide	ポリアクリルアミド|水溶性合成樹脂の一種として原油の回収助剤|廃水処理用凝集剤|洗濯糊|接着剤(合成糊)|塗料などに広く用いられる
sensibly	感じられるほどに|目立って|賢明にも
biathlon	バイアスロン(射撃とスキーを組み合わせた競技)
moxie	活気|精力|ファイト|ガッツ|技術(知識)
biff	すばやいパンチ|一撃|〜'を'ぶんなぐる|‘に'一撃を加える
sidewall	側壁|サイドウォール(タイヤのトレッド(tread)とリム(rim)との間の部分)
turd	(一塊の)糞|くそ野郎|げす
inexplicable	不可解な|説明しがたい
initio	「第一原理」の意(化学･物理･生物他で)
hypothermia	低体温;(医療における)体温低下[法]
expeditious	急速な|迅速な
timberline	樹木限界線(環境・条件の変化のため高木の生育が不可能となる地域的限界線)
intently	熱心に
chrysalis	(ガやチョウの)さなぎ|まゆ
raincoat	レーンコート
destruct	自動的に破壊する
penance	ざんげ|懺悔|苦行|いやだがしなければならないこと
proliferate	増殖させる|増殖する|繁殖
hoary	白髪の|昔の(old)|白い|霜のように白い|年老いた|神々しい|古めかしい
corse	=corpse
trillium	ユリ科エンレイソウ属の植物
swot	〈C〉《英話》がり勉家|猛勉強家(《米》grind)|〈U〉がり勉|がり勉する|(試験前に)〜‘を'詰め込みで勉強する《+up+名|+名+up》
andante	(音楽の演奏の指示で)アンダンテ|ゆるやかに(な)|アンダンテの楽章(楽曲)
overtly	明白に|公然と
lurch	窮地|苦境|急に傾くこと|大敗|よろめく
simile	直喩|(ものごとを例えて表現する手法のひとつ)|likeまたはasなどで形成される|ex|Her eyes were like stars|(metaphorの項参照)
trowel	こて|コテ
bask	恵まれる|幸せな境遇にある|暖まる|浴する|日なたぼっこをする
bannister	=banister
kebab	カバブ|ケバブ|トルコ料理の一種
tiredness	疲労;けん怠
restorer	元へ戻す人|修復する人
methylene	メチレン|メチレン基(methylene group)とは|有機化学における2価の基の一種|メタンから水素が2個取り除かれた構造を持つ
subsist	存続する|生きて行く|生存する
cofactor	補因子(規定の結果を出すために他の物質と結合しなければならない|補酵素のような物質)|コファクター|共通成分とも
oppress	圧迫する|苦しめる|重圧感を与える
discreetly	慎重に
leprechaun	レプレコン(小さい老人の姿をした妖精)
hookah	水ぎせる(たばこの煙を水の中を通して吸う)
morgue	死体保管所|陰気な場所|参考資料館|(口)横柄|傲慢
dumbass	まぬけ
redden	赤くする
sateen	(サテン(satin)に似せた)綿じゅす
polyhedron	多面体
uhm	えー|あの|その
autosomal	常染色体の
restful	休息を与える|安らかな
eyeliner	アイライナー|目の輪郭を際立たせるためまぶたの縁に塗る化粧品
splat	薄い平板
aristocratic	貴族の
chomp	をむしゃむしゃ食う(champ)
profitably	有利に|有益に;(結果として)利益を得て
offload	=unload
granule	顆粒
obelisk	オベリスク|方尖塔
admittance	入場許可
ageless	不老の;永遠の
hurl	投げつける|力いっぱい投げつける
internment	収容|抑留|留置
porridge	(英)ポリッジ(オートミールのかゆ)
cede	譲る|割譲する|引き渡す|認める
cheeseburger	チーズバーガー
standstill	行き詰まり|停止(した)|行詰り
unattractive	魅力のない
toucan	オオハシ(熱帯南米産のくちばしが大きな鳥)
beefy	肥満した|たくましい
repressor	抑制物質|抑制因子|阻止物質|リプレッサー|抑制遺伝子
discoideum	キイロタマホコリカビ|細胞性粘菌の一種|分子生物学|遺伝学のモデル生物として|細胞間連絡|分化|アポトーシスの例として研究されている
falsify	反証をあげる|偽る
promulgation	発布|公表|普及
fistful	ひとつかみ|一握り|多額の金|多数
incognito	お忍びで|匿名で|変名で
silliness	ばかなこと
macaw	(動物)金剛インコ|(植物)オニトゲココヤシ
redevelop	再開発する|再現像する|最発展する
gerbera	ガーベラ(キク科の多年草)
barnyard	納屋の前庭|農家の庭
crier	クライヤー|叫ぶ人|泣き虫|廷吏|廷丁
hepatocellular	肝細胞の
styrofoam	スタイロフォーム(発砲スチロールの一種)
pillage	略奪(する)|戦利品
cwm	(ウェールズ語)圏谷(けんこく)(氷河の浸食によって山頂などにできた円形のくぼ地)
forceps	ピンセット(=tweezers)
ccw	counterclockwise
argumentation	議論|討論|立論|論証
passively	受動的に|受け身に
multifaceted	多面
wahoo	ニレの木
derange	〜‘を'錯乱させる|狂わせる
savour	風味
touchy	気難しい|微妙な|気を使わねばいけないような
unintelligible	理解できない|聞き取れない
infantile	幼時の
unspeakable	言いようのない|言うに言われない|口にするのも恐ろしい|口では言えない|お話にならない
sorbet	シャーベットsherbet
hemodialysis	血液透析
guildhall	(中世の)ギルド集会所;同業者集会所・市公会堂|市ホール;《the G-》ロンドン市庁
piney	piny|松の(茂った)|松のような
disgraceful	不面目な
houseware	家庭用品
disburse	(金)を支払う|(金･費用を)支払う|支出する
fractionation	分割|分画法|フラクショネーション|分別作用|分割放射線療法
dandruff	(頭の)ふけ
proximate	近似の|最も近い|直前の
idem	同上|前述の部分|同上の|前述の
exemplify	範例となる|例示する|典型的に示す|体現する
quiche	キッシュ|キシュ(パイの一種)
pitchfork	熊手
animosity	敵意|憎悪|憎しみ|恨み
hairpin	ヘヤピン|ヘアピン|U字形の
unprofessional	専門外の
corroborate	確証する|確認する
paediatrics	=pediatrics
flaunt	見栄を張る|誇示(する)|見せびらかす|(旗など)が翻る
idealist	理想家
relativism	相対論(主義)
noose	(引くと輪が締まるようになっている)輪なわ|引き結び|(縄を結んだ)輪
tripwire	わなや仕掛けを動かすため地面に張った針金
differentially	差別的|異なって
encephalopathy	脳症
debatable	議論の余地のある
loading	荷積み|船荷|装填|ディスクの挿入
marcasite	白鉄鉱(宝石類似の装飾品を作るのに用いられる)
reroute	新ルートで送る|別の経路に切り替える|旅程変更する
decisively	断固として
heyday	全盛期|(若さ･元気･繁栄などの)盛り|絶頂
undeniably	紛れもなく
spasm	痙攣|けいれん|発作(=sudden attack)|ひきつけ(=fit)
eminently	大いに|著しく|抜きんでて
mercilessly	無情に|容赦なく
churchyard	教会所属の墓地|教会の境内
toke	マリファナたばこの一服|〈マリファナたばこ〉‘を'吸う|‘に'火をつける
boggle	しりごみする|英単語をつくるゲーム
sanctum	私室|書斎|神聖な場所
heinous	極悪の|凶悪な|憎むべき
dusky	薄暗い
tabasco	メキシコ・タバスコ州原産のキダチトウガラシの一種チレ･タバスコ(タバスコペッパー)を使った辛味調味料
masochism	マゾヒズム|自己虐待|被虐的傾向
infallible	全く誤りのない|絶対確実な|信頼できる|必ず起こる
swordsman	剣士|剣術家
prosthetics	《単数・複数扱い》(外科・歯科の)補綴(ほてい)術
pasty	ねり粉のような|のりのような|しまりのない|顔色が青白い
phosphor	燐|(蛍)燐光体|蛍光体
incessant	絶え間なく続く
adjudicate	(計画など)を決定する|宣告する|裁く|判決をくだす
neoplastic	腫瘍性の
overburden	〜‘に'荷を積み過ぎる|《受動態で》(仕事などを)〜‘に'負わせ過ぎる《+『名』+『with』+『名』》
applesauce	リンゴソース|(俗)たわごと
realign	再編成する
cheery	明るい
harshly	耳障りな
feisty	怒りっぽい|短気な|高慢な|元気のいい|攻撃的な
nonverbal	非言語的な
slush	ぬかるみ|雪解け|廃油
mutton	羊肉|マトン|ヒツジ
revisionist	見直し論者|異質論者|リビジョニスト
congruent	一致する|(図形が)合同の
eyeshadow	アイシャドウ
aphis	=aphid
lough	湖|入江
wigwam	(小枝・アシ・こさなどで作った)アメリカインディアンの小屋
yardstick	基準|ヤード尺(ものさし)
midge	蚊|ブヨ|小さい人
merrily	楽しく|陽気に|愉快に
blackness	黒度|黒いこと|黒さ|暗黒|凶悪|肚黒さ|陰険|陰鬱|険悪
transitory	一時的な|つかの間の|はかない
encampment	野営すること|野営地|陣地
larynx	喉頭|咽頭
thresh	(からざおで)〈穀物〉‘を'打つ|(脱穀機で)〈もみがら〉‘を'取る《+名+with+名》|《まれ》〜‘を'打つ(thrash)|脱穀する|激しく打つ
tartar	酒石(ワイン製造時の沈殿物)|歯石
slither	ずるずる滑る
reefer	マリファナ|マリファナタバコ|(鉄道の)冷凍車|冷蔵トラック|冷蔵船|リーファー(丈夫な通例青い布製のダブルの上着)
pragmatism	実用主義|道具主義
rct	receipt|recruit
mortgagee	抵当権者
altruism	利他主義|博愛主義|(類)philanthropy(博愛主義|慈善)|(反)misanthropy(人間嫌い|厭世|人間不信)
capricious	気まぐれな
antifreeze	不凍液
juxtaposition	並置|並列|(比較対照のために)並べること
hemodynamic	血行動態
gradation	段階的変化|等級付け|階級別にすること|順序|次第|等級|段階
annulment	取り消し
bedstead	寝台の骨組み
ruddy	血色のいい|赤い
academe	大学(学究)生活|学界|教育の場(特に大学)
stirrup	あぶみ|かすがい
gosling	ガチョウの子
icebreaker	砕氷船
weighty	重い|重荷となる|重大な|有力な
subsidence	沈下・減退|鎮静
afterglow	夕焼け|夕映え|(成功後の)楽しい快感
promiscuous	ごたまぜの|乱交の|無差別の
slouch	不精者|ぐうたら|だらりとたれる|前屈みになる|猫背になる|不格好に歩く
hyena	ハイエナ
sago	サゴ(サゴヤシの幹から製するでんぷん)|=sago palm
freshen	いきいきとする|新鮮にする
parentage	生まれ|家系|家柄|親であること
walkabout	放浪旅行|徒歩旅行
proprietorship	所有権|個人事業
waistcoat	チョッキ|ベスト
outlandish	外国風の
chitty	Chitty Chitty Bang Bang|イギリスの映画
beautify	美しくする
ataxia	運動失調
camaraderie	友情
bullhead	北米産の頭が大きいカジカの一種
abysmal	底知れぬ
bourse	(特に欧州の)株式(証券)取引所|金融市場
camber	上反(うわぞり)(道路や船のデッキなどの|雨水などを端に流すための傾斜)|(自動車の|ふつう前輪の)上開き傾斜|上反になる|〜'を'上反にする
tilde	スペイン語で n の上につける記号.ñの上の記号（「ニャ」とか「ニョ」といった音を表す）・波形符号、波形ダッシュ・= swung dash
tenacity	固執|粘り強さ|頑強|不屈
denture	(一組みの)義歯
workhorse	使役馬|働き者
moslem	イスラム教の
permanence	永久|永久不変|永続(性)|耐久(性)
coincident	同時に起こる
monotype	モノタイプ(活字の鋳造植字機械)|〈U〉モノタイプ印刷方式
enviable	ねたましい|うらやましい
categorically	範疇の(をなす･に属する)|分類別の|絶対的な|断定的な
foothold	足場|拠点|地盤|よりどころ|立脚点
catnip	イヌハッカ(植物)
inflection	(文法)屈折形
eloquently	雄弁に
hanky	ハンカチ
bluish	青みがかった
sheathe	〈刃物など〉‘を'さやに納める|(保護物で)〈物〉‘を'おおう|包む《+『名』+『with』(『in』)+『名』》
ambivalent	あいまいな|相反する物･意見･感情を持つ
appellation	名称|呼称|称号
bruise	打撲傷|打ち身|挫傷|傷跡|傷つける|に傷を与える|へこませる|あざをつける
cornucopia	(ギリシア神話)豊穣の角(つの|幼時のZeus神に授乳したとされるやぎの角)|くだもの･花のあふれた角|豊かさの象徴|豊富
speedometer	速度計
lewd	みだらな|放蕩な|下劣な
runny	柔らか過ぎる|粘液を分泌する|流れやすい|流れる傾向のある
thither	そこへ|あそこへ
assuredly	確かに
vesicle	(医)|小水泡|ベシクル|小疱疹|小胞|小嚢|小胞
viaduct	陸橋|高架橋
constabulary	警官隊
intelligible	理解できる|わかりやすい|知性的な
defibrillator	除細動器|細動除去器(心臓疾患医療具)
timbre	音色|音質
moorland	荒れ地
adversarial	対立する|敵対する|反対の|反対者の
demonstrator	デモ参加者|示威運動者|実験の助手|実地説明者|証明者
upturn	景気上昇
boyhood	少年時代
sustenance	維持すること|食物|栄養物|生計
campion	センノウ・マンテマなどナデシコ科の多年草
fester	(悲しみなどが)うずく|痛む|苦しめる|ただれる|(傷などが)膿む|腐る
disrespectful	失礼な
curd	凝乳|乳が固まったもの
diagonally	対角線上に
glint	きらきら光る
wizardry	魔法|魔術|妙技
fervent	熱烈な|誠意を込めた|強烈な|熱い|焼ける|燃える
wacko	頭のおかしいやつ|へんなやつ
triplex	3倍の|3重の|《米》(各戸独立の)3階建てアパート|〈U〉《しばしばT-》《英》《商標名》(自動車用の)3重ガラス
delusional	妄想の
tosh	あなた|あのう|きみ|がらくた|戯言|ナンセンス
peeler	(野菜などの)皮むきナイフ
passageway	廊下
herbalist	植物学者|漢方医|薬草商
aggravation	悪化|重大化
machete	なた(中南米で砂糖キビを切ったり|また武器として用いる)
lariat	投げ縄
halve	等分する|半減させる
firmness	確固不動|強硬|決意の固さ|堅さ|堅固|堅実|断固とした態度
petticoat	ペチコート|短いスカート|スカート型のもの
swindle	だます|詐欺(を働く)|を詐取する
unequivocally	明白に
selfless	無私の
scrip	1ドル札|仮株券|仮社債|軍票|(代用)紙幣|臨時紙幣|処方箋
whoop	大声で叫ぶ|叫び声|喚声|ホーホー鳴く(声)
perspiration	努力|汗|発汗(作用)
earthworm	ミミズ
chug	(エンジンなどの)ポッポッという音(を立てる)
liquidator	[公認]清算人
mirth	陽気|歓楽|歓喜
moiety	半分|一部分|(一人の)分け前
tasting	試食|試飲|味見
livable	住むのに適した|住みやすい
earpiece	《通例複数形で》(帽子の)耳おおい|《通例複数形で》(眼鏡の)耳づる|〈C〉受話器;イヤホーン
counterproductive	逆効果の(を招く)
tusk	tusk(切歯由来の牙|象･イノシシ･セイウチ･カバ等)|牙で突く
environmentalism	環境保護主義
instep	甲|足の甲|((反)sole)
neoclassical	新古典主義の
mediaeval	=medieval
adenine	アデニン|核酸を構成する5種の主要塩基の一つ|シアン化水素とアンモニアを混合し加熱するだけで合成されるため|原始の地球でもありふれた有機物だったと考えられる
petunia	ペチュニア(花)
lysis	(生物学用語)溶解|細胞溶解|崩壊|溶菌|(本来「分解」の意を表す語尾
helicase	ヘリカーゼ(ヘリケース)|核酸のリン酸エステル骨格に沿って動きながら絡み合う核酸をほどく酵素の総称|すべての生物に必須と考えられる
embarassed	恥ずかしく
nanotube	ナノチューブ
mignon	かわいらしい|愛くるしい
lifesaving	救命の
smokeless	煙のない|煙を出さない|無煙の
volition	決断力|決意|選択|意志力
scrimmage	スクリメージ|つかみ合い|小ぜり合い|組み打ち|乱闘|練習試合|スクリメージをする|せわしなく動き回る|乱闘する|練習試合をする|と戦う
thorax	胸|胸部
placental	胎盤の
warship	軍艦
kerb	=curb3
inboard	機内発動機|船内の|内向きの|運が良い|順調で
epicenter	中心|中核|震央(震源focus･hypocenterの真上の地表の1点)
metamorphic	変態の|変態を特色とする|変成の
flatiron	アイロン|こて
trophic	栄養の
bursa	滑液嚢
paratrooper	落下傘降下兵
insemination	受精
typescript	〈C〉タイプライターで打った原稿|〈U〉タイプライター印刷物
booby	田舎者|まぬけ(pl|boobies|ぱいぱい)
conceivably	考えられる限り
quetzal	ケツァル(中南米産の長い美しい尾を持つ鳥)
xylene	キシレン(xylene)|芳香族化合物|医学･生物学分野で薬剤･溶剤の原料として使われる|キシロールとも呼ばれる
schism	〈U〉(団体|特に教会の)分裂|分離|〈C〉(教会の)分派
conch	ホラガイ|巻き貝(の貝殻)|丸屋根|半円形屋根|オレンジを帯びたピンク|まじめ学生
cytotoxicity	細胞毒性
exuberant	豊富な|あふれるばかりの|元気な|生き生きした|(植物など)生い茂る
pretest	(新製品などの)試用|予備テスト|〜‘を'試用(予備テスト)する|試用(予備テスト)する
narcissus	スイセン|(N-:ギリシア神話)ナルキッソス
subdue	を征服する|を抑える|鎮圧する|抑制する|緩和する
electrification	充電|感電|強い興奮|強く感動させること
peninsular	半島(状)の|イベリア半島の
composure	落ち着き|落着き|沈着|平静
finitely	有限の
birthright	生得(せいとく|しょうとく)権|生まれながらに持っている権利|(例|米国領土内で生まれた子は市民権条項(Citizenship Clause)により自動的に米国市民権を持つ等)
corny	つまらない|古くさい|ださい|穀物の
histocompatibility	組織適合性
errant	誤った|正道からはずれた|(諸国)遊歴の|冒険的遍歴の
musicale	社交音楽会;(非公開の)音楽演奏会
heifer	(まだ子供を産んでいない)若い雌牛(女性)
earthen	土製の|陶製の
sulfuric	イオウの|イオウを含む|硫酸
rendering	完成予想図
portcullis	落とし門(攻撃に対して直ちに開閉できる鉄格子の城門など)
operon	オペロン(Operon)|一つの転写因子によって同時に発現が制御される複数の遺伝子が存在するゲノム上の領域|あるいはその複数の遺伝子の組のこと
ultimatum	最後通牒|最後の言葉|最後の申し出|根本原理
stratigraphy	層位学|層序学(地質学の一部門)
spoonful	一さじ|スプーン一杯(分)
desirous	欲している
surefire	必ずうまくいく|成功疑いなしの
waterworks	水道設備|上水道
captivate	の心を捕える|を魅惑する|人をうっとりさせる
wench	(特に田舎の)女の子|娘;淫婦
rummage	くまなく捜す
unionist	組合員
discernible	認識できる|識別し得る
intercession	仲裁
best	ベストの|最もよく
orator	雄弁家|演説者
homophobic	同性愛嫌悪症の
diamondback	ヒシモンガラガラヘビ(ひし形の斑(はん)点がある毒蛇)
retrace	さかのぼる|回顧する
lode	鉱脈|鉱床
epidermis	表皮
peptic	消化を助ける|消化力のある|ペプシンの|消化液が引き起こす|消化剤;《複数形で》消化器官
pendent	ぶら下がった|垂れ下がった|張り出た|覆いかぶさった|未決定の|=pendant
sparingly	不足して
hypothalamus	視床下部|間脳(視床の前下方)に位置し|自律機能の調節を行う総合中枢
priestly	聖職者の|僧らしい
seaplane	水上飛行機
insomniac	不眠症患者
conspicuously	目立って
breaststroke	平泳ぎ
blip	レーダーに映るシグナル|(不隠当な発言を妨害する)中断音
eagerness	熱心
pearly	真珠のような|真珠で飾った
letterbox	=mailbox
polemic	論争の|論客|論争
dietician	栄養学者|栄養士|食事療法士
roadhouse	街道沿いの旅館|居酒屋
minefield	地雷(機雷)敷設面|地雷原(機雷)原
doublet	(文法)accusative case対格|名詞がもつ格のひとつ|他動詞の直接目的語を示す時使われる(ご飯を作る|など)|対格は全印欧語族に存在
recklessly	無謀にも
phospholipase	リン脂質を脂肪酸とその他の親油性物質に加水分解する酵素
transformative	変形させる
anhydrous	無水
germplasm	胚(はい)原質|生殖質|遺伝資源
parkin	パーキン|(オートミール･ショウガ･糖蜜で作るケーキ)
roan	(馬などが)あし毛の|あし毛の動物(特に|馬)|あし毛色
blimp	小型飛行船|でぶ|ブタ|頭の固い保守的な人
ravioli	ラビオリ(こまぎれ肉を小麦粉の薄皮で包んだ料理)
cropland	耕作に適した土地
trundle	ごろごろ動く|転がす
periwinkle	[ツル]ニチニチソウ
racy	ちょっときわどい|きびきびした|本場の
haystack	干し草の山|hayrick
flit	かろやかに飛ぶ|ひらひら飛回る
topsoil	表土
spate	大量|豪雨|大水
hypnotist	催眠術師
screech	かんだかい声(をあげる)|金切り声(で叫ぶ)|ブレーキをきーっとかける(音)|キーッ
domestication	家畜化|野生動物の家畜化
outwardly	外面的に
tumultuous	騒然とした|騒動を起こす|騒々しい|ひどく興奮した
symbiotic	共生の
wattle	(鶏などの)肉垂(にくすい)|ワットル(マメ科アカシア属(Acacia)の総称|黄色の花が咲く大木|オーストラリアの国花)|編み枝(細工)
zany	道化師|ばか者|おどけ者|おどけた|ばかげた
squirter	(液体の)噴出器|噴霧器
polyvinyl	ポリ［重合］ビニールの・ポリビニールの
ganglion	(gˈæŋgliən)(複|ganglia)|神経節|ガングリオン|結節腫(主に手首にできる良性の嚢腫)|知的･産業的活動の)中心|中枢
unimaginable	想像できない
gavel	(議長･裁判官･競売人などが静粛を促すときに卓上をたたく)小槌
moonshine	(俗)密造ウイスキー
centimeter	センチメートル
idolatry	偶像(邪神)崇拝|盲目的崇拝|心酔
firework	花火|才気のひらめき
involuntarily	無意識に|思わず知らずに
aggravate	悪化させる|怒らせる|悩ませる
adoptee	里親
grandmaster	チェス名人|《G- M-》(騎士団・友愛会などの)団長|会長
historiography	歴史学|史書|(記録された)史実|(厳正な)歴史記述|正史
militarism	軍国主義|軍人魂
glassy	どんよりした|ガラス状の
gash	深傷|長く深い切り傷
shrill	鋭い音を出す|鋭い|かん高い
homozygous	ホモ接合型|同型接合体とも呼ばれ|遺伝学で二倍体生物のある遺伝子座がAA|aa のように同じ対立遺伝子からなる状態のこと
guillotine	断裁機|ギロチン|断頭台|ギロチンの刑|打ち切る
discussant	討論者
utensil	器具|(台所･酪農場などの)道具
stopover	途中下車の
misfit	合わないこと|不釣り合い|不適任者
afflict	苦しめる|悩ます
quotable	引用する価値のある
zirconium	ジルコニウム(金属元素;化学記号は Zr)
alternation	交代|交互
naturalistic	自然のままの|自然を模倣する|自然誌研究の|自然主義の|博物学の
dogmatic	独断的な|教義上の|教理に関する|独断主義の
rectification	改正|修正|調整|(化学)精溜|(電気)整流
surly	険悪な
preeminent	卓越した
swoon	気絶(する)|次第に消えていく|衰える
nonparametric	ノンパラメトリック|(統計用語)母数によらない|統計のパラメーターに関わらない
consignee	(商品の)荷受人;受託者
mistral	(仏語)ミストラル|フランスの地中海岸に吹く北風
admirer	賞賛者|崇拝者
gringo	(中南米地方で)外国人|特に英米人(軽蔑的)
wanderlust	旅行熱|放浪癖
immediacy	直接|直接性|即時性|直感|直覚
aviary	(大きい)鳥のおり|鳥類飼育場
candor	率直|正直|虚心坦懐|率直さ|公平無私|親切|白さ|純真無垢
gasification	ガス化
sundae	サンデー|トッピングが載ったアイスクリーム
assassinate	暗殺する
pinewood	松材|松林
tangential	接線の
croissant	クロワッサン|三日月パン
pucker	しわを寄せる|ひだ
homily	説教|訓戒|くだくだしい小言
glebe	〈U〉《詩》土|土壌|〈U〉〈C〉(またglebeland)《英》小教区教会耕地|聖職領畑地
maelstrom	大渦巻き|大動揺|大混乱
scuttle	やめる|急いで行く|ほうほうの体で逃げる|小窓|石炭入れ|バケツ
salami	サラミソーセージ
dank	じめじめした|湿っぽくてうすら寒い|湿っぽい
affectionately	愛情をこめて
dodgeball	ドッジボール
uneducated	教育を受けていない|無教育の|無学の
alopecia	脱毛症
anchovy	アンチョビー(地中海原産のカタクチイワシ科の魚)|その塩漬|オリーブ漬
beachside	浜辺の
proportionately	比例して
bothersome	面倒な
draconian	(法律など)(きわめて)厳しい|苛酷な
pupa	さなぎ
cowbell	牛鈴(牛のいる場所がわかるように牛の首につるした鈴)
articular	関節の
sandstorm	砂あらし
mete	を割り当てる|分け与える|計測|計量
turban	ターバン(回教徒が頭に巻く)|ターバン風婦人帽
duchy	公爵領|公国
autocorrelation	自己相関
wadi	ワジ|かれ谷(アラビア･北アフリカ地方の雨期以外は水がない谷川)
fain	喜んで|快く|(I would fain give up the sword|棄つべきものは弓矢なり)
guanine	グアニンは核酸を構成する5種類の主な塩基のうちのひとつ|グアニンから誘導されるヌクレオシドはグアノシン|魚類の銀白色部位を構成する主要成分である
firecracker	爆竹|爆弾|爆筒|癇癪玉|魚雷
cruelly	残酷に|残酷|無情
tapioca	タピオカ(cassavaの根からつくった食用でんぷん)
drowsy	眠けを誘う|眠い
unproven	証明されていない
bushel	ヤード･ポンド法における体積(容積)の単位|液体の計量には用いられず|乾量|特に穀物の計量に用いられる|約35 リットル
myocardium	心筋
nightline	ナイトライン
trice	瞬間
cursive	(筆跡が)続け書きの|筆記体の|筆記体の文字(活字)
admonition	警告|説諭|訓戒|勧告|忠告
sedition	扇動|騒乱
photosynthetic	光合成の
ghastly	青ざめた|恐ろしい
vaudeville	寄席演芸|ボードビル|軽い喜歌劇
unapproved	承認されていない|認められていない
muslin	モスリン(木綿や羊毛などの梳毛(そもう)糸を平織りにした薄地の織物)|綿モスリン|キャラコ(インド産の平織りの綿布)
mumble	(口の中で)もぐもぐ言う|ぶつぶつ言う|つぶやく
rhinoceros	サイ(犀) rhino
aberrant	正道をはずれた|常軌を逸した|異常な
stalemate	行き詰まらせる|引き分け|手詰まり|行き詰まり
inquisitive	せんさく好きの
earner	儲かる仕事|儲けになる仕事|稼ぎ手|稼ぐ人|取る人|賄賂
deflate	の空気を抜く|空気を抜く|収縮させる|(反)inflate
coinage	貨幣鋳造|貨幣制度|新語|新造語
menagerie	野生動物|野生動物園
thrombin	トロンビン|蛋白質分解酵素のプロテアーゼの一種|血液凝固の際に水溶性のフィブリノーゲンを不溶性のフィブリンとする作用を持つ
laminar	層流の
scold	がみがみ女|説教する|叱る(rebuke)
apprehensive	心配した|心配して|理解力の鋭い
toga	トーガ(古代のローマの外衣)|(裁判官･教授)職服
perpetuity	永続|不滅
landfall	陸地接近|地滑り|山崩れ|圧勝
methyltransferase	メチルトランスフェラーゼ|メチル基を供与体から受容体へ転移させる転移酵素の一群
laity	信者たち|しろうと連|俗人連|平信徒
purposefully	意図的に
broadside	舷側(げんそく|船体の側面|ふなばた|ふなべり)
sedate	落ち着かせる|平静な
itinerant	巡回する|巡歴の|遍歴中の
reelection	改選|再選
vitreous	ガラス質の
litany	嘆願|退屈な話|呪文のように繰り返すこと
coloration	着色(法)|色合い|血色|天然の色|音声の調子|考え方|態度
aliquot	(ælɪkwɒt)|(数学)割り切れる|約数の|(名詞)アリコート(全体から取り出した一部の試料)|分割量|(動詞)(数･量が)等分される
countable	数えられる|数えられるもの|可算名詞
colostrum	初乳
crematorium	火葬場
dearth	欠乏|払底|飢饉
palatable	趣味にかなう|心地よい|(食べ物などが)味の良い|口に合う
idiocy	白痴
tarmac	タールマカダム(砕石とタールの混合物)|タールマック舗装道路|駐機場
artefact	加工物
expository	説明的な|解説の|釈義的な
instinctive	本能的な
restlessness	落ち着きのなさ
burlesque	パロディ|漫画|おどけた|道化の|戯作的な
impinge	侵害する|ぶつかる|突当る|打つ|突き当たる|衝突する
rickey	リッキー|アルコール性飲料と炭酸水の中にライム果汁を入れたもの
tankard	(ふた･取っ手つき|陶器|金属製の)大コップ
socialite	(しばしばけなして)社交界の名士|(社交界の)名士
ethnology	民族学|文化人類学|人種学
menorah	(ユダヤ教でおもに宮清めの祭り(Hanukkah)に用いる)大燭台
taut	張りつめた|ぴーんと張った
dimple	えくぼ|ディンプル
doing	すること|行為|小さいもの
foolishness	愚かさ
centrifugation	遠心分離
unequivocal	あいまいでない|はっきりした
spiny	とげのある|とげの多い|とげ状の|取り扱いにくい|厄介な
dropkick	ドロップキック(ラグビー・アメリカンフットボールなどで球を地上に落とし|はね上がりぎわをけること)
silken	絹の|(絹のように)柔らかな|光沢のある|絹を着た
newsworthy	報道価値のある
defs	definitions
sensitization	感性の
hyperactive	異常に活発な
antenatal	=prenatal|《英》出産前の診察
hemophilia	血友病(血液の凝固力が弱く出血しやすい病気)
kola	コーラ|ヒメコーラの木|アフリカ原産のアオギリ科の常緑高木|種子(kola nut)を採るために熱帯で栽培される|=cola
seepage	浸出
hie	(hάɪ)急ぐ
enjoin	に命じる|禁止する(enjoin a demonstrationデモを禁ずる|enjoin silence沈黙を申しつける)
nonviolence	非暴力(の状態)|非暴力主義|非暴力でも
glace	(仏語)(革･布など)なめらかな|砂糖をまぶした
elegy	エレジー|挽歌|悲歌|哀歌
technicolor	天然色映画法|テクニカラー(商標名が普通名詞化したもの)
needlessly	不必要に
cordially	心から
popper	入質する人|サッと動く人|ひょっこり来る人|ポップコーンを作る器具|花火|ピストル|砲手
headpiece	兜|帽子|頭|頭脳
botanist	植物学者
bub	若いの|きみ|おっぱい|赤ん坊
dodo	ドードー(Dodo)は|マダガスカル沖のモーリシャス島に生息していた絶滅鳥類|目撃例が途絶え1681年に絶滅したとされる
seabed	海底
rectory	牧師の住宅|牧師館(官舎)
officiate	職務を行う|式の司祭を勤める
erythrocyte	赤血球
unobtrusive	控えめ
myelin	ミエリン|(神経科学)髄鞘|myelin sheath(ミエリン鞘|しょう)|脊椎動物のニューロンの軸索周囲の絶縁性リン脂質の層|神経パルスの電導を高速にする機能がある
fragility	もろさ|脆弱さ
mobster	暴力団の一員|暴力団員|ギャングの一員
wrest	ねじる|をもぎ取る|苦労して得る|ねじり|ひねり
detoxify	〜‘の'毒性を除く
woodcut	木版(画)
dramatist	劇作家
cutaway	(内部を見せるため)外側の一部を取り除いた模型･舞台装置など|(モーニングなど)前すそを斜めに裁った上着
herringbone	杉あや(矢はず)模様(織物・寄せ木・石畳などの模様に用いる)|杉あや(矢はず)模様の
afoot	徒歩で|進行中で|起こって|計画中で
oddity	風変りなこと
lolly	(=lollipop|ペロペロキャンデー)|木製の棒についたアイスクリームまたは氷菓子|(=lolli)|(俗語)金(かね)
auspicious	幸先の良い|縁起の良い
hotly	熱く
coincidental	偶然一致する
strontium	ストロンチウム(金属元素;化学記号は Sr)
presumptive	推定上の|仮定の
hackman	貸し馬車の御者
comprehensible	理解できる
skinhead	スキンヘッド
thorny	厄介な|困難な|いばらの|とげのある|鋭く尖った
unambiguously	明確に
sawdust	おがくず|のこくず
metaphorical	隠喩的な(=fugurative)
alertness	警戒心
sphincter	括約筋
analyte	分析対象の検体
glitz	けばけばしさ|華美
heil	万歳
molding	型で作ること|造形
hotdog	ホットドッグ(細長いロールパンを割った間に焼いたフランクフルトソーセージをはさんだもの)|(替成・喜びなどを表して)その通り|けっこう|すてき
proportionality	比例
espouse	採用する|支持する|結婚する
sordid	むさくるしい|汚い|卑しむべき|くすんだ色の|いやしむべき|浅ましい
medico	医師|医学生
crud	かす|がらくた|屑|無価値なもの|CRUD|データベースの重要4機能(作成Create|読み出しRead|更新update|削除Delete)を表すことば
commie	共産党員
semblance	外見|うわべ|見せかけ|類似
coms	《話》=combination4
woolen	羊毛の|毛織物を扱う|woollen
pneumococcal	肺炎球菌の
yarrow	西洋ノコギリソウ
fickle	気紛れな|移り気な
meatloaf	ミートローフ
plasminogen	プラスミノーゲン(血栓など血液の凝固したものを溶解するプロテアーゼであるプラスミンの前駆体タンパク質)
lukewarm	不熱心な|いい加減な|生ぬるい
rotunda	ロタンダ|円形の建物|円形の広間
duce	首領|指導者|指揮官
crick	筋を違える|寝違える(crick one's neck|twist one's neck|)
faintly	かすかに
indiscriminate	無差別の|見境のない
reforestation	再植林
paradoxically	逆説的に
cava	静脈
oligo	オリゴ糖(oligosaccharide)とは|単糖類同士が結合した多糖化合物で|ビフィズス菌などの腸内善玉菌を増やす効果で知られる
accolade	絶賛|栄誉|ナイト爵位授与の儀式
raison	存在理由
interpretative	意味を明らかにするのに役立つ|説明的な
caseworker	社会福祉司
stutter	吃(ども)る|(to speak with difficulty in producing sounds|)
wallow	転げ回ること|転げ回る|のたうつ|ふける|おぼれる
bagpipe	バグパイプ(Scotlandの高地人などの用いる皮袋で作った吹奏楽器)
choppy	途切れ途切れの|関連性のない|絶えず(不規則に)変わる
introspective	自己反省の|内観的な|内省的な
riboflavin	リボフラビン(ビタミンB2またはG)
ubiquity	同時にいたる所に存在すること
vandal	芸術･文化をみだりに破壊する|文化･芸術の破壊者|野蛮人
pretender	要求者|詐称者
dweller	居住者
bitumen	瀝青(れきせい)(天然の炭化水素化合物の総称)
diabolic	悪魔のような
demonstrable	極めて明らかな|明白な|論証できる
fantasize	空想する
rummy	飲んだくれ|ラミー
constructively	前向きに
pollster	(職業的な)世論調査員(担当)
despicable	軽蔑に値する|卑劣な|卑しむべき|見下げはてた
reactant	反応物(化学反応を受ける物質)
wyvern	(紋章で)飛竜(2本足で翼を持ち|蛇の尾の架空の竜)
dressy	正装向きの
egalitarian	人類平等主義の
curvy	くねくねと曲がった|カーブの|曲がった|曲線の美しい|曲線美の
crucially	決定的に|重大に
facile	愛想のよい|手軽な|容易な|骨の折れない|たやすく得られる
environmentalist	環境問題研究家|環境保全主義者|環境保護論者
cognate	同起源の|同語源の|同語根語|祖先を同じくする|同血族の
spinster	未婚女性(a bachelor girl)|ハイミス|(男性独身者|bachelor|cf|celibate)
mistreatment	虐待
somber	憂うつな|くすんだ|薄暗い|地味な|陰気な|憂欝な
infective	感染性
immovable	動きのない|動かせない|固定した|不動の|静止した|冷静な
amoeba	アメーバ(複|amoebae amoebas)
poinsettia	ポインセチア
awry	間違って|片方に曲がって|斜めに|正道からそれて
iceman	氷屋|氷配達人
superposition	重ね合わせ
subordination	(〜より)下位に置くこと;(〜への)従属|服従《+to+名》
parakeet	インコ
unresponsive	反応しない
itemize	箇条書きにする|明細に記す
abolitionist	廃止論者
breakwater	防波堤
tenuous	あいまいな|薄い|細い
lentil	レンズ豆(平マメ|レンズの語源とされる)
stuffy	風通しの悪い|詰まった|面白くない
cocky	気取った|うぬぼれた
pyrite	黄鉄鉱(fool's gold)
beano	=bingo
flamboyant	色鮮やかな|炎のような|燃えるような|派手な
exchangeable	交換可能な
stretchy	伸びる|伸びやすい|伸び縮みする|伸縮性のある|弾力のある|胴の長い|伸び過ぎる
misunderstand	誤解する
haemophilus	インフルエンザ菌|(当初インフルエンザの原因菌とされたがその後否定された|名称のみ残った細菌)
piggyback	抱合せ広告|おんぶ|(子供が大人の)背に乗る
hubris	傲慢|思い上がり(arrogance)|威丈高
genitalia	=genitals
damper	調整弁
metalwork	金属製品|金属細工品|(特に学科目の)金属加工
orchestrate	管弦楽に作曲(編曲)する|統合する|結集する|(巧みに)調整する
carelessly	不注意に|不用意に|無頓着に
gravitate	引かれる
elation	意気揚々|盛んな意気|得意|大得意
disincentive	意欲をくじくもの|行動を妨げるもの|行動を抑制するもの|阻害要因|経済成長を阻害するもの|がっくりさせる|意欲をくじく
phonograph	蓄音機
belladonna	ベラドンナ(ナス科の有毒薬用植物)
oddball	変り者
dingle	樹木の茂った小さな渓谷|チリンチリンと鳴る|ビリビリ震える
deplore	ひどく悲しむ|嘆き悲しむ
hydroponic	水耕の
maltreatment	虐待
malaise	不快感|倦怠感
biceps	2頭筋|二頭筋|筋力|筋肉のたくましさ
tinderbox	火口箱|火災の危険の高い建物|(一触即発の)危険な場所(状態)
streetwise	世慣れた
rococo	ロココ様式(の)
nucleation	核生成
curmudgeon	意地の悪い人|けちな人
mountainside	山腹
deviance	逸脱
alcove	(部屋の一部を切り込んだ)小部屋|(床の間ふうの)壁の切り込み
quartermaster	(陸軍の)補給係将校|(海軍の)操舵(そうだ)係下士官
foodborne	食中毒|食品媒介
traditionalist	伝統主義者
fondness	優しさ
whet	研ぐ|(刃物)をとぐ|磨く|をそそる|刺激する|研磨
snowstorm	吹雪|ふぶき|吹雪のようなもの
multiplicative	乗法
urethra	尿道
retroactively	遡及的に
stepmother	義母
quip	いやみ|皮肉|気の利いた言葉
emoticon	顔文字
leeward	風下の|風下にある|風下へ(に)|風下|風下の側
fruitless	無益な
ticklish	くすぐったい cf|tickle
goad	突き棒で突く|突き棒|刺激|激励
ridership	(電車・バスなどの)乗客　特定交通機関の利用者数
athenaeum	学術振興協会|《古》図書館
deceleration	減速
granulocyte	顆粒球(白血球の一種)
instrumentalist	器楽家|演奏家|道具主義者
displeasure	不満
endoplasmic	(細胞内の)内質の
antiserum	抗血清(特定の抗原に対する抗体を含む血清)
usefully	役に立つように|有効に
risotto	リゾット(イタリアの麦類の料理に東洋から伝播した米が融合した料理)
attenuate	やせさせる|細くする|薄める|和らげる|弱める|減ずる
threefold	3倍の(に)
plop	どぶん|ボチャン|ドブン(と落ちる･落とす)
innocently	無邪気に|何食わぬ顔で
darken	暗くする
steamship	汽船|蒸気船
gridlock	(交差点での)交通妨害|都市部での交通渋滞|身動きの取れない(手詰まりの)状態
anaemia	=anemia
blather	ばかげたことを言う
woah	すごい迫力
violator	違反者
pharmacokinetic	薬物動態学的な
tirelessly	疲れを知らずに
pushbutton	押しボタン
crisscross	十文字|十字の|交差する|十字になる
observant	観察力の鋭い
unhappiness	惨めさ|悲哀|不運|不幸
outstrip	を追い越す
methodical	きちょうめんな
secularism	世俗主義|非宗教的道徳(教育)論
monotonous	単調な|一本調子の
neuroblastoma	神経芽細胞腫
belay	ザイル等で留める|索止めなどに巻きつける|“Belay that!” he roared|「やめろ」と彼はどなった
glandular	腺の|先天的な|生まれつきの
operatic	歌劇風の
terrorize	恐れさせる
malevolent	悪意のある
stile	(牧場の柵などを人だけが越せて家畜は通れないようにした)踏み越し段|turnstile(回転ドア)
outgrowth	自然の成り行き|結果
epileptic	てんかん(性)の|てんかん患者
nadir	天底|どん底
feedlot	(家畜を屠殺する前に飼料で太らせるための)飼育用地
naught	完全な失敗|ゼロ(=nought|主にUK)|無価値|滅びた
warhead	弾頭
debby	debutante|浮薄な上流社交界の若い女
foreshore	前浜(満潮線と干潮線との間の砂浜)|なぎさ|みぎわ
endgame	エンドゲーム
unproductive	非生産的な|不毛の|むだな
curbside	道路脇
innuendo	風刺|諷刺|あてこすり
nefarious	極悪な|ふらちな|非道な
gah	がーん
flog	むち打つ|なくす|売る
landmine	地雷
oeuvre	一生の仕事|芸術作品|全作品|全仕事
sahib	だんな|閣下|紳士|～殿|～様
shoestring	靴ひも|(靴ひものように)細長い|(資金･予算)わずかな|乏しい
enrollee	入学者
storehouse	倉庫|宝庫
senor	セニョール|氏|様|Mr|sir
vermin	社会の害虫
geezer	変な老人|頭のおかしいオイボレ
ischium	座骨
ankh	(エジプト美術で)輪つき十字形(生殖・長寿の象徴)
misstatement	虚偽表示
detonator	雷管|起爆薬|起爆装置
epithet	悪口|罵りの言葉|あだ名|通り名|形容句
callous	たこのできた|(皮膚などの)堅くなった|無感覚な|思いやりのない|冷淡な
adjutant	(陸軍の)副官|補助員|助手|(またadjutant stork|adjutant bird)ハゲコウ(インド・アフリカ産のコウノトリ科の鳥)
sod	芝生|芝(土)
molester	いたずらをする人|痴漢|悩ます人
gallium	ガリウム(金属元素)|元素記号はGa
mannered	(複合語で)行儀の～な|(軽蔑的)(作風など)個性の強い|気取った|型にはまった
enmity	敵意|悪意|恨み|憎しみ|反目
referent	対象|(語の)指示物(対象)
transliteration	音訳
barf	吐き気|吐く|戻す|ゲーゲーやる|文句を言う|うんざりだ
smite	襲う|悩ます|をなぐる|を罰する|ぶつかる|強打(する)
buttery	ぶどう酒類貯蔵室|食料品貯蔵室|(UK英)学生にビール･パン･果物などを売る部屋
optometrist	検眼医|視力測定者
invalidity	無効|無価値|=invalidism
soundly	堅実に|ぐっすりと|激しく
hominid	ヒト科
impersonation	人格化|擬人|権化|体現|物まね|他人の振りをすること(一種の詐欺)
rehash	改作|焼き直し|蒸し返し|繰り返し論議する|言い直す|刻み直す|作り直す|焼き直す
barbican	(城などの)物見やぐら|外堡(ほ)
criminally	犯罪的に
afterthought	あと知恵|あとからの思いつき|結果論
pursuance	(計画・任務などの)遂行《+『of』+『名』》
faceless	顔のない
hydrotherapy	水治療法(温泉などの病気療法)
anathema	呪い|大嫌いなもの|教会の呪い|破門
counterbalance	相殺する|つりあう量
quintile	5分位点|5分割する区切り点|数
freightliner	大型貨物(コンテナ)列車
holdall	(旅行用の)大型スーツケース
ashram	アーシュラム(ヒンズー教の人々が宗教の教えを受けに来る所)
trapeze	(曲芸･体操用の)空中ぶらんこ
stargazer	天文学者;占星家|空想家|夢想家
preferentially	優先的に
reevaluate	再評価
ditty	小歌|短い(単純な)歌
diuretic	利尿の|利尿薬
mangle	めった切りにする|台なしにする|ぶち壊す
throb	動悸を打つ|鼓動する|どきどきする|脈打つ|脈拍|動悸
refractor	屈折媒体(レンズ)|=refracting telescope
inadmissible	許せない
zooplankton	動物プランクトン
belittle	けなす|価値を下げる
philatelic	切手収集の
innocuous	刺激のない|無害の|無毒の|迫力のない|無味乾燥な|退屈な
midwinter	真冬|冬至
matchbook	マッチブック(二つ折りの携帯用はぎとり式マッチ)
cassava	〈C〉キャッサバ(熱帯産植物)|〈U〉キャッサバでんぷん
doormat	ドアマット|玄関マット|ぼけ|人にいいようにされる人
musicianship	音楽の技能(知識|才能)
adios	さようなら
purview	範囲|権限|(法令の)条項
inwardly	心の中で|密かに
amylase	アミラーゼ(でんぷん糖化酵素)
decongestant	充血除去剤|消炎剤
arbitrate	仲裁する
gonadotropin	ゴナドトロピンは|性腺刺激ホルモンとして正常な成長|性的発達|および生殖機能を調節する|時にGnと略される
superstructure	上部構築物|上層|超格子構造|規則格子|建築|建物|ある原理に基づく思想
pernicious	有害な|ひどく有害な|致命的な
crewneck	丸首セーター
discriminant	判別式
heiress	女相続人
pombe	シゾサッカロミセスSchizosaccharomyces pombe|ビール(pombe|スワヒリ語の雑穀ビール)から単離された最初の分裂酵母|(Schizoは分裂|cf|精神分裂病Schizophrenia)
persecute	を迫害する|で悩ます
lacuna	脱落(部分)|引用文|知識の空隙|空白|小窩|くぼみ
anyplace	どこでも
nonsensical	馬鹿げた|愚にもつかない|無意味な
gallows	絞首台(これで単数形)
rheumatism	リウマチ
devotee	熱愛者|帰依者
cowardice	臆病
microform	縮小写真印刷[物]
dynamism	動力論
wily	策略にとむ|悪賢い|狡猾な|ずるい
ensue	続く|あとで起こる|あとに続く|結果として起こる
manmade	人造の|人工の
drunk	飲んだ
cupcake	カップケーキ
hopelessness	絶望
errand	使い走り|伝言
slimy	ねばねばする|どろどろした|不快な|卑屈な
spinoff	スピンオフ
annexe	=annex
stunningly	驚くほど
reformist	革新主義の|革新主義者|改革派
deliberative	審議の|熟慮の
crossbar	(ラグビー・フットボールなどのゴールの|走り高飛び・棒高跳びの)バー|横木|横線
cicada	セミ(米ではlocust(本来バッタの類)とも言うが|識別できないためと思われる)
emigrant	移住する|移民(の)
cytomegalovirus	サイトメガロウイルス(ヘルペスウイルス科のウイルスのひとつ)
chump	太い木切れ|厚い肉の切り身|(俗)ばか
subplot	わき筋
neurosis	ノイローゼ
bassinet	ほろ付きゆりかご;ほろ付きのうば車
commissary	物資配給所|販売部|売店|兵站係将校|代表者
typhimurium	ネズミチフス菌
bumblebee	マルハナバチ
hibernation	冬眠
interplanetary	惑星間の
bork	公職への任命を拒否する|(1987年Bork判事の最高裁判事指命が阻止されたことに由来)|破壊する
hullabaloo	がやがや|騷々しさ|騷ぎ|騒ぎ|ごった返し
musket	マスケット銃
erratum	誤り|誤字|誤植|正誤表|(pl|errata)
globetrotter	世界を駆け回っている人
anthracite	無煙炭
altercation	口論
foxtrot	社交ダンスの一種|Foxは創始した米人の名|foxtrotはphonetic alphabetのfに使われるほど著名
merciless	無慈悲な|残酷な
phalanx	方陣(古代ギリシャの)方陣
oriole	コウライウグイス(ムクドリの一種)
rhesus	アカゲザル(北インド産)
lather	に石けん泡を塗る|馬の泡汗|石鹸の泡
shenanigan	いたずら|悪ふざけ|ごまかし
atrocity	残虐(行為)|非道|極悪
proportionally	比例的に
untrained	訓練され(てい)ない
billable	支払請求可能な
tiresome	退屈|退屈な|うんざりする|あきあきする
faraway	遠方の
garnishment	〈C〉(第三債務者に対する)債権差し押さえ通告|〈U〉飾り|装飾
enliven	に活気を与える
twirl	振り回す(こと)|くるくる回す(こと)|クルクル|回る様子
shanty	小屋|掘っ立て小屋
sirloin	サーロイン･ステーキ
lightbulb	電球
potash	あく(灰汁)|カリ|カリウム化合物
chivalry	騎士道
regrettably	遺憾ながら
playbook	脚本
hod	ホッド(長い柄がついた木製の容器でれんが・しっくいを入れ肩にかついで運ぶ)|石炭入れ
bolo	片刃の大なた|打撃
whitey	白人
laryngeal	喉頭(こうとう)の;(音声が)喉頭音の