deceiver	詐欺師
abrogate	(法律などを)廃止する|捨てる
equaliser	平衡錘
broomstick	ほうきの柄
knave	男の召使い|悪者|悪党
booger	のやつ|鼻くそ
immunogen	免疫原
waker	someone who rouses others from sleep|a person who awakes; "an early waker"|a person who awakes
cluck	鳴き声
psychosomatic	精神治療学の
kidnapping	誘拐
shrinkwrap	wrap something tightly with heated plastic that shrinks upon cooling; "shrinkwrap the CDs"|wrap something tightly with heated plastic that shrinks upon cooling
frictional	摩擦の|摩擦によって起こる
avena	カラスムギ属
loach	ドジョウ (ゴキブリはroach|cockroach)
philately	切手収集|切手研究
repairable	修理できる|元どおりにできる|回復できる
prefectural	(フランス・日本などの)県の|府の
loathsome	ひどくいやな|忌まわしい
disequilibrium	不均衡
abduct	誘拐する
overhear	ふと耳にする
skinless	皮のない;皮をむかれた
sauerkraut	ザウアークラウト(塩漬けにして発酵させたキャベツ)
oncorhynchus	Pacific salmon including sockeye salmon; chinook salmon; chum salmon; coho salmon|Pacific salmon including sockeye salmon|chinook salmon|chum salmon|coho salmon
satanist	悪魔派
instigator	扇動者
muskrat	マスクラット(北米産のビーバーに似たネズミ科の動物)
stealthy	密かな|一目を盗んだ|ひそやかな
fertilize	肥やす|豊かにする|受精させる|受胎させる
upswing	(経済)上昇|上向き
hooligan	ごろつき|悪党|不良|よた者|与太者
uda	the major Protestant paramilitary group in Northern Ireland; responsible for bombing the homes of Catholics and for criminal racketeering and selling drugs|the major Protestant paramilitary group in Northern Ireland|responsible for bombing the homes of Catholics and for criminal racketeering and selling drugs
gunnery	砲術|(集合的)銃砲
dyspepsia	ディスペプシア(消化不良|病名)
digestible	消化できる
unsweetened	not made sweet
pyrolysis	(有機化合物の)熱分解
sonography	超音波検査法|超音波
apologist	弁証家|弁明者|擁護者|弁解者|言い訳がましい人
neruda	ネルダ
gynecologist	婦人科医
tartrate	酒石酸塩
tomboy	おてんば娘
candidly	率直に
honorably	名誉となるように|りっぱに
shifty	やりくりのうまい
attentional	注意の
attractant	引きつける物|誘引物(剤)
footbridge	歩行者専用橋
dilate	広げる|膨張させる|敷衍する|詳しく話す
upwind	風上|風上に
overexposure	the act of exposing film to too much light or for too long a time|the act of exposing someone excessively to an influencing experience; "an overexposure to violence on television"|the act of exposing someone excessively to an influencing experience
counterfactual	going counter to the facts (usually as a hypothesis)
neutropenia	好中球減少
massless	(物質が)質量のない
intimation	暗示|通告
lemming	レミング(極地帯に住む小型のネズミ|大量繁殖で有名)
laminin	ラミニンは細胞の基底膜を構成する巨大なタンパク質|多細胞組織構築と維持|細胞増殖を促し|がん細胞と関係が深い
neurotoxicity	神経毒性
cyanobacteria	シアノバクテリア(藍色細菌)|藍藻とも呼ばれる真正細菌|光合成で酸素を生み出す|27億年前のストロマトライトの縞状鉄鉱層は酸素を作るシアノバクテリアの出現を示す
geostationary	(衛星が)静止軌道に乗っている
fertilisation	受胎|受精|受粉|施肥
insurable	保険がつけられる
obstinate	頑固な|stubborn|しつこい|病気が難治の|強情な
earthwork	土塁|土工作業
artesian	(of water) rising to the surface under internal hydrostatic pressure; "an artesian well"; "artesian pressure"|(of water) rising to the surface under internal hydrostatic pressure
retinoblastoma	網膜芽細胞腫
serology	血清学
buttock	お尻(の肉)|しりの片方
ergodic	エルゴード的
gregarious	群生した|群居性の|集団の|社交的な|(植物)群生する
torrential	激しい|急速な|圧倒的な
jamb	upright consisting of a vertical side member of a door or window frame
farmstead	(土地・建物を含めた)農場
missus	妻|細君|女房|あんた|おかみさん|ガールフレンド
inconsiderate	察しのない|思いやりのない|礼儀作法を心得ない|思慮分別のない|軽率な
scamper	すばやく走る|疾走|素早く走り回る|(子供や動物が)跳ね回る|大急ぎで走る|疾走する
hokey	変に感傷的な
endocytosis	エンドサイトーシス|飲食細胞運動|形質膜陥入
warlike	戦闘的な|戦争の|軍事の|好戦的な
wheatgrass	ヒメカモジグサ
diluent	(液体を)薄める|希薄用の|希釈剤
scouter	偵察
rifampin	リファンピン
posthumously	死後に
geode	晶洞(どう)石
suet	スエット|料理用の脂(牛|羊など)
barbarous	野蛮な|粗暴な|未開の
expressiveness	表現の豊かさ
hcfc	ハイドロクロロフルオロカーボン
runabout	小型のオープンカー|小型モーターボート|小型飛行機|走りまわる子供|浮浪者|うろつき回る人
isere	イゼール
unpredictability	不可測|気まぐれ
eggnog	卵酒
anther	葯(やく)|雄しべ(stamen)の一部で|花糸の上端にあり花粉(pollen)をつくる袋状の器官
scrapie	羊海綿状脳症
mufti	(通常は軍服など制服を着ている人たちの)平服|服
poliovirus	ポリオウイルス
quadrilateral	四辺(角)形の|四辺(角)形
enlace	縒る|縒り合す|織交ぜる|撚り合わせる|縒り合わせる|撚合せる|縒り合わす|縒合わせる|縒りあわす|縒り合せる
demean	(人の)品位を落とす|ふるまう
purist	純正主義者
freestone	種離れのよい果実(ある種のモモ・スモモなど)|軟石(石目がなく)切り出しやすい岩石|種離れのよい
formulaic	公式の
attender	リスナー|傾聴者|聴衆|聴取者|傍聴者|傍聴人|聞き手|聞き方|聞き役|聴き手|随行員|お傍|付添|差添|随行|随伴者|お供|付添い|付き添い人|御伽|参加者
corned	快然
shockley	ショックレー
antiserum	抗血清(特定の抗原に対する抗体を含む血清)
answerable	責任のある
inky	まっ黒な|インクのついた
triplicate	三つ揃い|3通の|3通作成する
sepulchre	sepulcher|墓|地下埋葬所
stickiness	粘ること
cataclysmic	(政治的･社会的)大変動|一大異変|(地殻)激変|地殻が激変する位の
curia	《しばしばD-》ローマ教皇(法王)庁|古代ローマの元老院
cabbie	(俗)タクシー運転手
derision	嘲笑|あざ笑い|嘲り
dutifully	うやうやしく
honoree	a recipient of honors in recognition of noteworthy accomplishments
emollient	柔らかにする|皮膚を軟化する|苦痛を緩和する
frisk	はね回る|はね回り|(俗)所持品検査(服の上から触って武器を持っていないか確かめる)
nontoxic	無毒
durga	Hindu goddess of war; a malevolent aspect of Devi; "the inaccessible Durga"|Hindu goddess of war|a malevolent aspect of Devi
falconry	タカ狩り(hawking);(タカ狩り用の)タカ訓練法
ischaemic	relating to or affected by ischemia
bailout	緊急援助|緊急救済
remediate	規正|更正|矯正|修める|矯める|修する|匡正|是正|改正
bicolor	having two colors; "a bicolor flower"; "a bicolored postage stamp"|having two colors
annulus	環帯|ミミズやヒル類で|体の前方の生殖孔付近にある帯状の分泌腺|シダ植物の胞子囊の外側にある一列の細胞|胞子をはじき出す
conspirator	共謀者
promiscuity	乱雑|乱交
gallantry	〈U〉さっそうとした勇気|〈U〉婦人に対する丁重さ;〈C〉《しばしば複数形で》丁重な行為(言葉)
businessperson	実業家
myopathy	any pathology of the muscles that is not attributable to nerve dysfunction
buckler	(手に持つにぎり|または腕を通すひものついた)丸盾(たて)|《比喩(ひゆ)的に》防護となる物
interlocutory	対話の|対話中にはさんだ|(判決などが)中間の
regurgitate	噴き返す|逆流する|(食物を)吐き戻す
alga	藻類|酸素発生型光合成を行う生物のうち|種子植物|コケ植物|シダ植物以外の総称|真正細菌のシアノバクテリア(藍藻)から|真核生物で単細胞生物の珪藻類や多細胞生物の海藻類まで含む
louse	シラミ(複数形lice)
gaffer	じいさん|かしら|親方|父親|おやじ
arguable	議論の余地がある
eclampsia	子癇
rumania	a republic in southeastern Europe with a short coastline on the Black Sea
siliceous	ケイ酸を含む|ケイ酸質の土壌に生育する
grimoire	グリモワール
sailfish	バショウカジキ(大さな背びれのメカジキの類の食用魚)
signore	シニョーレ
coldly	冷たく
fenugreek	annual herb or southern Europe and eastern Asia having off-white flowers and aromatic seeds used medicinally and in curry|aromatic seeds used as seasoning especially in curry
polyphone	a letter that has two or more pronunciations; "`c' is a polyphone because it is pronounced like `k' in `car' but like `s' in `cell'"|a letter that has two or more pronunciations
sundowner	《おもに英話》仕事帰りの夕暮れ時に飲む酒|《オーストラリア》日暮れれになってから農場に着き|労働せずに一宿一飯にありつく浮浪者
enormity	極悪|非道|膨大なこと|巨大さ
botulism	ボツリヌス中毒
pyridoxine	=vitamin B6
longhair	《しばしば軽べつして》インテリ|知識人・クラシック音楽愛好家・ヒッピー
coldness	寒さ|寒気|不感|冷ややかさ|冷感|冷静|冷淡
pestle	をすりつぶす|乳棒|すりこぎ
noguchi	イサム・ノグチ
grouchy	不機嫌な|機嫌の悪い
gusty	突風の吹く|風の強い
vulgarity	俗悪|下品
godliness	信心
docile	すなおな|従順な|教えやすい
prostatectomy	前立腺切除
maliciously	悪意のある|意地の悪い
showmanship	演出上手|興行的手腕|聴衆を引き付ける手腕
redeploy	移動する|移動させる|再配置する
stagnate	沈滞する|澱む|淀む
sucky	嫌な
scrivener	(昔の)代書人;筆耕者|書記
conker	トチの木の実|《複数形で》トチの実遊び(トチの実をひもに結びつけて相手の実を割るゲーム)
ethicist	倫理学者
cardioid	カージオイド
subsoil	心土|底土(地表のすぐ下にある地層)
biannual	年2回の|半年ごとの|半年毎に
congeniality	(趣味・性格などの)一致|相性|適合性
vasculitis	血管炎
complicit	なあなあの
substantiation	立証|実証;具体化|実体化
capitation	人頭税(各人に等しくかける税)
devries	ユーゴー・ド・フリース
bulwark	防波堤|とりで|とりでのようなもの(人)|砦|堡塁|防護者|防壁
usury	高利貸し業|(法外な・違法な)高利
greedily	欲深く|どん欲に|がつがつと
fuschia	a dark purplish-red color
streptomycin	ストレプトマイシン|結核の治療に用いられた最初の抗生物質
arborist	樹医
vizier	a high official in a Muslim government (especially in the Ottoman Empire)
antebellum	(米語)戦前の|南北戦争前の
nostril	鼻孔
subscale	下位尺度
dopaminergic	ドーパミン作動性の
barbarism	野蛮|未開
staphylococcal	ブドウ球菌(性)の
hooch	(hootchとも)|(húːtʃ) 1|酒|(密造)ウイスキー|人名(姓)ホーホ|住居|家
razorback	ナガスクジラ|(米国南部に多い)半野生の豚
clawfoot	a deformity of the foot characterized by an abnormally high arch and hyperextension of the toes which gives the foot the appearance of a claw
inscrutable	測り知れない|計り知れない
antialiasing	(computer graphics) a technique that is used to smooth jagged distortions in curves and diagonal lines so they appear smoother|a technique that is used to smooth jagged distortions in curves and diagonal lines so they appear smoother
syne	以前の 
xxxii	being two more than thirty
organon	a system of principles for philosophic or scientific investigations; an instrument for acquiring knowledge|a system of principles for philosophic or scientific investigations|an instrument for acquiring knowledge
underbelly	(動物の)下腹部(動物の最も柔らかい部分)|弱点|急所|泣き所
reducible	縮小できる
landlady	女主人|女家主
potentiation	相乗作用
vertebra	椎骨(ついこつ)|脊椎の分節をなす個々の骨のこと|ヒトの場合上から頚椎7個|胸椎12個|腰椎5個|仙椎5個|尾椎4個の計33個存在する
escapement	(時計の) 脱進機 《調速機構》|逃がし止め|(タイプライターの)文字送り装置|(ピアノのハンマーをもとの位置にもどす)休止装置
blameless	文句のつけられない|(生活などが)非難するところのない|罪のない|潔白な
schoolmaster	男子教員|校長
democratisation	民主化
newsagent	=newsdealer
polenta	ポレンタ
absurdly	不条理に|ばかげて
invalidation	(law) a formal termination (of a relationship or a judicial proceeding etc)|a formal termination (of a relationship or a judicial proceeding etc)
probative	試みの|試験的な|立証(証拠)に役立つ
corporeal	実体のある
passivity	受動性|消極性|無抵抗|忍耐
partiality	〈U〉不公平|えこひいき(bias)|〈C〉(〜に対する)特別な好み|偏愛《+『to』(『for』)+『名』》
annul	(ənˈʌl)|取り消す|廃棄する|溶ける|液状化する(liquefy)
lunchroom	簡易食堂|軽食堂|食事室
anonym	作り名|仮名|別名|別称|筆名|雅号|アノニム|異称
personification	擬人化|権化|化身|典型|体現
steno	=stenographer|=stenography
pkd	多発性嚢胞腎
monopolist	独占者
bode	の前兆になる|の前触れとなる|予告する|予言する
backflip	後ろ宙返りをする|バク転をする|態度をころりと変える|後ろ宙返り|態度の反転
wordsmith	a fluent and prolific writer
objectivism	客観主義|客観論
headstrong	わがままな
gramma	pasture grass of plains of South America and western North America
rainstorm	暴風雨
scantily	乏しく
making	製造|形成
ductal	(乳管や膵管など体内の管腔を指して)管の
evocation	(感情・記憶などを)喚起すること(of)|(口寄せ・神降ろしの)呼び出し
tendonitis	腱炎
preform	プリフォーム|プリフォーム
underpass	地下道
animus	憎しみ|意向
handbrake	(車の)手動ブレーキ
levitation	空中浮揚
supine	あお向けになった|怠惰な|不精な
porphyrin	ポルフィリン
soffit	the underside of a part of a building (such as an arch or overhang or beam etc.)
walkout	ストライキ|退場
solemnity	厳粛|まじめさ|荘厳な儀式
blain	膿疱(のうほう)|水疱|はれもの
bloodthirsty	血に飢えた
haemoglobin	hb|ヘモグロビン
weighting	特別調整手当
glasnost	(露)グラスノスチ|情報公開
lysosomal	＜lysosome|リソソームの
oldie	オールディー
methylphenidate	リタリン
vindictive	復讐心のある|悪意に満ちた|執念深い|spiteful
hacksaw	弓のこ|ハクソー(金属|プラスチック切断用)
splenic	脾臓の
electrocardiography	diagnostic procedure consisting of recording the activity of the heart electronically with a cardiograph (and producing a cardiogram)
praline	プラリーヌ|砂糖をまぶしたアーモンド
triptych	(三面鏡のようにちょうつがいでつないだ)3枚続きの絵画
pipework	管
scanty	わずかな|狭い|不十分な|乏しい
marmite	soup cooked in a large pot|a large pot especially one with legs used e.g. for cooking soup
concessionaire	営業権所有者|(場内の)売店営業者
undaunted	びくともせずに
stillborn	児んで生まれた|死産の
constructivism	構成主義
obstetrician	産科医
conceited	自惚の強い
gabapentin	an anticonvulsant (trade name Neurontin) used to control some types of seizures in the treatment of epilepsy; also used to manage neuralgia caused by shingles|an anticonvulsant (trade name Neurontin) used to control some types of seizures in the treatment of epilepsy|also used to manage neuralgia caused by shingles
neonate	新生児
mortification	くやしさ
misfire	不発
monogamy	一夫一婦婚
salk	ソールク
taxiway	誘導路
differentiator	微分器
legibly	読みやすく
shutterbug	アマチュアの写真狂|写真ファン
inkwell	(特に卓上の)インク入れ|インクつぼ
polythene	=polyethylene
uncontrollably	抑制できないほど|手に負えないほど
impermissible	許されない
canst	《古》canの二人称単数現在形
idleness	ぶらぶらしている|怠惰|無為|無益
doorknob	ドアの取っ手
redheaded	赤い頭をした|赤毛の
peritonitis	腹膜炎
closer	近い|closeの比較級
toughen	頑健になる|強くなる|堅くなる|粘り強くする|頑固にする|強健にする|困難にする
entomb	の墓場となる|葬る|墓となる|墓に入れる
pontifical	教皇の|大祭司の|独断的な|尊大な
tetrachloride	四塩化物
shuffleboard	シャッフルボード|銭はじき
sleeplessness	不眠症
nightie	ねまき|ネグリジェ
reevaluation	再評価
revulsion	嫌悪|憎悪
lope	大股で走る
jitterbug	ジルバ(特に1940年代に流行したジャズやスイングに合わせて踊るダンス)|ジルバを踊る人|ジルバを踊る
demobilization	除隊|動員解除
goldenseal	perennial herb of northeastern United States having a thick knotted yellow rootstock and large rounded leaves
sandcastle	子供が砂で作るお城
flexor	屈筋
moonbeam	月光
playmaker	a player in a team sport who leads attacks or maneuvers in such a way that a teammate can score
backless	背部(裏張り)のない|(衣服が)背中があいている
stunner	気絶させる人(物)|(話)すばらしい美人
inguinal	鼠径(そけい)部の|股の付け根の|｢鼡径｣と表記されることもある
clothing	に衣服を着せる|服を着せる
fullerene	フラーレン
soleus	ヒラメ筋
layperson	門外漢|信徒|平信徒|俗人|レイマン
psychical	精神的
matchstick	マッチ棒[の1本];(特に)その燃えさし[の1本]
mycology	菌学
ryegrass	ドクムギ
travelog	旅行談|紀行映画
liquefaction	溶解|液化;液化状態
timpani	ティンパニー
retrain	再教育
quitter	根気がない人|簡単にあきらめる人
fastback	ファーストバック(流線形の後部[をもった自動車])
volcanism	火山作用|火山現象
earthling	(他の天体から見た)地球人|人間
earnestness	真面目さ|真剣|熱心
monolingual	一言語しか知らない|一言語だけで表現された
allocable	配分できる|割り付け可能な|割り振り可能な|割り当てできる
sommelier	(仏語)ソムリエ|レストランのワイン専門の給仕|ワイン係
ipv	ソークワクチン
steerage	操舵(そうだ)|操縦|(昔の)3等船室
intraperitoneal	腹腔内
karloff	カーロフ
subjectively	主観的に
disrepair	荒廃|破損
filamentous	フィラメント状の|糸状の
polyp	ポリープ|ポリプ(サンゴなど群生体を構成する個体)
incompressible	圧縮できない|圧搾できない
ecliptic	黄道(こうどう)(地球から見た太陽のみかけの軌道)|黄道の
brevet	(退役・引退直前の軍人の)名誉進級
obfuscate	当惑させる|混乱させる|気持を暗くさせる
microsomal	ミクロソーム(microsome)の
whitish	やや白い|白っぽい
irreconcilable	和解できない|妥協できない|矛盾して|非妥協派の人|両立しないもの
authentically	真正に|確かに
schnapps	シュナップス|オランダ|デンマーク|スカンディナヴィアの香りをつけた蒸留酒
gargantuan	巨大な|途方もない
supranational	超国家的な
marginalization	周辺化
mujahideen	ムジャーヒディーン
howitzer	大砲|榴弾砲
clorox	a commercial bleaching agent
morpheme	形態素
debrief	報告を受ける
unwashed	人並み|世間並み|平凡|十人並み|並大抵|凡下|一般的|凡庸|凡|平平凡凡たる
virtuosity	すぐれた技巧
interscholastic	(特に中学校・高校)学校間の|対校の
radiofrequency	無線周波数
prelate	官長|僧侶|高位聖職者
printmaker	版画家
wearily	疲れて|うんざりして
northernmost	最北
anodise	陽極酸化
theistic	有神論の
unscientific	科学的知識のない|非科学的な
warrantee	被保証人
permeation	浸透;普及
heaviness	うっとうしさ|しつこさ|重いこと|重さ|重苦しさ|憂鬱
statehouse	州議事堂
mallee	マリー
phantasm	幻影;幻想|亡霊|幽霊
brachial	of or relating to an arm; "brachial artery"|of or relating to an arm
eroticism	エロチシズム|異常な性欲亢進|好色(性)|性衝動|性的興奮|性欲
prototypical	原型的な
outdoorsman	a person who spends time outdoors (e.g., hunting or fishing)
linseed	亜麻仁(あまに)(アマ(flax)の種子)
staccato	スタッカート|断音の
isoniazid	イソニアジド
chronicler	年代記作家
polyhedral	多角体
trogon	forest bird of warm regions of the New World having brilliant lustrous plumage and long tails
propagandist	宣伝者|伝道者|布教者|宣伝の|伝道の
mutational	突然変異(性)の
impermeable	しみ通らない|不浸透性の|通り抜けられない
cacophony	不協和音|不快な音調|ごろの悪さ
cuneiform	cuneiform charactersくさび形文字|楔形(せっけい|けっけい)文字
remarry	と再婚する|再婚させる(する)
uncircumcised	割礼を受けていない|ユダヤ人でない|異邦人の|異教[徒]の
anticoagulation	the administration of an anticoagulant drug to retard coagulation of the blood
duplicative	重複した
embroider	ししゅうする|刺繍する|潤色する(うわべや表現をつくろう)
diddle	〈人〉‘を'だます;(〜を)〈人〉‘から'だまし取る《+『名』+『out of』+『名』》
drawl	音を長く延ばして言う
eventide	夕べ|たそがれ
hashish	ハシッシュ|ハッシシ (大麻の枝先の葉と若芽を乾燥させた麻薬)
bookclub	a club that people join in order to buy selected books at reduced prices
glomerulonephritis	糸球体腎炎
iffy	ifが多い|疑わしい|微妙な|危うい|risky|あやふやな
uncommitted	拘束されていない|未遂の;約束
meagre	乏しい|貧弱|微微たる|貧しい|微々たる|貧小
locomotor	歩行|歩行運動
fantastical	架空|ファンタスチック|幻想的|ファンタスティック|突飛|ファンタスチック|珍妙|奇矯|ファンタスティック
reconstitute	再構成する
chintz	ささら木綿|光沢をつけたはでな模様の木綿製の更紗
nebulous	曇った|不透明な|星雲上の|ぼんやりした|かすんだ|漠然とした
dilettante	好事家|芸術愛好家|美術愛好家|素人芸術家
ouija	ウィジャ板
vassal	(封建時代の)封臣|領臣|家来|召使|奴隷
kookaburra	カワセミ(=kingfisher)|水に飛び込んで魚を捕まえる|ワライカワセミは laughing kookaburra
lineal	直系の
gainful	有利な
droll	滑稽な|ひょうきんな
terrarium	陸槽(陸生動物・植物を飼育する容器)
methodically	念入りに
sustainment	保持|持続|整備|保有|確保|維持|メンテナンス|保守|扶養|補修
compote	〈C〉(果物・菓子を盛る)足付き皿|〈U〉砂糖づけ(砂糖煮)のくだもの
mummer	無言劇の役者|役者
viciously	道徳に反して|よこしまに|意地悪く|ひどく
suntan	(健康的な)日焼け
monogamous	一夫一婦の
inflame	に火をつける|を燃やす|を明るくする|を熱くさせる
hypersonic	(音速の5倍に及ぶ)極超音速の
indistinct	はっきりしない
nevirapine	a non-nucleoside reverse transcriptase inhibitor (trade name Viramune) used to treat AIDS and HIV
chlorination	塩素処理;塩素殺菌
lounger	リクライニングチェア|凭れ椅子
presynaptic	シナプス前の
manus	ハンド|御手手|手|お手て|お手手|お手々|御手々
tenfold	10倍の(に)
bluefin	flesh of very large tuna|largest tuna; to 1500 pounds; of mostly temperate seas: feed in polar regions but breed in tropics|largest tuna|to 1500 pounds|of mostly temperate seas: feed in polar regions but breed in tropics
constrict	締めつける|圧縮する|押え付ける
bushido	traditional code of the Japanese samurai which stressed courage and loyalty and self-discipline and simple living
pilsner	a pale lager with strong flavor of hops; first brewed in the Bohemian town of Pilsen|a pale lager with strong flavor of hops|first brewed in the Bohemian town of Pilsen
knotty	もつれた(complicated)
speller	スペリングブック|綴り字教本|字を綴る人
limnology	陸水学
demagogue	扇動家|煽動政治家|民衆煽動家|デマゴーグ|民衆の指導者
tuft	ふさ|小さな房|小さい束|小さな丘
chancel	(教会堂の)内陣
crystallize	結晶化する|考えなどを具体化する
klutz	ぶきっちょ|のろま|どじ
bloodbath	血の海|血の粛正|大量殺戮(さつりく)|大虐殺(massacre)
inexorably	冷酷に|無情に|容赦なく
tongan	a Polynesian native or inhabitant of Tonga|the Polynesian language spoken by the Tongan people|of or relating to the island monarchy of Tonga or its people; "Tongan beaches"|of or relating to the island monarchy of Tonga or its people
dissension	意見の相違|不和の原因|紛争
diopter	ジオプトリー(レンズの屈折力の大きさを示す単位)
geb	ゲブ
weft	(織物の)横糸
counterculture	反体制文化|反文化
sunshade	(店舗用)日よけ|(婦人用の)日がさ(parasol)
imidazole	イミダゾール|含窒素芳香複素環式化合物の一つ
falsity	事実に反すること|偽りの言葉|欺瞞|虚偽|不信行為|不正直|裏切り
appendage	添加物|付加物
crustacean	甲殻類の
geographer	地理学者
volant	with wings extended in a flying position
airwave	放送電波
dendrobium	デンドロビウム
ballgame	野球の試合
joist	根太
clairvoyance	千里眼|透視力
ductwork	配管
orthographic	of or relating to or expressed in orthography
oversea	海外の|海外へ|海外向けの
interlocutor	対話者|対談者
knick	小物
fizzy	シューシュー泡立つ|発泡性の
heartbroken	悲痛な思いの
bluegill	米国Mississippi川流域産のクロマス科の談水魚
perplexity	当惑|途方に暮れること|紛糾|混乱|難問|難局
lameness	跛行|gimp|片ちんば
stockist	特定商品仕入れ業者(会社)
cementitious	like or relevant to or having the properties of cement; "the adhesion of cementitious materials"|like or relevant to or having the properties of cement
bannock	《英・スコットランド》バンノック(オートミールを主体にした菓子パン;米ではトウモロコシを用いる)
tightrope	綱渡りの綱
pithy	(文体が)力強い|簡潔な|簡潔にして要を得た|髄のある
birdcage	鳥かご|鳥かごのような場所|留置所
natriuretic	of or relating to natriuresis
mortise	ほぞ穴|切り組む|切り組む
hysterically	異常に興奮して|ヒステリー気味に
windsurf	ウィンドサーフィン
shortbread	ショートブレッド
blissfully	穏やかに
gratin	(仏語)グラタン
malign	有害な|悪性の
draftsman	製図係員|起草者|製図家(工)|立案者|デッサン画家
monsignor	(Roman Catholic Church) an ecclesiastical title of honor bestowed on some priests|an ecclesiastical title of honor bestowed on some priests
unpretentious	見栄をはらない
sounder	音響器
galvanic	(化学反応によって生じた)直流電気の|(笑い・動作などが)ひきつった|どきっとさせる
raze	完全に破壊する
oof	お金|強さ|現金|効力|ウーン|ウッ
cornflower	矢車菊|ヤグルマソウのほうが一般的|bachelor's button とも
parlance	語調
lethargic	(異常なほど)だるい|無気力の|不活発の
umlaut	母音変異|ウムラウト記号(¨)
dustbin	ごみいれ
marshland	湿地帯|沼沢地|沼沢地帯
nosocomial	院内
slob	泥|だらしなく薄汚い人
knell	(nél)|悲しみの鐘|弔いの鐘|鐘の音
buckshot	鹿弾(バックショット)と呼ばれる装弾は|散弾(Shot)より大きな鉛の弾を飛ばすための装弾|鹿|猪などの大きな獲物用
isotherm	等温線
chalcedony	玉髄(半透明の石英の一種)
erasable	capable of being effaced; "the fire's worst scars were effaceable by a comprehensive program of reforestation"; "a signal too loud to be erasable in a single pass through the erase head"|capable of being effaced
suitor	請願者|原告|求婚者
cichlid	シクリッド
cruciate	shaped like a cross
masseur	男のマッサージ師
bevy	(小鳥などの)群れ|(少女などの)一団|グループ
lithosphere	地殻
scad	any of a number of fishes of the family Carangidae
showstopper	an act so striking or impressive that the show must be delayed until the audience quiets down|something that is strikingly attractive or has great popular appeal; "she has a show-stopper of a smile"; "the brilliant orange flowers against the green foliage were a showstopper"|something that is strikingly attractive or has great popular appeal
gravelly	砂利の多い;砂利のような|(音・声が)ギシギシ(キーキー)いう
forging	鍛造
bearcat	ビントロング
inconspicuous	目立たない
dismissive	追い払うような
toxoplasmosis	infection caused by parasites transmitted to humans from infected cats; if contracted by a pregnant woman it can result in serious damage to the fetus|infection caused by parasites transmitted to humans from infected cats|if contracted by a pregnant woman it can result in serious damage to the fetus
soapstone	石けん石(石けんのような感触で炉床・溶槽などに用いる)
autoroute	高速道路
outdraw	早撃ちする
urbane	都会風の
sardine	イワシ|鰯|詰め込む
nebuchadnezzar	ネブカドネザル2世
meniscus	凹(凸)面|凹凸レンズ|新月(半月)形のもの|(ひざ関節の)半月板
hobble	妨げる|困らせる|たどたどしい|足かせ
stupor	まひ|知覚麻痺|昏睡|人事不省|昏迷|茫然自失|in a stuporぼう然自失して|He drank himself into a stupor
gratuitously	根拠もなく
sagamore	a chief of a North American tribe or confederation (especially an Algonquian chief)
aimless	目的のない
understate	控え目に言う
quietness	おとなしさ|つつましさ|穏やかなこと|静寂
oaten	of or related to or derived from oats; "oaten bread"|of or related to or derived from oats
celecoxib	a Cox-2 inhibitor (trade name Celebrex) that relieves pain and inflammation without harming the digestive tract
measly	不十分な|たったの|ちっぽけな|価値のない|わずかな|つまらない|不満足な|けちな|貧弱な|はしかにかかった|包虫症にかかった|麻疹
catharsis	カタルシス(観客が悲劇を観ることにより心のわだかまりなどの感情を浄化させること)
assignor	(law) the party who makes an assignment|the party who makes an assignment
protractor	分度器
flugelhorn	フリューゲルホルン
sangria	サングリア(赤ぶどう酒を薄めて甘味・香料を加えた清涼飲料)
antilock	アンチロック(anti-lock brake system)|自動車が急ブレーキをかけたとき|ロックを起こした車輪のブレーキの油圧を調節し|安全に止まれるようにした装置
kaon	an unstable meson produced as the result of a high-energy particle collision
anorak	アノラック(ずきんのついた防寒用のジャケット)
copperhead	カパーヘッド(アメリカマムシ)|豪州産コモチコブラの一種|南部に同情した北部人
blackbody	黒体(その表面に投射するすべての電磁波を吸収すると物理学的に仮定される物体)
kipper	に塩をして燻製にする
swampy	沼地の(ような)
procrastinate	ぐずぐずする|引き延ばす
wast	areの古語の過去形
cataloger	目録(カタログ)作製者
phon	a unit of subjective loudness
insinuate	遠回しに言う|ほのめかす|あてこする
wend	進む|行く|(古期英語「まわる」の意)
durum	デュラム小麦(マカロニ・スパゲティを作る原料)
sappho	the Greek lyric poet of Lesbos; much admired although only fragments of her poetry have been preserved (6th century BC)|the Greek lyric poet of Lesbos|much admired although only fragments of her poetry have been preserved (6th century BC)
viburnum	ガマズミ属の植物;樹皮は薬用
lustful	どん欲な|好色の
irrelevance	見当違い|無関係
guano	グアノ|鳥糞石|人工肥料
worshiped	崇拝されている
grandad	=granddad
nonmember	員外
driveshaft	a rotating shaft that transmits power from the engine to the point of application
necrotic	壊死の
everyplace	=everywhere
presumptuous	でしゃばりの|厚かましい
stipple	〈U〉点彩(点画|点刻)[法]|点彩(点画|点刻)による作品|〜‘を'点彩(点描|点刻)する
redouble	倍加する|強める|強まる
afore	=before
dour	陰気な|むっつりした|気むずかしい|きびしい|頑固な
trapezoid	台形
unadulterated	混ぜ物のない|純粋の
exploitative	搾取的な
urticaria	じんましん(蕁麻疹)
neonatology	that branch of pediatric medicine concerned with the newborn; the diagnosis and treatment of neonates|that branch of pediatric medicine concerned with the newborn|the diagnosis and treatment of neonates
nosy	かびくさい|鼻の大きい|おせっかいな|(口)せんさく好きな
unacceptably	容認しがたく
holography	レーザー写真術
storeroom	貯蔵室
psychomotor	of or relating to or characterizing mental events that have motor consequences or vice versa
salmonid	soft-finned fishes of cold and temperate waters
afforestation	造林|植林
maypole	(5月祭に立てる)5月柱|五月柱
liftoff	(ロケット・ミサイルなどの)打ち上げ|離昇
datura	チョウセンアサガオ
maneuverability	操縦性
stably	しっかりと|安定して
rachmaninoff	ラフマニノフ
athos	アトス山
xxxiii	being three more than thirty
brawn	(人の)筋肉|筋力|《英》煮て塩づけして固めた豚肉(《米》headcheese)
eardrum	こまく|鼓膜
periodontics	歯周治療学
ouster	放逐|占有剥奪|流浪性の|巡回の|広く分布している
pander	女を取り持つ男|売春宿の主人|人の弱みにつけ込む人|迎合する
matchless	無比の|無類の|無敵の
aether	=ether
prohibitively	法外に
dissociate	引き離す|分離する|解離する
regale	大いに喜ばせる
captopril	カプトプリル
unconcerned	心配しない
newlywed	新婚
underpayment	a payment smaller than needed or expected|the act of paying less than required
heritability	遺伝可能性
internode	節間(植物の茎などの節(ふし)と節の間の部分)
metastable	(of physical systems) continuing in its present state of equilibrium unless sufficiently disturbed to pass to a more stable state of equilibrium
woodsman	森の住人|山林に詳しい人|きこり
orthography	正書法|正字法
semiotic	記号の|記号論の
misbehavior	不作法
holotype	模式標本|基準標本
syncope	語中音消失(never→ne'erのように語中の音が消えて短縮されること)|(脳貧血などによる)失神|気絶|(音楽で)切分|区分法
paperclip	書類留め
pincus	ピンカス
hirer	元締め|雇主|雇い主|ボス|上司|大将|親分|元締
vibraphone	ビブラホン(鉄琴楽器の一種)
phobos	the larger of the two satellites of Mars
viscoelastic	having viscous as well as elastic properties
tapeworm	サナダムシ
desensitization	知覚鈍麻|脱感作
undergrowth	下ばえ|やぶ(underbrush)
enamored	にほれて|夢中になって
iteratively	反復して
depose	供述する|高位から退ける|退陣させる
gunfight	銃撃戦
ulterior	向こう側にある|潜在の
nij	the law enforcement agency that is the research and development branch of the Department of Justice
cryptologic	暗号の
asbestosis	石綿沈着症
inbuilt	本有的|生得的|固有
accompanist	伴奏者
bathhouse	風呂屋|銭湯|浴場|(海水浴場などの)更衣所
lenticular	レンズ状の
passim	(作家の特徴を示す概念・語句などが)各所に|随所に
cyberculture	the culture that emerges from the use of computers for communication and entertainment and business
cavitation	空洞現象(低圧で流体を中に空間のできること)
artisanal	職人の
scintilla	微量(の〜);(〜の)気味《+『of』+『名』》
jovial	陽気な
scoundrel	悪党|悪漢
pleurisy	ろく膜炎
hospitalisation	入院
xxxviii	being eight more than thirty
ology	an informal word (abstracted from words with this ending) for some unidentified branch of knowledge
majolica	マジョリカ焼き|マジョリカ風の焼き物|赤茶色
spork	スポーク
cumulatively	累積的
accursed	under a curse
duplicity	偽り|二枚舌
irrefutable	反駁できない
symbolise	象徴|模る|象徴|模す|象る|表現|意味|シンボライズ|表す|表わす
exaltation	昇進|賛美|大得意|意気軒昂(けんこう)
handiwork	手細工(品)
aliyah	(Judaism) the honor of being called up to the reading desk in the synagogue to read from the Torah; "he was called on for an aliyah"|the honor of being called up to the reading desk in the synagogue to read from the Torah|(Judaism) immigration of Jews to Israel; "students making aliyah"|immigration of Jews to Israel
joyously	いそいそ
zinnia	百日草|ジニア
ltm	your general store of remembered information
strident	かん高い|耳障りな|甲高い
internationalism	国際(協調)主義|国際性
smokehouse	薫製(くんせい)場
homeboy	a fellow male member of a youth gang|a male friend from your neighborhood or hometown
wampum	貝殻玉|磨かれた貝殻から作られ|ひもやベルトに使われる小さな円柱形のビーズ
redemptive	買い戻しの|質受けの|償還の|償いの
longitudinally	長期的|縦方向
southpaw	左ききの選手(ボクサー)|左投げの投手|左ききの
quine	クワイン
evince	はっきり表わす
stylishly	in a stylish manner; "she was dressed very stylishly"|in a stylish manner
intelligentsia	インテリ|知識人|知識階級
combative	闘争的な
bierce	アンブローズ・ビアス
brucella	ブルセラ
eris	エリス
highwayman	追いはぎ|乗り物を止めて物を盗るピストル強盗 (a holdup man who stops a vehicle
infiltrator	侵入者|潜入者
mandamus	(上級裁判所から下級裁判所への)職務執行令状
theremin	テルミン
briarwood	wood from the hard woody root of the briar Erica arborea; used to make tobacco pipes|wood from the hard woody root of the briar Erica arborea|used to make tobacco pipes
otherworld	あの世|来世
unhappily	運悪く|不幸にも|折りあしく|不適切に
leishmaniasis	レーシュマニア症
erst	昔は|以前は
scurvy	壊血病
plumeria	deciduous shrubs and trees of tropical America having branches like candelabra and fragrant white or pink flowers
antisemitism	反ユダヤ主義
wouldst	=would
tormentor	いじめっ子
lenten	of or relating to or suitable for Lent; "lenten food"|of or relating to or suitable for Lent
synchrony	同調言語学|同調的研究
boogeyman	糞|妖魔
ghee	ギー|水分を蒸発させて精製したバター脂肪
hypnotism	催眠術
industrialisation	工業化|産業化
cytosine	シトシン|核酸を構成する5種類の主な塩基のうちのひとつ
strongman	実力者|独裁者|有力者
expectorant	痰(たん)が出るのを促す|去痰(きょたん)剤
ceaseless	絶え間ない
emblematic	象徴の
challis	シャリス(羊毛・綿・あるいはレーヨンの軽い織物)
digitalis	〈C〉ジギタリス(ゴマノハグサ科の植物)|〈U〉その葉からとった強心剤
manufactory	工場|製作所
taw	はじき玉|びー玉|(はじき玉遊びの)基線
unreserved	遠慮のない|率直な|制限(制約)のない|無条件の
azimuthal	of or relating to or in azimuth
judicially	as ordered by a court|in a judicial manner; "judicially controlled process"|in a judicial manner
smatter	ちょっと手を出す|噛る|齧る|手を出す
cloudiness	曇り|曇天;(気象用語で)雲量|もうろう;陰うつ
backache	背の痛み
stealthily	こそこそと|こっそりと|密かに|一目を盗んで
breastplate	(よろいの)胸当て
cleverness	器用|賢さ|手際よさ|利口
sorcerer	魔法使い|魔術師
changeling	ひそかに(うっかりして)取り替えられた子|(おとぎ話で)妖精が美しくかわいい子とすり替えて残していった子
fice	a nervous belligerent little mongrel dog
nephritis	腎炎(じんえん)
toenail	足指の爪|斜めに打ち込んだくぎ|丸カッコ|くぎを斜めに打ち込んでを固定する
domiciliary	住所の|住居の
selectman	(米国New Englandでの)都市行政委員
maquiladora	マキラドーラ
undirected	当てのない|無目的|当ても無い
sunlit	日に照らされた
rediscovery	再発見
nauseate	吐き気を催させる
peaceable	平和を好む|おとなしい|平穏な|平和な
posttraumatic	心的外傷後の|(PTSD|Posttraumatic stress disorder|心的外傷後ストレス障害)
olanzapine	オランザピン(略称OLZ)|アメリカFDA(食品医薬品局)で承認された抗精神病薬|最も多く使用されている非定型抗精神病薬のひとつ
tangram	タングラム
quebecois	a native or inhabitant of Quebec (especially one who speaks French)|of or relating to Quebec (especially to the French speaking inhabitants or their culture)
anopheles	ハマダラ蚊(マラリアを媒介する)
djinn	魔神
asexual	無性生殖|無性の
tubman	タブマン
gaggle	がちょうの群れ|があがあ鳴く
extricate	救出する|遊離させる|解放する|脱出させる
anesthesiologist	麻酔医
supercharge	〈エンジン〉‘に'過給する
dormancy	休止|休眠|静止|不活動状態
incongruous	一致しない|調和しない|釣り合わない|不似合いの
yuletide	ユール|聖誕祭
indiscretion	無分別|無思慮|軽率
gendarme	(フランスの)憲兵|警官
contrivance	くふう|(人工的な)仕掛け|発明されたもの
gnaw	(nˈɔː|gはsilent)かじる|かみ切る|腐食する
paneled	fitted or decorated with panels or wainscoting
jungian	a follower or advocate of Carl Jung's theories|of or relating to Carl Jung or his psychological theories
sciatic	坐骨の|坐骨神経(痛)の|坐骨部
placate	なだめる
multiphase	多相
pika	ナキウサギ|兎
militancy	交戦状態|好戦性|闘志|闘争性
pinhead	馬鹿|間抜け|ピンの頭|つまらない物|まぬけ
cathodic	of or at or pertaining to a cathode; "cathodic deposition of metals"|of or at or pertaining to a cathode
comorbidity	併存疾患
palmistry	手相術
callow	未熟な|うぶな|羽毛がまだ生えない|青二才の
chloroquine	(医)クロロキン(抗マラリア薬|アミノキノリン系)
underfloor	(特に暖房装置が)床面下施工の
retrenchment	削減|節約|縮小|経費削減|不拡大方針
jugular	頚部|急所|最大の弱点|咽喉部の|頸静脈の|殺人的な|熾烈な|喉に腹びれのある
photoelectron	光電子
pimple	にきび|小突起
humus	腐植土
inattentive	不注意な
precession	春分点歳差(春分が年々早く起こること)
transmutation	変化|変形|変質|(物理学で)変換
prosciutto	プロシュート|香辛料の効いたイタリアハム
bemuse	(ぼんやりするほど)〜‘の'心を奪う
uninfected	感染していない
coonhound	クーンハウンド(アライグマ猟用に改良された猟犬)
unexpended	(of financial resources) not spent; "unexpended funds"; "his unspent allowance"|(of financial resources) not spent|not used up; "leftover meatloaf"; "she had a little money left over so she went to a movie"; "some odd dollars left"; "saved the remaining sandwiches for supper"; "unexpended provisions"|not used up
lawman	(昔の西部の)保安官
voiceless	無声の|無言の|意見を言えない|無声音の
uncluttered	having nothing extraneous; "an uncluttered room"; "the unlittered shoulders of the road"|having nothing extraneous
interrogator	質問者|呼掛け機
shrubbery	低木|生け垣
tannin	タンニン|タンパク質|アルカロイド(Alkaloid)|金属イオンと結合し|難溶性の塩を作る水溶性化合物|植物界に普遍的に存在|タンニンの名は「革を鞣す」の"tan" に由来
motorcyclist	オートバイ乗り
outcall	make a higher bid than (the previous bid or player); in a card game|make a higher bid than (the previous bid or player)|in a card game
rewriter	編輯人|編集する
extrovert	外向的な|外向型の人|外交的な人
dockyard	造船所
anastomosis	(血管・神経の)吻合(ふんごう)|接合|(葉脈の)網状連絡
dermis	=derma
insured	被保険者
presentment	〈U〉(〜の)贈呈|進呈;提出|提示《+『of』+『名』》|〈U〉(〜の)記述|陣述《+『of』+『名』》|(劇の)上演|演出
hierarchically	in a hierarchical manner; "hierarchically organized"|in a hierarchical manner
corrode	腐食する|腐食|侵食する|腐食させる
inure	慣れさせる|鍛える
unseat	落馬させる|議席を奪う|(地位･公職から)追放する
authoritarianism	独裁主義
pinecone	松かさ|松ぼっくり
coverall	すっぽりと覆うもの|つなぎ|赤ん坊のひとつなぎの服|全般的な|包括的な
buffoon	道化師|バカ|fool|道化
nookie	転ばす|ファッキン|セックス
dishonour	不名誉|屈辱|恥|恥辱|汚名|不義理|不名誉|屈辱|恥|恥辱|汚名|不義理|凌辱|陵辱|辱める|名を穢す
basenji	small smooth-haired breed of African origin having a tightly curled tail and the inability to bark
dimensioning	indicating or determining size and position in space; "the ultrasonic dimensioning measurement"; "an ultrasonic dimensioning arrangement of the heart"|indicating or determining size and position in space
perfumery	〈U〉《集合的に》香料|〈C〉香水製造(販売)所|〈U〉香水製造(販売)業
prudently	手堅く|用心して
luff	船首を風上へ向ける
hilariously	陽気に
virago	口やかましい女|がみがみ女
chicory	〈C〉チコリ(ヨーロッパ産の植物;葉はサラダに用いる)|〈U〉チコリの根(その粉末はコーヒーに加える)
explication	解明|詳細な説明
presentable	人に紹介できる|しつけの良い
arcadian	牧歌的
chablis	a town in north central France noted for white Burgundy wines|dry white table wine of Chablis, France or a wine resembling it
dais	(広間･食堂の)上段|高座|(講堂の)演壇
snooty	紳士気取りの|傲慢な|きざな|うぬぼれが強い
elitism	エリート支配(主義･意識)
sultanate	サルタンの領土(位)
foetal	=fetal
helicon	a tuba that coils over the shoulder of the musician
goatee	ヤギひげ
junket	ジャンケット(凝乳に甘味をつけた食品)|宴会|旅行
prematurity	早熟|未熟児
hepatocyte	肝細胞
carwash	洗車場
collegium	(各員が平等の地位と権力を持つ)支配者集団|(特にかつての)旧ソ連人民委員会
retouch	写真修正
discouragement	失望
insolence	横柄な態度
braless	having the breasts uncovered or featuring such nudity; "topless waitresses"; "a topless cabaret"|having the breasts uncovered or featuring such nudity
inoculum	接種材料
theosophical	神知学の|接神教(論)の
moneymaker	儲け仕事|金儲けのうまい人|蓄財家
transversal	(幾何で)横断線
elaborately	念入りに
gaslight	ガス灯(の光)|ガスの火口
niobium	ニオビウム(金属元素;化学記号は『Nb』)
pith	(植物の茎の中の)髄;(果実などの)やわらかい部分|《the ~》(〜の)重要な部分|要点《+『of』+『名』》
gladden	〈人〉‘を'喜ばせる
retrovirus	レトロウイルス|RNAウイルス類の中で逆転写酵素を持つ種類の総称|レトロウイルス科とも呼ばれる
flambeau	たいまつ
smooch	キスする|愛撫する|抱擁する
railbird	a fan of racing who watches races from the outer rail of the track
waterless	退屈
gnosis	intuitive knowledge of spiritual truths; said to have been possessed by ancient Gnostics|intuitive knowledge of spiritual truths|said to have been possessed by ancient Gnostics
powwow	(病気回復|猟の成功|戦いの勝利などを祈る)北米インディアンの儀式|北米インディアンの会議|《おどけて》(一般に長ったらしい)会議|集会|〈北米インディアンが〉儀式を行う|《おどけて》会合する
runic	relating to or consisting of runes; "runic inscription"|relating to or consisting of runes
skewness	不平等
transmissible	伝播性|伝染性
penitent	悔い改めた|後悔している|罪を悔いる人
goby	通り過ぎること|見て見ぬふり
linesman	=lineman|(スポーツ競技で)線審・ラインズマン
framer	フレーマ|フレーマ
effectual	効果的な|効きめのある|(法律上)有効な
unimproved	not made more desirable or valuable or profitable; especially not made ready for use or marketing; "taxes on unimproved land are low"; "unimproved dirt roads"|not made more desirable or valuable or profitable|especially not made ready for use or marketing
arteriovenous	動静脈
deaminase	デアミナーゼ|脱アミノ酵素
astonish	驚かす|突然びっくりさせる
trisomy	chrosomal abnormality in which there is one more than the normal number of chromosomes in a cell
cerise	サクランボ色|淡紅色
gird	備える|囲む|(帯で)～を締める|縛る|まとう
mendelsohn	エーリヒ・メンデルゾーン
shute	シュート
revascularization	血行再建
parsimony	極度の倹約|けち
discriminator	微分器
raunch	卑陋|低劣|平凡|俚俗|俗気|粗野|下品|不意気|卑俗|俗
recto	(印刷で)右[側の]ページ
ashen	灰の|灰白色の
ankylose	produce ankylosis by surgery|undergo ankylosis; "joints ankylose"|undergo ankylosis
procrastinator	someone who postpones work (especially out of laziness or habitual carelessness)
broadsheet	一枚刷|新聞用フルサイズ紙
conjoint	結合した|共同の|連帯の
showman	興行師
echt	not fake or counterfeit; "a genuine Picasso"; "genuine leather"|not fake or counterfeit
ramjet	ラムジェット(航空機のジェットエンジンの一種)
inexcusable	言い訳のたたない|許し難い|けしからん|言語道断
muttering	うなり声
provable	証明できる
heterocyclic	複素環式化合物
recalcitrant	強情張り|反抗的な
thoughtfulness	思慮深さ
outmoded	流行遅れの
harshness	厳しさ
anabaptist	アナバプテスト
yellowfin	キハダ|黄肌
markdown	値下げ|プライスダウン(和製英語)
spyglass	小望遠鏡
sterilisation	断種|消毒|殺菌
crossway	=crossroad
foodstuff	食料品
gluttony	暴飲暴食
truant	怠ける|怠け者|無断欠席者|無断欠席する学生
exfoliate	剥離
crackpot	狂人
decelerate	減速する
tiramisu	ティラミス(イタリア語)
utiliser	someone who puts to good use; "not all organisms are utilizers of oxygen"; "the social agencies and their utilizers both objected to the budget cut"|someone who puts to good use
markoff	マルコフ
prostatitis	前立腺炎
commercialism	コマーシャリズム|商業主義|商慣習
alstroemeria	アルストロメリア属
sandbar	(河口・湾口の潮によってできた)州|砂州(さす)
unpatriotic	愛国心のない
impute	不名誉なことをに帰す|負わせる|不名誉なことを～に帰する|のせいにする
bandstand	野外ステージ
anionic	a class of synthetic detergents in which the molecules do not ionize in aqueous solutions|of or relating to anions
digestibility	こなれやすいこと|消化能力|消化のよしあし
archaea	古細菌(単数形はarchaeon)
compleat	=complete
chambered	having compartmental chambers; "a spiral chambered seashell"|having compartmental chambers
consumptive	消費の;消耗させる|破壊的な;(〜を)消費する《+『of』+『名』》|《古》肺結核の|肺病患者
melancholic	憂うつな|憂鬱な
cathartic	カタルシスの|下剤の
noisily	やかましく
corticotropin	副腎皮質刺激ホルモン
denaturation	変性
unaccountable	説明できない|謎の|責任を負わない
compositor	合成器|植字工
reminiscence	追憶|記憶|思い出|思い出させるもの|回想すること
brama	type genus of the Bramidae
woodblock	木版[画]|(床材用などの)木[目]タイル
descendent	下降の|伝来の|子孫(=offspring)
fetishism	呪物(じゅぶつ)崇拝|物神(ものがみ)崇拝|(事物に対する)盲目的崇拝(関心)
bellwether	先導者|主導者
punky	minute two-winged insect that sucks the blood of mammals and birds and other insects
genealogist	系図学者|系譜専門家
chromate	クロム酸塩
inferential	推理の
prerecord	〈番組の〉‘の'録画(録音)をとる
razzle	any exciting and complex play intended to confuse (dazzle) the opponent
insolent	横柄な|ごう慢|無礼な;(〜に対して)横柄な《+『to』+『名』》
neuropathic	神経病の
lectureship	大学の講師の職(地位)
newsman	ニュース番組のレポーター|取材記者
finis	終[り](本・映画などの最終にしるす語)
comprehensiveness	包括的なこと|考えの幅|知識の広範さ|視野の広さ
reclusive	孤独好きの|わびしい|寂しい
beastly	獣のような
letdown	減少|(気の)ゆるみ|失望|(空)(着陸前の)下降
nonesuch	無比の人(もの)|逸材(品)
foment	(不和･反乱など)を助長する|扇動する|に湿布する|醸成する|(患部)を蒸す
legibility	(文字が)読みやすいこと
guinevere	(Arthurian legend) wife of King Arthur; in some versions of the legend she became Lancelot's lover and that led to the end of the Knights of the Round Table|wife of King Arthur|in some versions of the legend she became Lancelot's lover and that led to the end of the Knights of the Round Table
cyclopedia	百科|百科辞書|百科全書|エンサイクロペディア|百科事典|百科辞典
summerhouse	あずま屋
arcanum	シークレット|内密|奥義|秘か|内聞|内証|秘決|秘訣|奥許し|隠し事
schooler	就学児童
switchback	スイッチバック(急勾配をジグザグに上る線路)・ジグザグの山道・ジェットコースター（roller coaster）・(一般に)変換|変更
tardiness	緩慢;遅刻
ruminate	反すうする
birdsong	鳥の鳴き声|囀り|鳴き声|さえずり
ammonite	アンモン貝|アンモナイト
leggy	足のひょろ長い|足の長い
liken	たとえる|なぞらえる
solanum	ナス
kahlua	カルーア
incredulous	なかなか信じない|容易に信じない|懐疑的な|疑わしそうな
kaolin	白土|高陵土|陶土
governess	(住み込みの)婦人の家庭教師
predilection	ひいき|偏好
demille	セシル・b・デミル
uncooperative	非協力的な
stiffen	堅くする|をこわばらせる|固くなる|強ばる
devastate	荒廃させる
adroit	巧妙な|器用な|機敏な|気転のきく|抜け目のない
perfuse	(医)灌流する(臓器や組織に液体を流すこと)|灌流適用する
oxygenase	酸素添加酵素
royalist	王党派
highchair	脚の高い幼児食事用いす
peasantry	小作農|小作農の地位|農民らしさ|田舎風
torte	トルテ
letterpress	〈U〉凸版印刷[物]|〈C〉《おもに英》(さし絵以外の)本文
satyr	サチュロス(ギリシア神話で半人半獣の酒色を好んだ森の神;ローマ神話のfaunにあたる)
proteomic	プロテオーム解析またはプロテオミクスは|構造と機能を対象としたタンパク質の研究
abbreviate	短くする|省略する|短縮する
pinkish	桃色がかった|薄桃色の
tutelage	後見|保護|監督|指導
oolong	ウーロン茶|烏龍茶
waratah	straggling shrub with narrow leaves and conspicuous red flowers in dense globular racemes|tall shrub of eastern Australia having oblanceolate to obovate leaves and red flowers in compact racemes
concretely	具体的に|具体的
allopurinol	アロプリノール
bursitis	滑液包炎
operatively	in a manner to produce an effect
shellac	セラック
superfine	(商品などが)極上の|最上の;
jambalaya	ジャンバライヤ
helluva	ひどい|すばらしい|とても|非常に|「hell of a ...」に由来する
peculiarity	風変わり|特性|変わった点|独特のもの
decrepit	使い古した|弱った|老いぼれの|古くなってガタガタの|老朽化した
microvascular	微小血管の
flintstone	pebbles of flint used in masonry construction
sinkhole	(流しなどの)排水口;《米》下水だめ|ドリーネ(石灰岩台地などにできたすりばち穴)
equivocal	疑わしい|両義にとれる|多義的な|曖昧な
bocce	Italian bowling played on a long narrow dirt court
handmaid	侍女|女中
speedboat	高速モーターボート|快速艇
bottlenose	ハンドウイルカ|トックリクジラ属
bestest	最高のもの
biomarker	バイオマーカー|生物指標化合物|ある疾病の存在や進行度を|その濃度に反映し血液中に測定されるタンパク質等の物質を指す
unofficially	ひそかに|私的に|非公式に|非公式
cyclooxygenase	シクロオキシゲナーゼ(特定の酸を生理活性物質に代謝する酵素)