croon	低音の歌い声|小声で唄う|口ずさむ
ethology	動物行動学
midweek	週の真ん中
musketeer	銃兵
vouchsafe	〈返事・特典など〉‘を'賜る|与える
armorial	紋章の
longbow	大弓|長弓
affaire	通常|情事|不適な関係に使われる
bogie	ボギー(ゴルフ用語) (boggy|沼地は別語)
nimbus	(宗教画などの)後光 ・光輪・(人・もの・場所にただよう)輝かしいふんい気; 後光 (halo)・光輪; 栄光;雨雲
objectivism	客観主義|客観論
tureen	ふた付きの深皿
pugilist	(pjuː|dʒəl|ɪst) )(プロ)ボクサー|けんか(議論)好きな人
tromp	殴る|ぶちのめす|完敗させる|打つ
candidature	=candidacy
prig	堅苦しい人
hanker	あこがれる|こがれる|渇望する
neuroleptic	神経弛緩薬
workingman	働く人|労働者|労務者|職人|工員
literalism	文字通りに解釈すること|直訳調|写実主義
thiazide	チアジド|心臓|肝臓|腎臓病による高血圧や浮腫を治療するために使われる利尿剤
keratinocyte	ケラチノサイト|角質細胞|ケラチン生成細胞|角化細胞|ケラチン細胞
vaporous	蒸気が充満した|蒸気を出す|霧のかかった|はかない|空想的な|妄想的な|誇大な|実質のない
liquorice	=licorice
headpiece	兜|帽子|頭|頭脳
liveried	お仕着せ(livery)を着た|そろいの服を着た
metalworking	金属細工術
overdraw	〈預金・限度額など〉‘を'超過して借りる;〈小切手〉‘を'過振りする|〜‘を'誇張して描写する
sexless	男女の別のない|性的魅力のない|セックスレス
tipple	(恒常的に)酒を飲む|アルコール飲料
ammeter	電流計
bangle	腕輪|くるぶし飾り
vole	ハタネズミ(小型のネズミ族の総称)
longboat	長艇
suffuse	満たす
prejudge	前もって判断する
woodcock	ヤマシギ
buttercup	キンポウゲ(春に美しい花をつける植物)
howsoever	たとえ〜でも
leprous	ハンセン病(らい病)にかかった;ハンセン病の|らい病の
unchristian	(宗教が)キリスト教でない|キリスト教的精神に反する
chiaroscuro	(イタリア語)キアロスクーロ|白と黒のスケッチ (light and dark)
futurism	(芸術の)未来派
prevaricate	言い紛(まぎ)らす|言い逃れる|うそをつく|お茶を濁す
foist	(偽物など)を人につかませる|押しつける|そっと挿入する|偽って～の作だとする
arty	芸術家ぶった(気取りの)|芸術品まがいの|こりすぎた
skylark	ヒバリ|ばか騒ぎする
gazer	見詰める(凝視する)人
shortlist	最終選抜候補者名簿|〈人〉‘を'最終的選抜候補者名簿に載せる
photocopier	写真複写機
amusingly	面白おかしく
coastguard	《集合的に》(米国の)沿岸警備隊|(またcoastguardsman)(個々の)沿岸警備隊員
hemochromatosis	ヘモクロマトーシス|血色素沈着症|血色素症
shabbily	みすぼらしく;卑しく
trilateral	三辺の|三者から成る|三辺形
undersecretary	次官(deputy secretary|大臣|長官の補佐)|政務次官
assize	〈U〉判事と陪審員による裁判|《複数形》《英》巡回裁判(ロンドンから定期的にイングランドの各州に裁判官が派遣されて行う裁判)
libitum	自由
gaffe	(特に社交･外交上の)失敗|へま
tenon	(木工で)ほぞ
slinky	しなやかな|セクシーな|腰をくねらす|内緒の|コソコソした
sorbet	シャーベットsherbet
fibril	小繊維|根毛
ideologue	イデオロギーの信奉者|空論家|夢想家
haemodynamic	血行動態
croft	(屋敷続きの)小農園;(家畜数頭を飼育する程度の)小牧場|(小さな)小作地
recalcitrance	手に負えないこと|強情|反抗
raga	ラーガ(インド音楽の旋律の一つ;その曲)
pleb	庶民
creeped	(女性が男性に対し)気味が悪い感じ|這い回るような
mimeo	=mimeograph
bobble	ふらつく|よろめく|へまをする|(野球)打球をとり損なう|ファンブルする
jailhouse	刑務所
sportsmanship	スポーツマン精神|スポーツマンシップ
meshwork	網細工
sprocket	鎖歯車の歯|=sprocket wheel
villus	絨毛
trophoblastic	絨毛(性の)|栄養膜の
thiosulfate	チオ硫酸塩|チオ硫酸塩は自然に存在する化学物質で|「チオ」は硫酸イオンの酸素原子が硫黄原子で置換された「S₂O₃²⁻」 を含む塩を示す
shibboleth	シボレテ(聖書で|ギレアデ人がshの音を発音できないエフライム人を区別する目的で発音させた言葉);ある集団を特徴づける習慣・言葉遣い・昔は重要であったが現在では重要性のない表現や習慣
rouble	=ruble
pundit	専門家|博学者|インド人の賢者|博識者
bailey	外壁|城の中庭
seabird	海鳥
underclothes	下着|肌着(underwear)
ukulele	ウクレレ
optician	(特に)眼鏡商|光学器機商
malinger	(特に軍務|労働などを避けるために)仮病を使う
marsupial	有袋動物|有袋目の|袋(状)の
amortize	(無形固定資産などを)償却する
cogency	(理由・議論などの)説得力|なるほどと思わせること
vilification	悪口|中傷
mealy	(míːli)(mealier|-iest)粉状の|粉(こ)を吹いた(mealy potatoes粉吹きジャガイモ)|食事を含んでいるか食事でできている(containing meal or made of meal)
diamagnetic	反磁性の|逆磁気の
urology	泌尿器科|泌尿器科学
arrogate	(自分の物に)〈権力・特権など〉'を'不当に帰する(占める)《+『to』 one『self』+『名』》|(自分に)〜‘が'あると理由もなく言う《+『to』one『self』+『名』》
lunate	三日月形の
vim	精力|気力|活力
loopy	愚かな
swordsmanship	剣術の腕前;剣術|剣道
estrange	遠ざける|引き離す|の心を離す|の仲を裂く|疎遠にする
antennal	触角の
pedophilia	小児性愛
cabana	(海辺やプールサイドの)簡易更衣所|小屋
sportswear	スポーツウェア|運動着
bloat	ふくれさせる|ふくれる|慢心する
chloroquine	(医)クロロキン(抗マラリア薬|アミノキノリン系)
resuspended	再懸濁
antifreeze	不凍液
foremast	前檣(ぜんしょう)
loveable	(=lovable)|愛らしい|愛すべき
splat	薄い平板
doh	(音階の)=do
qualm	(kwάːm)良心のとがめ|不安
mandamus	(上級裁判所から下級裁判所への)職務執行令状
toenail	足指の爪|斜めに打ち込んだくぎ|丸カッコ|くぎを斜めに打ち込んでを固定する
phenotypically	表現型(肉眼で見える生物の形質)
helmeted	ヘルメット(かぶと)をかぶった
spiritless	元気のない
chondroitin	コンドロイチン|動物体内にみられるグリコサミノグリカン(ムコ多糖)の一種
lanthanum	ランタン(希土金属元素;化学記号は『La』)
overtop	〜‘の'上にそびえる|〜‘より'高い|〜‘より'すぐれる
dirk	(特にスコットランド高地人の)短刀
chauvinist	偏愛主義者|狂信的愛国主義者
suspenseful	サスペンスに満ちた
overmaster	〜‘を'圧倒する|克服する
predetermine	を予定する|を運命づける
flippancy	軽薄|軽薄な言葉(行為)
rigueur	(仏)絶対条件|厳格|厳しさ
puffin	ツノメドリ(はでなしま模様で三角の口ばしを持つ海鳥)
pulverize	(議論などを)粉砕する|粉にする|粉々に砕く|液体を霧状にする
barnacle	フジツボ (acorm barnacle|rock barnacleなどはフジツボ目の総称)
brioche	ブリオッシュ(小麦粉・卵・イースト・バターなどで作る軽くて甘い菓子パン)
icebox	冷蔵庫|アイスボックス
letdown	減少|(気の)ゆるみ|失望|(空)(着陸前の)下降
kamikaze	神風特攻隊のような|無茶な
meed	相応(当然の)報酬|正当な報い
poltergeist	騒がしいいたずら好きの妖精
thruster	(宇宙船の)高度制御ロケット|《英俗》(キツネ狩りで)猟犬に近づき過ぎる狩猟家|《話》でしゃばり屋
clef	音符記号
cumbrous	=cumbersome
idolize	偶像化する|偶像を崇拝する|溺愛する
avionics	航空電子工学
rearm	再軍備する
betoken	予示する
alluvium	沖積層|沖積土(河川によって運ばれてきた地層)
concertina	コンチェルティーナ|アコーディオンの一種|(アコーディオンのように)伸縮する|(蛇腹状に)ぺちゃんこになる
ladybug	テントウムシ(=ladybird)
intelligibly	分かりやすく・明りょうに
pooch	ふくらます|ふくれる|犬|雑種犬
pullback	〈U〉引き戻すこと|《複数形で》撤兵|撤退
permissiveness	寛容さ
digitalis	〈C〉ジギタリス(ゴマノハグサ科の植物)|〈U〉その葉からとった強心剤
rota	当番表|ロタ島(Rota Island)|ミクロネシアにある米国の自治領|人口約3000人
concessionaire	営業権所有者|(場内の)売店営業者
nonaligned	(国家が)非同盟の|中立の
coco	ココヤシ|ヤシ|黒人|頭|有色人種
phylogenetically	系統発生的に
fabricator	製作者|ほら吹き;(文書などの)偽造者
virtu	〈U〉(美術品などの)優秀性|よさ|値打ち|《集合的に》《複数扱い》美術品|骨とう品|〈U〉美術品(骨とう品)に対する造詣(知識) = vertu
stumpy	切り株の多い|切り株だらけの|太くて短い|ずんぐりした
hurtle	激しくぶつかる|突進する|音をたてて行く|急速に進行する|衝突する
alveolus	胞|肺胞|腺房|歯槽|小窩|歯ぐき
catatonia	緊張[型分裂]病(筋肉硬直や精神混迷を伴う)
intriguingly	興味深いことに
casuistry	決疑論(特定の行為を道徳的原理に照らしてその是非を解決しようとすること)|〈C〉詭弁(ぎべん)
packhorse	(荷物を運搬する)駄馬(だば)
pantheistic	汎神論の|自然崇拝の
bassinet	ほろ付きゆりかご;ほろ付きのうば車
botanic	植物の
lysate	ライセート|溶菌液|溶解質|溶解物|溶血物
parochialism	考えの狭さ|偏狭;地方根性
kinswoman	親類の女
quadrangular	四角(辺)形の
banns	結婚予告(教会での挙式前に新郎新婦の名前を公表し|その結婚に対する異議の有無を問う)
pansy	三色スミレ|パンジー|スミレ色|にやけた男|ホモ
sandcastle	子供が砂で作るお城
neocolonialism	(強国の新興独立国にする)新植民地主義
umber	アンバー(黄褐色の天然鉱物顔料)|こげ茶色|こげ茶色の
becalm	(風がないで)〈帆船〉'を'止める
lowliness	(地位・身分などの)低いこと|腰の低いこと|謙そん
caravel	キャラベル(15-16世紀の軽快な帆船)
cannibalistic	人食いの;共食いの
ectodermal	＜ectoderm|外胚葉(発生初期における胚の外表面の細胞層|将来表皮や中枢神経系|感覚器官などに発達する)の|性の
meh	まあ
infantryman	歩兵
bicuspid	(歯などが)2つの尖(せん)部(突起)を持つ|小臼歯(きゅうし)
carport	カーポート|差しかけ屋根のみの簡易車庫(garageとは異なる)
impale	突き刺す|刺し貫く
acquirement	〈U〉(不断の努力・習慣などによって)(〜を)取得(習得)すること《+『of』+『名』》|〈C〉《しばしば複数形で》(身につけた)学識|技能
unsubstantial	がんじょうでない|もろい|弱い|実質(実体)のない;非現実的な|空想的な
luxuriate	大いに楽しむ|ぜいたくをする|繁茂する|ぜいたくに暮らす|ふける
senility	(sɪníləṭi)老齢|老衰|おいぼれ|もうろく
carriageway	車道
onomatopoeia	擬音|擬音語
dauphin	《しばしばD-》ドーフィン(昔のフランス皇太子の称号)
demilitarize	非武装化|非軍事化する
exoneration	免罪|罪を晴らすこと
haunting	絶えず心に浮かぶ
passover	過越の祭り
mallard	マガモ(の肉)
fiance	(仏語)(男の)婚約者
bewilder	まごつかせる|当惑させる|驚き呆れさせる
corroborative	(信念などを)強固にする|(人･証拠など)確証的な
interpenetrate	〜‘に'十分浸透(貫通)する|十分に(相互に)浸透(貫通)する
demerit	短所
shogunate	(日本の)幕府の
invulnerability	傷つけられないこと|不死身|破られないこと|論破されないこと
nother	その他の何もない|Ex|nother thing just occurred to me
teatro	テアトロ(劇場|演劇|シアター|イタリア語)
typo	誤植(typographical error)|印刷工|印刷技術者(typographer)
whittle	削る|をナイフで(少しずつ)削る|を減らす
showing	展示(会)|外観|説明|できばえ
skitter	水面すれすれに飛ぶ|速やかに進む|流し釣りをする
autocrine	オートクリン|自己分泌
diabolic	悪魔のような
troika	トロイカ|三頭制|3人組
metamorphose	魔術などで違ったものに変身する|変える
dork	馬鹿|間抜け(卑語)
collagenase	コラゲナーゼ|コラーゲン蛋白を分解する酵素の一種
pulpy	ドロドロの|果肉の|果肉状の|柔軟な|汁の多い
munificent	非常に気前のよい|物惜しみをしない
hobgoblin	悪鬼|鬼|幽霊
chicanery	ずるい言い抜け|ごまかし
dramatics	演出法
youngish	どちらかというと若い|なんとなく若い|若い人
connotative	含蓄のある|(論理学で)内包的な
thereat	そこで|その時|そのために
entente	〈C〉〈U〉(2か国・数か国間の)友好関係|〈U〉《the~》《集合的に》(友好関係を結んでいる)2か国|数か国
diametric	=diametrical
choreograph	(バレエの)振付けをする
relict	残存生物(過去の環境のなごりである動植物)|《古》未亡人|寡婦(かふ)|なごりの|残存の|遺物の
misconceive	〜‘を'誤解する|思い違いをする(misunderstand)
mishmash	ごたまぜ|寄せ集め
samovar	サモワール(おもにロシアで用いられているお茶用の湯沸かし器)
slushy	雪解けの|ぬかるみの|くだらない;感傷的な
chummy	仲よしの|親しい
surefire	必ずうまくいく|成功疑いなしの
pleader	申立て人;嘆願者|弁護人
floater	浮くもの(人);(住所|職などを)転々と変える人;浮動投票者
justness	正しさ|公正|正当|合法
preclusion	防止|妨害
tao	道教の「道」
castigate	厳しく罰する|きびしく非難する|添削する
dumpy	ずんぐりした
uproariously	騒々しく|やかましく|どっと(笑うなど)
bombast	大言壮語|豪語|誇張
whiten	白くする|を白くする|白くなる
baht	バーツ(タイの通貨単位)
callow	未熟な|うぶな|羽毛がまだ生えない|青二才の
carefulness	注意深いこと
kohl	コール墨|アンチモニーの粉末でアラビア婦人などがまぶたを黒く染める|人名
nostalgically	昔を懐しんで|郷愁で
paperweight	文鎮
ultramarine	群青(ぐんじょう)(明るい空色をした顔料)|群青色|群青色の
mizzen	(3本マスト船の)後帆|=mizzenmast
decoherence	デコヒーレンス|量子力学で「量子力学的重ね合わせ」と呼ばれる状態が外的要因で破壊され|量子上の情報が失われる現象のこと
commoditization	コモディティ化|日用品化
ouch	痛っ! (という声)
firing	発射する
intoxicate	酔わせる|夢中にさせる
defector	離反者|離党者|脱党者|脱落者|亡命者
benefice	(牧師|特にvicar|rectorの)聖職禄;受禄職者の地位
solvability	解決しやすさ|解きやすさ
glasshouse	温室|ガラス工場|営倉
seashell	貝|貝殻
trachoma	トラコーマ|トラホーム(眼の伝染病)
internist	内科医
hottie	湯たんぽ
capsicum	トウガラシ;その実
dissidence	(意見などの)相違|不一致
lithology	岩石学|結石学
pmol	ピコモル|濃度を表す方式|溶液1L中の溶質をモル数を使って表した単位1mol/L|その10(-12乗)mol=1pmol 
prurient	好色な|いん乱な|わいせつな
antral	(解剖学)腔の|空洞の
loveseat	二人掛けのいす
stunner	気絶させる人(物)|(話)すばらしい美人
micturition	排尿(=voiding)
zodiacal	(天文学で)黄道帯(獣帯)の十二宮[図]の
actinic	化学線作用を持つ|(actinic rays化学線|紫外線)
adze	(材木をけずる)手おの
inhalant	吸入剤
neurasthenia	神経衰弱
tubercular	結節のある|結節状の|(また tuberculous)結核の|結核性の
stentorian	大声の
suppressant	抑制剤
grenadier	擲(てき)弾兵(昔|手りゅう弾を投げる任務をもっていた兵士)|《Grenadier》《英》近衛(このえ)歩兵第1連隊の兵
joule	ジュール|SI(国際単位系)でのエネルギー|仕事|熱量|電力量の単位|1Jは標準重力下で約102|0 グラムの物体を 1 メートル持ち上げる仕事に相当
visitant	《文》幽霊|亡霊|(またvisitor)渡り鳥
deism	自然神教|理神論
pimple	にきび|小突起
bafflement	挫折(ざせつ)|失敗
superabundance	(物・愛情などの)過多|過剰《+『of』+『名』》
seasonable	季節(時節)に合う|時節がらの|《文》時機を得た
retrogression	後退|逆行|退化
layover	旅行途中の一時的滞在
exhibitionism	自己宣伝癖|露出症
mudflat	干潟(ひがた)
mitten	ミトン(親指だけ離れたふたまた手袋)|手袋
rococo	ロココ様式(の)
skydiving	スカイダイビング(パラシュートで目標地点への降下を競うスポーツ)
lexicographic	辞書編集の
handcart	手押し車
naughtiness	わんぱく
venation	脈相(植物の葉脈・昆虫の翅脈などの分布状態)
roofless	(建物が)屋根のない|(人が)宿なしの
vermiculite	バーミキュライト|ひる石(熱するとふくれ|防音・断熱材として用いられる)
criminologist	犯罪学者
camber	上反(うわぞり)(道路や船のデッキなどの|雨水などを端に流すための傾斜)|(自動車の|ふつう前輪の)上開き傾斜|上反になる|〜'を'上反にする
affray	《文》(公共の場所での)乱闘|口論
venturesome	冒険的な|大胆な|冒険好きな
huntress	狩りの女神|狩猟用の雌馬|女性狩猟家
menfolk	男たち|男性|男連中|複数扱い
casualness	偶然|むとんじゃくさ;さりげなさ
plash	=splash
inkstand	インクスタンド
shoestring	靴ひも|(靴ひものように)細長い|(資金･予算)わずかな|乏しい
tellurium	テルル|非金属元素|元素記号Te|太陽電池や各種電子部品の材料|ビスマスとの合金は熱電変換素子|先端工業に欠かせぬレアメタルの一種|日本でも産出する
confute	論破する
lief	快く|喜んで
worktop	調理台|(台所の)作業台
magus	古代ペルシアの僧|《文》魔術師
frag	(手投げ弾で)〈気にくわぬ上官〉‘を'粉々にしてやる|襲う
gazetteer	地名辞典|地名索引
anechoic	(録音室・スタジオなどが)反響のない|無響の
perspicacity	洞察力|明敏
putsch	(pˈʊtʃ)反乱|暴動|一揆
symbiont	共生生物
matchbox	マッチ箱
paisley	ペーズリー織り(の)|ペーズリー模様(の)
imager	撮像装置
larboard	(船の)左側
dicey	あぶなっかしい
riskiness	危険|危ないこと|冒険的なこと
anodize	〈金属〉'を'陽極酸化する(電解で酸化皮膜をつけること)
milord	御前(ごぜん)様|だんな
countersign	(特に戦場で歩哨・斥候などの)合い言葉|応答信号|副署(他の人の文書に確認のためにする署名)|〜‘に'連署(副署)する
misdeed	悪い行い|悪行|犯罪
pantsuit	パンツスーツ
misrule	悪政|矢政|〜‘の'統治(政治)を誤る
parsnip	パースニップ|セリ科の二年草|ニンジンに似た根菜で|別名アメリカボウフウ|シロニンジン|サトウニンジン|ヨーロッパ原産
innominate	名の無い|無名の
luxe	贅沢|華美
islander	島の住民|島民|島国民
buckshot	鹿弾(バックショット)と呼ばれる装弾は|散弾(Shot)より大きな鉛の弾を飛ばすための装弾|鹿|猪などの大きな獲物用
poesy	=poetry
typographic	活版印刷術の|印刷上の
tempera	テンペラ画[法](壁画などに水性絵の具を卵黄などで溶いて用いた画法)|テンペラ絵の具
requester	依頼者|請求者
beautification	美化|装飾|盛装(粧)
hayloft	(馬小屋の納屋の2階にある)干し草置き場
lamentably	嘆かわしく
neocortical	大脳新皮質とは|大脳の表面を占める皮質構造のうち進化的に新しい部分|合理的な思考や|言語機能をつかさどる
philander	(男が)戯れに恋をする|(女に)言い寄る|いちゃつく
abstinent	節度のある|禁欲的な|禁酒の
archetypical	=archetypal
captaincy	captainの地位(職)
cypher	=cipher
prankster	いたずら者|ふざけ屋|ふざけ者
nitrocellulose	ニトロセルロース(硝化綿)|セルロースを硝酸と硫酸で処理し作る|用途は塗料|接着剤|火薬(白煙を出す黒色火薬に比し無煙火薬と呼ばれる)|樟脳と作られたセルロイドは世界初の熱可塑性合成樹脂
admix	(〜と)〜'を'混合する《+『名』+『with』+『名』》|混合する|まざる(mix)
cartoonish	漫画っぽい
euphemistic	婉曲語法の|婉曲な|遠回しな
maladjustment	適合(調和)しないこと;(環境への)不適応
purgation	清めること|浄化;浄罪|便通[をつけること]
stockpot	スープなべ|ソースなべ
pigmy	=pygmy
cavalryman	(1人の)騎兵
ourself	myself|君主の公式用語･新聞の社説用語
smut	汚す|塊り|黒穂病
peon	労働者|日雇い人
roughshod	(馬が)滑り止めのてい鉄を付けた
speller	スペリングブック|綴り字教本|字を綴る人
albinism	先天性白色症|白子
topoisomerase	トポイソメラーゼ|2本鎖DNA(1本鎖DNAが互いに逆向きに結合し二重らせん化したDNA)を切断し再結合する酵素|抗がん剤や抗生物質のターゲットとして知られる
retrospection	回想|追想;回顧|思い出
miscarry	〈人・人の計画などが〉失敗する|しくじる(fail)|《英》〈手紙などが〉誤って配達される|不着になる|流産する
bibl	biblical|bibliographical
itemize	箇条書きにする|明細に記す
crackpot	狂人
coccyx	尾骨
dizzily	目まいがして;目がくらむほど
biannual	年2回の|半年ごとの|半年毎に
episcopacy	〈U〉《文》監督(主教|司教)の職(任期)|《the~》主教(司教)団
beachside	浜辺の
luv	同じ発音であるloveの俗語
microsurgery	顕微解剖|顕微手術(顕微鏡を見ながら組織や細胞を手術する技術)
archaeal	古細菌の
defoliation	落葉
upregulate	上方制御する
pamphleteer	パンフレットの著者(発行者)
prequel	(文学･映画作品などの)前編|続編
sidereal	星の|恒星の
complainer	不平家|苦情を言う人
irredeemable	救いようのない|買い戻しのできない
protestation	抗議
hypnotherapy	催眠療法
irresolution	不決断|優柔不断
expressionism	表現主義
exceptionality	(いい意味で)例外的なこと|まれなこと
pinstripe	細かい縦縞|ピンストライプ
recondition	を修繕する
repercussion	(好ましくない間接的な)影響|(音の)反響|(銃などの)反動|はね返り
repletion	充満|充実|満腹|食べ(飲み)すぎ
vesture	衣服|着物;おおうもの
unexceptional	例外でない|通例の|例外を認めない|《unexceptionableと混同して》非の打ちどころがない
plasmin	プラスミン|タンパク質分解酵素(プロテアーゼ)の一種|フィブリンやフィブリノーゲンを分解して血栓を分解する
wheresoever	whereverの強調形
trefoil	シロツメグサ属の植物(小葉が3枚の植物;クローバーなど)|(石材などの)三つ葉模様
tatty	《おもに英話》うすぎたない|みすぼらしい|ぼろの
valorous	=valiant
mescaline	メスカリン(メスカルより採取した幻覚作用のある薬)
monophyletic	単一系統の
freeborn	(奴隷(どれい)としてでなく)自由の身に生まれた
consolatory	慰めの|慰問の
victual	飲食物|食料(provisions)|〈多人数〉‘に'食物を供給する|〈船など〉‘に'食糧を積み込む
candida	カンジダ菌|-症|カンジダは酵母(単細胞性菌類)の属名|出芽で増殖|カンジダ･アルビカンス(C|albicans)はカンジダ症を起こす病原体|消化管|膣粘膜に棲み|体調が悪い時日和見感染を起こす
coinfection	同時感染
dolt	まぬけ|とんま
laughingstock	笑い者|笑いぐさ
newfangled	新奇の|新式の|最新流行の
poppet	(かわいがっている)子供(動物);《呼びかけ》かわいい子ちゃん
hussar	(はでな姿の)軽騎兵
rulebook	〈C〉規則書;就業規則書|《the rulebook》(競技などの)規則集
seaworthy	航海に適する
unexpectedness	思いがけないこと|不意|意外
academician	アカデミー会員|学士院会員
crouton	(仏語)クルトン(スープに浮かす揚げパンの小片)
misidentify	を誤認する
gondolier	ゴンドラの船頭
vox	音声|言葉|声
wolverine	グズリ(イタチ科クズリ属の北米産哺乳類)
oviduct	卵管
aptness	(〜の)適性|才能《+『for』+『名』》|(〜する)傾向|性向《+『to』 do》
consonantal	子音の|子音の特徴のある
pax	(ラテン語でpeace平和)|強国の支配による平和|親睦の接吻|Pax Romana(ローマ支配による平和)|(子供の遊びで一時中断の)タイム|(子供のけんかで)仲直り
houseguest	泊まり客
funicular	ケーブルカー|鋼索鉄道|ロープによる|ロープの|索状の|珠柄の|吊り重り作用の
peristyle	(建物･庭などを取り囲む)柱列|柱列に囲まれた空間
safflower	ベニバナ (サフラワー油がとれる)
songbird	歌う鳥|鳴鳥
cw	clockwise
geeky	おかしな
spandex	(合成繊維)スパンデックス
costa	肋(ろっ)骨;肋骨状の部分
stupa	仏舎利塔|卒塔婆
banquette	バンケット|乗客席|棚|壁際の長椅子|歩道
quieten	静かになる《+『down』》|‘を'静かにさせる
untended	世話されていない|世話する者がいない|ほったらかしの
honorarium	(講演者など一定料金のない人に対する)謝礼金
smokescreen	煙幕|(一般に)隠す(ごまかす)ためのもの
weepy	お涙頂戴の|ジクジク染み出させる|涙ぐんだ|涙もろい|涙を流さんばかりの|滲出する
apologia	(行動・動機・特に信念の)正当化|弁解;弁護(弁明)論《+『for』(『of』)+『名』(do『ing』)》
bong	ボーン|鐘の音|ゴーン(と鳴る)
conciseness	簡潔さ
toxicant	毒物
ult	先月の
capitation	人頭税(各人に等しくかける税)
quondam	元の|以前の
thallium	タリウム(金属元素;化学記号はTl)
isoprene	イソプレン(主として合成ゴム製造用の揮発性液体)
dirigible	操縦できる
salle	ホール|広間|室
sublimely	卓越して|抜群に|荘厳に|すばらしく|全く|ひどく
backbreaking	骨の折れる
ejector	射出装置|放出(排出)器
roadster	ロードスター(初期のオープンカー)
catarrh	カタル(特にかぜなどで鼻・のどなどの粘膜に起こる炎症)
dressage	(馬の)調教|調馬
mycoplasma	マイコプラズマ
deadness	死の状態|生気のないこと|(色などの)さえないこと;(酒などの)気の抜けていること
lupine	ハウチワマメ(マメ科植物)|オオカミの(ような)
serried	密集［林立］した(crowded)
womanizer	女たらし|女遊びにふける男
mesmeric	催眠術の
androgenic	アンドロゲンの
doggerel	(内容もふまじめで|韻律もふぞろいな)へぼ詩
reanimate	〜‘を'再び元気づける(勇気づける)|‘に'生気を与え直す
cronyism	縁故主義|(任命などで)知人を引き立てること
rhomboid	偏菱(へんりょう)形|長斜方形|ひし形の|長斜方形の
absentminded	放心した|ぼんやりしている|忘れっぽい
liposuction	(美容整形の)脂肪(吸出し)除去術
temptress	誘惑する女|妖婦
vender	=vendor
nucleolus	核小体
acquaintanceship	=acquaintance 2
yawl	(2本マストの)小型帆船|(オールでこぐ)船載ボート
snakebite	ヘビにかまれた傷
chondrocyte	軟骨細胞
uppercut	アッパーカット|上方に突き上げるような打撃|アッパーカットを食わせる
efflorescence	開花(期)|風解|風化
freehand	(絵などを)(器具の助けを借りずに)手でかいた|手がきで|自由行動(裁量)
paschal	(ユダヤ人の)過越(すぎこし)の祭り(Passover)の|《古》復活祭の
wisteria	フジ|藤
manometer	流体圧力測定器
hotpot	ホットポット(羊肉・じゃがいも・玉ねぎなどを煮こんだ料理)
nonadherence	不遵守の
bullfrog	ウシガエル|食用ガエル
ibidem	同じ箇所に|同書に|同章に|同節に
dissenter	反対者|国教反対者|非国教徒(Nonconformist)
mope	ふさぎ込む|落ち込む|意気消沈する
uppity	図々しい|生意気な
creosote	クレオソート(防腐剤)
perihelion	《通例単数形で》近日点(太陽系の天体が太陽に最も近づく位置)
mastodon	マストドン(第四紀洪積世の象に似た巨獣)
coiffure	ヘアスタイル
homelike	自宅のような|家庭的にくつろいだ気分の|気楽な
vacuolar	(生科学)|空胞|液胞|空胞の
dodo	ドードー(Dodo)は|マダガスカル沖のモーリシャス島に生息していた絶滅鳥類|目撃例が途絶え1681年に絶滅したとされる
mesmerism	催眠術(hypnotism)
curio	骨董品(=antique)
parterre	花壇をあしらった庭園|《おもに米》劇場の平土間
capstan	キャプスタン(テープレコーダー等の巻上げ装置)|碇を巻き上げる装置
disputable	議論の余地がある(questionable)
prithee	願わくは　何とぞ(please)
carload	(〜の)貨車1両分の貨物《+『of』+『名』》
pantograph	写図器(一端を固定して伸縮できるパンタグラフ状の器具;比率を変えて写図できる)|(電車の)パンタグラフ
hotshot	やり手|腕利き|うまい選手|急行貨車|有能な(ぶる)人|(スポーツの)名人
mailing	郵送
outbuilding	離れ(家)
outrigger	アウトリガー|舷外材|アウトリガー付きボート|クラッチ受け
heterodoxy	〈U〉(宗教上の)異端|〈C〉異端の教義|異説
coulomb	クーロン(1アンペアの電流が1秒間に送る電気量)
mandrake	マンドレーク|マンダラゲ(ナス科の植物で|麻酔性があり有毒;昔は魔力があると信じられていた)
cellist	チェロ奏者
poisoning	中毒|毒殺
unregenerate	悔い改めない|更生しない|強情な|がんこな
mitochondrion	ミトコンドリア|(複数形)mitochondria
foxglove	ジギタリス(釣り鐘状の紅紫色または白色の花をつける;葉は強心剤に用いる)
loll	ゆったり横になる|たれる
eclogue	田園詩|牧歌(対話形式の短詩)
retrievable	取り戻せる|回復できる;償い得る
windbreak	防風林|(塀などの)風よけ
forefather	祖先(ancestor)
crawfish	伊勢エビ|ザリガニ|ザリガニの身|けち|尻込みする人|取り消す
drumstick	太鼓(ドラム)のばち|《話》(料理した)鶏(七面鳥など)の足
arrant	(悪い意味で)評判の|この上ない
dacha	(ロシアの)いなかの邸宅(別荘)
maceration	水に浸して柔らかくすること|ふやけさせること
pathless	道のない|だれも足を踏み入れたことのない
peccary	ペッカリー(米大陸産;イノシシに似た動物)
dandruff	(頭の)ふけ
kola	コーラ|ヒメコーラの木|アフリカ原産のアオギリ科の常緑高木|種子(kola nut)を採るために熱帯で栽培される|=cola
lackadaisical	気力のない|意欲のない|怠惰な
earful	小言|説教
mortify	くやしがらせる|恥をかかせる|抑制する|(肉欲･感情などを)抑える
amputee	(肢)切断患者|切断手術を受けた人
subvention	(政府などからの)補助金|助成金
strep	連鎖球菌(の)|streptococcus
laryngitis	喉頭(こうとう)炎
wittily	頓知をきかせて
catchword	欄外見出し語|スローガン
coxcomb	しゃれ者|だて男|=cockscomb2
slobber	だらしなくやる
copywriter	広告案内作者
bushman	森林地居住者|《Bushman》ブッシュマン(南アフリカの現住民で背の低い狩猟民族)
uremia	尿毒症
streamlet	細流|小川
exegete	(特に)聖書解釈学者
summerhouse	あずま屋
stepladder	(持ち運びのできる)段ばしご|脚立(きゃたつ)
gulag	強制収容所
sequoia	セコイア(California州の巨木)
erogenous	(体のある部分が)性感を刺激する
groundswell	(世論などの)盛り上がり
sexiness	セクシーなこと|性的魅力のあること
breezily	そよ風が吹いて|さわやかに
barony	男爵の位|男爵領
fem	female|feminine
hepatobiliary	肝胆汁性の
multiform	多くの形態を持っている;多様な
missal	《しばしばM-》(ローマカトリック教会の)ミサ典書;(一般に)祈祷書
chlorite	緑泥石
farrier	蹄鉄(ていてつ)工|鍛冶屋(blacksmith)
unutterably	言語に絶するほどに|非常に
bacteriology	細菌学
derailment	脱線
pentameter	(詩の行の)五歩格|五歩格の詩|五歩格の
ethicist	倫理学者
wrinkly	皺(しわ)になりやすい|皺の寄った
flyover	(道路・鉄道の)高架式交差道|インターチェンジ|《米》=flyby
optometrist	検眼医|視力測定者
burgomaster	(オランダ・フランドル地方・ドイツ・オーストリアの)市長
stodgy	つまらない|重苦しい|不消化の
noontide	=noon 1
phantasmagoria	(夢や想像上の)めまぐるしく移り変わる光景|走馬灯のように去来する幻影
standoffish	冷淡な|よそよそしい(aloof)
thwack	ピシャリと打つこと|バシッと叩くこと|試み|分け前|をピシャリと打つ
electrocution	感電死
unsociable	打ち解けない|人づき合いの悪い
unfix	〜‘を'はずす|緩める|〈心・気持ち〉‘を'ぐらつかせる
hilariously	陽気に
batik	ろうけつ染め
glitzy	けばけばしい|派手な
palpitation	動悸
burg	(独語他に由来)|市|町|(地名接尾辞の一種|単語のあとにつけ場所を表す)
flounce	飛び出す|飛び込む
electromotive	電動の|起電の
teatime	(午後の)お茶の時間
polychrome	多色の
beefsteak	(ステーキ・フライ用)牛肉の切り身;(それを焼いた)ビフテキ
tropism	向性|屈性(植物が一定の刺激の方へ|または反対方向に成長する性質)
washboard	波よけ板|洗濯板|幅木
erysipelas	丹毒(たんどく)(連鎖球菌により生じる急性伝染病)
electroporation	電気穿孔法|電気パルスで細胞膜に微小な穴を空け|DNAを細胞内部に送り込むなどに利用
townsman	都会人|町内の人
puppetry	操り人形を作る(動かす)技術
malodorous	悪臭のひどい|(社会的に)受け入れがたい
obsequy	葬式|埋葬式
watercraft	船
sylph	空気の精|ほっそりした美しい女
picaresque	悪漢を題材とした
breakable	破れ(壊れ)やすい|もろい|壊れやすいもの|割れもの
acetyltransferase	アセチルトランスフェラーゼ|一つの化合物のアセチル基を他の化合物へ転移する反応を触媒する酵素|アセチル基転移酵素ともいう
vintner	ブドウ酒醸造業者|ブドウ酒商人
dustpan	ちりとり
enuresis	遺尿(いにょう)症|尿失禁|寝小便
shelve	(問題など)を棚上げする|延期する|を棚にのせる|を解雇する
avocation	副業|趣味|職業
stria	(平行に並んでいる)細い溝(筋)|条線(氷河運動により岩の表面についたかき傷;鉱物の結晶面に走る平行線)|(円柱についている)縦溝
nightshade	ナス科の植物
showmanship	演出上手|興行的手腕|聴衆を引き付ける手腕
earmark	取っておく|目印をつける|指定する|(資金を)割り当てる
greediness	どん欲|がつがつしていること
hypersonic	(音速の5倍に及ぶ)極超音速の
impecunious	無一文の(penniless)|貧乏な
midrib	(葉の)中肋(ろく)|中脈
maidenly	処女の|処女らしい;つつましやかな|しとやかな
provincialism	地方気質|地方色|偏狭|田舎根性|いなか風|田舎くささ|訛り|方言
ingrate	恩知らず|忘恩の徒
cowslip	キバナノクリンザクラ|リュウキンカ
dioxygenase	ジオキシゲナーゼ|二原子酸素添加酵素
salver	食物・飲料・名刺などを載せて出す昔の金属製の盆
baseboard	(壁の最下部の)幅|裾|(一般に)土台となる板(プレートなど)
rising	のぼりつつある|立ち上る|騰貴する|昇進する
trompe	だまし絵
hitchhiker	ヒッチハイクする人
curlew	ダイシャクシギ(くちばしが細長く下に曲がっている鳥)
covariation	共変動|相関性のある変化(correlated variation)
fluster	騒がす|あたふた|あわてる様子
pertinacity	根気強さ|粘り強さ|執よう|頑固
workfare	勤労福祉制度
ambulate	歩き(動き)まわる
malefactor	悪人|犯人
rhombus	ひし形|斜方六面体
unalienable	=inalienable
untrodden	踏まれていない|前人未踏の
parvenu	成り金|成り上がり者
facing	上塗り|向く
syphilitic	梅毒(性)の|梅毒患者
flashcard	フラッシュカード(生徒の反応速度を増すために語学・算数などの授業に用いる単語・数字・絵などのカード)
moodiness	むら気な|むっつりした|不機嫌な|ふさぎ込んだ
hatchback	ハッチバック
landsman	陸上生活者;陸上勤務者
pylorus	(胃の)幽門
peroration	(講演などの)結論|熱のこもった演説
surtout	(フロックコート型の)男子用外とう;婦人用フード付きマント　シュルトウ　部分的に他の紋章と重なる
fosse	堀|溝|運河
factious	派閥的な|党派心の強い
marque	プレート|モデル|型|車名|標識
succubus	サッキュバス|サクバス|夢魔(むま)淫魔|キリスト教の悪魔|夢の中に現れ性交を行う|女性型Succubus(は男性を誘惑し精を奪う
syndicalist	サンディカリズム主義者|サンディカリズム主義の
voyager	ボイジャー
largo	ラルゴ|きわめておそい(おそく)
repossession	所有権を取り戻すこと|再所有
technetium	テクネチウム(マンガン属の元素;化学記号は Tc)
flagellation	鞭打ち|鞭毛運動
questioning	探求的な|詮索好きの|尋問|取り調べ|不審尋問|疑わしげな
solipsistic	唯我論主義者の|自己中心[主義]的な
viticulture	ぶどう栽培
scrabble	ひっかき回す|手さぐりする
gyration	旋回|回転
somnolent	眠い
latecomer	遅参者
catnip	イヌハッカ(植物)
intergalactic	銀河系(宇宙)間の
deadbeat	なまけ者|のらくら者(=loafer)|借金を踏み倒す人
numerology	(誕生日の数字などによる)数占い;数秘学
nonintervention	(他国の政策・他人の私事に対する)不干渉|不介入《+『in』+『名』》
underwood	下草(したくさ) 2|アンダーウッド|人名
kraft	クラフト紙
obligee	債権者|権利者|恩を受けた人
adulteress	姦通した女(人妻)|姦婦(かんぷ)
irresponsibly	無責任に
shim	詰め物|かい物(物を水平にしたり|すき間に入れるくさび形の木片など)
matador	(スペイン語)マタドール|闘牛士
junto	(持に政治的目的を持つ)徒党|秘密結社
afro	アフロヘア(和製英語)
schadenfreude	シャーデンフロイデ(独|Schadenfreude)|他者の不幸|失敗を見た時の快感|ドイツ語で「恥知らずの喜び」|「様を見ろ」や「隣(他人)の不幸は蜜の味」の意
starless	星(星明かり)のない
cloudiness	曇り|曇天;(気象用語で)雲量|もうろう;陰うつ
disport	〈自分自身〉‘を'楽しませる
bearskin	熊の毛皮|熊皮製品(服)|黒い毛皮帽(英国近衛兵がかぶる)|粗いラシャ地
catchall	種々雑多なもの(がらくた)をなんでも含む(収める)もの|広範囲の
demote	の地位を下げる|(n|demotion)
resolvable	解決できる
angiosperm	被子植物|顕花植物|(種子植物のうち|胚珠が子房に包まれ受精後結実するもの|反:gymnosperm)
sojourner	逗留者|滞在者|旅人|ソジャーナー
dazedly	目がくらんで|ぼうっとして
quintet	五重奏
ergot	麦角(ばっかく)病(麦角菌によるライ麦など穀物の病気)|麦角(止血剤・子宮収縮剤用)
hatless	帽子をかぶっていない
asphyxiate	〜'を'窒息[死]させる|窒息[死]する
westbound	西へ向かう
greengrocer	青物商人|やお屋
helpmate	協力者|仲間;連れ合い(夫または妻)
hydraulically	水(油)力で|水(油)圧で
zen	禅
compote	〈C〉(果物・菓子を盛る)足付き皿|〈U〉砂糖づけ(砂糖煮)のくだもの
hauler	運送業者
precocity	早熟
dysgenesis	発育不全
concubinage	同棲|内縁関係
discourteous	失礼な|ぶしつけな(impolite)
backache	背の痛み
greenwood	緑林
haunch	臀部(でんぶ)|(動物の)腰肉
clerestory	採光窓、高窓層(教会堂などで採光用の高窓が並んだ側壁)|《米》高窓;(電車の天井両側にある)通風窓
rennet	レンネット(チーズなどを作るときの牛乳の凝固剤)
faro	銀行|賭けトランプの一種
supersaturate	〈溶液〉‘を'過飽和させる
sightseer	観光客
chamfer	〈板〉‘の'かどをそぐ;〈板〉‘に'みぞをつける|(板・角材の)そがれたかど;板につけたみぞ
farsighted	先見の明のある|遠視の
frig	冷蔵庫|ダラダラと時を過ごす|急いで去る|出て行く|せんずりをかく|オナニーをする
siding	下見張り(外壁に貼る板)
brainy	頭のいい
stateliness	荘重|威厳
yucca	イトラン(植物)
centrosome	中心体
redevelop	再開発する|再現像する|最発展する
decennial	10年間(ごと)の
gizmo	仕掛け;妙案|工夫
oligomer	モノマー(単量体)が少数結合した重合体がオリゴマー(oligomer)|ダイマー(dimer|二量体)|トライマー(trimer|三量体)|テトラマー(tetramer|四量体)等|多数の重合体はポリマー(polymer)
pleasingly	楽しく
stardust	星屑
popup	(野球の)ポップフライ
camshaft	カム軸(カムを支え回転させる軸)
quaff	〜‘を'がぶがぶ飲む|痛飲する|がぶ飲みする|痛飲する|がぶ飲み|痛飲
agglutinin	凝集素(赤血球などの凝集反応を起こす抗体)
songbook	歌集|賛美歌集
glam	(=glamour)魅力的な|グラマーな
seacoast	沿岸|海岸
winepress	(ワインを作るための)ぶどうしぼり器(おけ)
tryout	適性試験|テスト|オーディション
prentice	洗練されない|年季奉公人の|未熟な
politick	政治運動(活動)をする
plenteous	= plentiful・『豊富な』|たっぷりの|たくさんの;豊富に生じる
clave	cleaveの過去形
capon	去勢した食肉用おんどり
pergola	パーゴラ(つる草などをまといつかせたあずま屋・たな)
trencher	みぞ(ざんごう)を掘る人|(特に昔|肉|パンなどを供したり切り分けたりした)木皿
sixfold	6倍の|6重の|6倍に|6重に
defeatist	敗北主義者
dogmatics	(特にキリスト教の)教義学|教理学
transposable	転位可能な
warpath	(アメリカインディアンの)征途|出陣の道
holdall	(旅行用の)大型スーツケース
immure	〜‘を'監禁する閉じ込める
falconer	タカ匠
crick	筋を違える|寝違える(crick one's neck|twist one's neck|)
fescue	ウシノケグサ(牧草・芝用の植物)
stylistics	文体論
naivete	素朴|単純
taxidermy	剥製(はくせい)術
decaf	カフェイン抜きのコーヒー
finicky	(=finical)|凝り性の|細部まで綿密な|ex|a finicky eater 食べ物にうるさい人
repairman	修理工
vacationer	休日の行楽客
decrepitude	老衰
telephonic	電話の|電話による
unfaltering	とまらない|とどまることを知らない|ちゅうちょしない
artifactual	人為的な
boozy	酔っぱらって|大酒を飲む|大酒飲みの
knackered	くたびれ果てた
bewitch	に魔法をかける
espousal	(支持|主義･説などの)支持|擁護|結婚|婚約
milkweed	乳液を出す植物
pleurisy	ろく膜炎
pinwheel	かざぐるま(=windmill主にUK英)|回転花火
transposon	トランスポゾン(Transposon)|細胞内においてゲノム上の位置を転移(transposition)できる塩基配列|動く遺伝子|転移因子(Transposable element)と呼ばれる
anemometer	風力計|風速計
chaotically	混とんとして|無秩序に
cherubic	＜cherub|ケラブ(智天使|9天使中の第 2 位で|知識を司る翼のある愛らしい天使)の|無邪気な
improvident	(経済的に)将来への備えを怠る
hotness	暑さ
extirpate	〈悪習・集団など〉‘を'根絶する|撲滅する|〈植物〉‘を'根こそぎにする
enthronement	即位式
unfrequented	人がほとんど(全然)いない|人通りの少ない|人けのとだえた
devoir	〈U〉本分|つとめ|《複数形で》敬意の表現|あいさつ
woulda	would haveの短縮形
chandler	雑貨商人
collier	(炭鉱の)坑夫|石炭船
cookware	料理用具:pots,pans,bowls (utensilはknife,fork)
ambitiously	野心的に
lovey	(呼びかけに用いて)おい|ちょっと|おまえ|= lovey-dovey
gremlin	グレムリン(第二次大戦中|飛行機のエンジンに故障を起こさせると言われた小悪魔)
tailspin	きりもみ降下(落下)|(経済的)混乱|狼狽|動揺
forager	食糧徴発隊
hearthstone	〈C〉炉石|〈U〉炉辺|家庭
mammon	(悪の根源としての)富|財宝|《M-》(富・強欲の擬人的偶像としての)マモン神
divorcee	離婚者
backpacker	バックパッカー|気ままに放浪し世界を回る旅人
unselected	選択されていない
incautious	不注意な|軽率な;無謀な
disquietude	不安|不穏
jackhammer	(圧搾空気で動かす)手持ち削岩機
creamery	酪農品製造所|酪農品販売店
backwash	逆流(船の航跡などによってできる)|後流(プロペラの回転によって起こる)|(事件などの)余波
kibble	〈穀物など〉‘を'あらびきする
bonhomie	(仏語)気さく|人のよさ|温容|温厚|快活
cinco	スペイン語で5の意
eucharist	聖餐(式)|聖餐用のパンとブドウ酒
autarky	〈U〉(国家の)経済的自給自足|〈C〉(また『autarchy』)経済的自給自足国家
aftershock	余震
myelitis	脊(骨)髄炎
bola	2個以上の鉄玉付きの投げなわ;(おもに南米南部で|獣の脚に投げつけ|からませて捕える道具)
marzipan	マジパン(すりつぶしたアーモンドで作る菓子)|マーチパン
cleanness	清潔|潔白;清浄
centime	サンチーム(フランスの貨幣;1|100フラン)
soporific	眠くさせる|催眠の|催眠剤|麻酔剤
bougainvillea	ブーゲンビリア|熱帯性の低木で美しい密集した花をつける
corsage	コサージュ(婦人が肩・腰・手首などに飾る花)
indicia	(料金別納郵便物などの)証印
unceremonious	不作法な|ぶしつけな|儀式(形式)ばらない
orbiter	オービター|巡回するもの|人工衛星
merchantman	商船
misprint	誤植|ミスプリント
catholicity	〈U〉(趣味・見解・関心などの)広いこと|包容性;普遍性|《C-》=Catholicism
oilcloth	油布
epigrammatic	警句(風刺詩)の|警句ふうの|風刺的な;(人が)警句好きの
muesli	ミューズリー(穀物・豆・乾燥果物など;朝食でミルクとまぜて食べる)
parricide	〈C〉近親者(特に父親)殺しの犯人|尊属殺人者|〈U〉尊属殺人
unexceptionable	非の打ちどころがない|申し分のない
ween	(wíːn)|(I weenで挿入句的に)だと思う|と想像する|期待(予期)する
turbaned	ターバンを巻いた
ovulate	(生物学)排卵する|卵を産出し|放出する
underpass	地下道
coms	《話》=combination4
enigmatical	=enigmatic
ministration	援助|介抱|看護|世話|聖職者の職務|奉仕
arteriole	小動脈
bodiless	体のない;無形の|実体のない
rangy	歩き回る
caboose	乗務員車(貨物列車の最後尾につき調理・宿泊設備がある;《英》guard's van)
circumpolar	北極(南極)周辺の|(星が)天極の回りを円を描いて回る
extravascular	血管外の
hypermethylation	高メチル化
draughty	=drafty
weighting	特別調整手当
extempore	準備なしの|即席の|準備なしで|即興に
humidifier	湿らせる
photojournalist	フォトジャーナリスト|写真報道家
dotage	もうろく|老いぼれ
thingy	あれ|何とかいうもの|名前を忘れたときの代名詞|物の|物質の|物体の
tress	(女性の)髪のひと房|巻き毛|編んだ髪
excursus	(本の巻末につけた)詳説|補説
sympatric	同所性の|(種分化について同様か重なった地理的地域において起きる)
unhallowed	聖別(祝別)されない|あがめられない|《文》悪に染まった|邪悪な
docent	(大学の)講師
yokel	田舎者|いなかっぺ
madcap	向こう見ずな|無鉄砲な|向こう見ずな人;無鉄砲な娘
seagoing	(またocean-going)遠洋航海用の|=seafaring
shiner	宝石
spat	ささいなけんか|いさかいをする|spit(つばや悪口を吐く)の過去分詞
overhand	(野球・クリケットの)オーバーハンドの|上手からの(手を肩より上にあげて行う);(水泳の)抜き手の|(テニスで)オーバーハンドの(腰より上のボールを打つ)|(クリケット・テニス・野球などで)上手で|オーバーハンドで;(水泳で)抜き手で
grouper	共同出資で別荘などを借りる若者
emasculation	去勢|骨抜き|無力化
schoolmistress	女教師|女校長
dogfight	空中戦|乱闘
excoriation	擦りむくこと|擦過傷|激しい非難|痛罵
pock	あばた
ambidexterity	両手効きの
impressiveness	印象的であること|感銘深さ
seductress	(男を)誘惑する女|男たらし
hothead	性急な人|短気な人|短気者|血の気の多い人
huckleberry	ハックルベリー|コケモモという低木の青黒い実
divot	(ゴルフクラブでそぎ取られた)芝生の小さな塊
arabesque	アラベスク|モスクの壁面のイスラム美術の一様式|幾何学文様を反復し|人物の描写を禁じるスンニ派の世界観に基づく|(シーア派はムハンマド以外は認められている)
hypochondriac	心気症の(人)|憂鬱症の|健康なのに病気だと思って悩む
palmetto	キャベツヤシ
conurbation	都市集団|(特に)大都市圏
interdepartmental	各部(局・省)間の|(大学などの)学部間の
respecter	《軽べつして》権力にへつらう人|えこひいきする人
dressmaking	婦人服仕立[業]|洋裁
shaver	そる人;そり道具|削り道具;電気かみそり|《話》若者|小僧
diphthong	(文法)2重母音|複母音
sarin	サリン(毒ガスの一種|地下鉄サリン事件で使われた)
sept	7の意味(Septemberは9月に転じた)
housemate	同居人
inspectorate	《集合的に》視察検閲官|検査官(inspector)|視察官(検査官)の職(管轄区域|任期)
clothier	服屋|紳士服店|服地屋|織物仕上げ工
uncap	〜‘の'帽子をとる;〜‘の'ふた(おおい)を取る
changeful	変化に富む|変わりやすい
coexistent	共存の
enterocolitica	Yersinia enterocolitica|(食中毒原因菌)エンテロコリチカ菌|(エルシニア･エンテロコリチカ)
liveable	=livable
demagoguery	民衆扇動
uneconomic	むだづかいをする|浪費の|不経済な
amanuensis	筆記者|筆耕|写字生
retrench	(費用などを)削減する|削除する|省く
thermosetting	熱硬化性の
stickleback	トゲウオ(ひれにとげのある魚)
indigence	貧困|窮乏
glamor	うっとりさせる魅力|魅惑|(glamourの綴りが圧倒的)
varlet	ならず者|悪漢
squib	爆竹|導火爆管|小花火|(政治家攻撃)機智に富んだ文|風刺
authoress	女流作家
foolscap	〈U〉(洋紙の)フールスキャップ判|大判|=fool's cap|道化師帽(昔道化師が用いたもので|普通|とさか・ロバの耳などの形の垂れ部が数個つき|その先端に鈴がついていた)
misapplication	誤用|乱用
overcapacity	設備過剰|生産能力過剰
roseate	バラ色の(rosy);楽観的な
disconcertingly	面くらわせるほど|まごつかせるように
tonsillectomy	扁桃腺摘除術
clastic	(地質が)砕屑(さいせつ)性の
superannuate	〈人〉‘を'老齢(病弱)のため退職させる
mothball	防虫剤|をしまい込む
arteriosclerosis	動脈硬化症
counteroffensive	反攻|反撃
unnoticeable	人目をひかない|重要でない
wold	高原|丘陵
kickback	ぴんはね|リベート|賄賂|激しい反応|反動
inanity	ばかなこと|愚鈍|空|空虚|考えのない行為|無意味な言葉
jogger	ジョギングする人
tobacconist	たばこ業者|たばこ屋の主人(店員)
drupe	核果|石果(さくらんぼ・梅・桃など)
passerine	スズメの目の|燕雀(えんじゃく)目に属する|スズメ目の鳥(ヒバリなどを含む)
asinine	(ˈæsənὰɪn)|(ラテン語|ロバに由来)|愚かな|がんこな|ロバの(ような)
hookah	水ぎせる(たばこの煙を水の中を通して吸う)
stingray	アカエイ
ambidextrous	両手利きの|非常に器用な|多芸多才な|二枚舌の|ずるい
backrest	背もたせ
bloodstain	血痕(こん)
intracellularly	細胞内に
copyedit	〈原稿〉'を'校正する
hyperpolarization	過分極
regimentation	連隊編成|規格化
suchlike	このような
pastorate	牧師の職(任期)|《集合的に》牧師団
histochemical	組織化学的な
lucre	利益|もうけ|金銭
niceness	きちょうめんさ
chromic	クロムの|クロム(特に3価のクロム)を含む
emcee	司会者|司会する
obiter	傍論|付随的意見　
rearward	後方の|後方へ(に)
taiga	タイガ(亜北極地の常緑針葉樹林)
wombat	ウォンバット|カンガルー目ウォンバット科の哺乳類|アボリジニ(オーストラリアの原住民)の言葉で「平たい鼻」の意
orangutan	オランウータン
dolorous	悲しみを誘う|悲しそうな|悲しい|痛ましい
overleaf	裏ページに
mahout	(インドの)象使い
straggly	落伍した
bullfight	闘牛
ephedrine	(医)エフェドリン|ぜんそく･かぜなどの薬
dosimeter	線量計(放射線の量を測定する装置)|薬量計
suasion	勧告|説得
catastrophically	悲劇的に|破滅的に
coxswain	(競漕用ボートの)舵(だ)手|かじ取り|艇長
amir	(アラビアの)首長|王族|預言者ムハンマド(Muhammad)の子孫の尊称|emir
aureole	(聖者・殉教者などの絵に見られる)光の輪|輪光|後光|(太陽・月にかかる)かさ
midlevel	中間レベル
pauperism	(救済の必要な)貧窮状態|赤貧
pyrexia	発熱;熱病
rancorous	深く憎んでいる|深い恨みのある
chapbook	呼び売り本(昔|行商人が売った通俗読み物の小冊子)
butterscotch	バターボール(バター入りキャンデー)
ceramide	セラミド|細胞膜にある細胞シグナル伝達物質|分化|増殖|アポトーシス(細胞死)を制御し「細胞死のメッセンジャー」と呼ばれる|その合成障害でアトピー性皮膚炎などを生じる
cortege	《集合的に》従者の列|行列|(特に)葬列
fourscore	80の(eighty)
sharpshooter	狙撃兵|一級射手|法律の抜け穴をねらう弁護士
neomycin	ネオマイシン
samizdat	(特に旧ソ連における発禁書などの)地下出版[物]
sloppily	だらしなく;いいかげんに
descry	〈遠くのもの・はっきりしないもの〉‘を'目を凝らして認める(進行形にできない)
antipoverty	貧困救済(絶滅)を目指す
bung	栓|栓をする|うそ|一撃|醸造者|パブの主人|盲腸|肛門
gunk	べたべた(ぬるぬる)した不潔なもの|汚物(《英》gunge)
siderophore	シデロフォア|微生物が作る|鉄を含むか鉄と結合した有機化合物|鉄イオン(Fe3+)と親和性があり|鉄の可溶化や輸送に働く|腸内細菌|土壌細菌|真菌|藻類に広く分布
sureness	確実;確信;安全
uvula	喉ひこ|(俗称|のどちんこ)
dressy	正装向きの
kanamycin	カナマイシン|1957年に梅澤濱夫により日本で最初に発見された抗生物質|細菌性のリボソームと反応し|毒性を発揮する|この毒性は真菌類には発揮されない
taffy	タフィー(砂糖・バターなどを煮て固めたキャラメルの一種)
geminate	〜‘を'二重にする|対(つい)にする|二重になる|対になる
valuer	評価をする人|鑑定人;《英》価格査定官
helipad	(商業施設のない)ヘリコプター発着場
hierarchic	=hierarchical
pomposity	もったいぶり|華やかさ|華麗さ|尊大|尊大な言動|尊大ぶる人
tartaric	酒石の
geophysics	地球物理学
lotta	lot of(口語)
caecum	=cecum
perspicuous	(言葉・議論などが)理解しやすい|明快な
pigsty	豚小屋|きたない所
notochord	脊索
piebald	(特に馬などが)白黒まだらの|(特に)白黒まだらの馬
prepuce	(陰茎の)包皮
sandpiper	イソシギ(細長いくちばしと脚をした海岸の鳥)
redeploy	移動する|移動させる|再配置する