funerary	葬式の
clew	(また『clue』)(森や迷路から抜け出すためたぐる)糸玉|(難問解決の)糸口|(また『clue』)帆耳(帆の最下端)
spironolactone	スピロノラクトン
beamish	にこやか|莞爾たる
trefoil	シロツメグサ属の植物(小葉が3枚の植物;クローバーなど)|(石材などの)三つ葉模様
riptide	潮衝(他の潮流と衝突して激潮を起こす潮流)
theologically	as regards theology; "the candidate was found theologically sound"|as regards theology|in a theological manner; "he dealt with the problem of evil theologically, not philosophically"|in a theological manner
rorschach	ロールシャッハテスト|ロールシャッハ
blab	べらべらしゃべる
trapezoidal	resembling a trapezoid
steller	シュテラー
nominator	指名(任命)する人
delude	欺く|惑わす|裏切る|失望させる|回避する|はぐらかす
buna	made by polymerizing butadiene
bleeder	多量に出血しやすい人.(特に)血友病患者|出血素因者
firing	発射する
methylmercury	メチル水銀
pinon	any of several low-growing pines of western North America
snotty	鼻水でよごれた
remiss	ぞんざいな
anchoress	女性隠者
entrails	(通常pl形)|(動物の)はらわた|後部出口|中身|内臓|内部
subsonic	亜音速の|音速以下の
handbell	ハンドベル
strabismus	斜視|やぶにらみ
periplasmic	ペリプラズム|周辺質の
atheistic	不信心
plagiarize	盗用する|剽窃する|盗作する|人の文章などを盗む
unforgivable	許せない
topsail	(船の)中檣帆|トップスル
igniter	ライト|電灯|火切り|ライタ|とぼし|ともし火|火鑽り|点火装置|ライター|点火器
pipit	タヒバリ(数種の小さな鳴き鳥の総称)
ordering	発注
modicum	少量
midseason	中間期(スポーツなどの|=mid season) cf|high season|low season
tiamat	ティアマト
naltrexone	ナルトレキソン
affectation	見せかけ|ふりをすること|気取り|てらい|きざ
birder	a person who identifies and studies birds in their natural habitats
vocally	in a vocal manner; "she defended herself vocally"|in a vocal manner
retrial	再審
flotsam	難破船の漂流物|がらくた
correlative	相関関係のある
diametrically	まさに|全然|直径に沿って
ministration	援助|介抱|看護|世話|聖職者の職務|奉仕
keflex	セファレキシン
freakish	気まぐれな
equidistant	等距離で|等距離の(所にある)
hypoglycemic	血糖降下
dicker	小取引をする|掛け合う|値段の交渉をする|小取引
homoeopathy	a method of treating disease with small amounts of remedies that, in large amounts in healthy people, produce symptoms similar to those being treated
raindrop	雨粒
antacid	酸を中和するもの|制酸剤|中和する
chide	たしなめる|(子どもなど)を叱る|小言を言う
negligently	in a negligent manner; "he did his work negligently"|in a negligent manner
peppy	加速が速い|活発な|元気いっぱいの|高速運転ができる|酒に酔って|張り切った
amperage	(電気の)アンペア数|電流量({略}amp.)
studentship	the position of student
leyte	レイテ沖海戦
unmoved	動じない|不動の|ゆるがない|断固とした|冷静な
endodontics	歯内療法学
firebrand	たいまつ|燃え木|扇動者|(激情を)あおる者|火つけ役
pyrotechnic	花火の|華々しい
kazoo	カズー笛(薄い膜の振動で音が出るおもちゃの笛)
glum	むっつりした|ふさぎ込んだ|浮かぬ顔の|陰気な
roomie	ルームメイト
hemostasis	止血
areola	small space in a tissue or body part such as the area between veins on a leaf or an insect's wing|small circular area such as that around the human nipple or an inflamed area around a pimple or insect bite
consecrate	神聖にする|捧げる|清める
loess	(中国・北米などに見られる)黄土(おうど)
potlatch	ポトラッチ|インディアン社会に広くみられる威信をかけた贈答慣行
meristem	分裂組織
humic	of or relating to or derived from humus; "humic acid"|of or relating to or derived from humus
sulky	陰鬱な|すねた
giantess	大女|女巨人
oximeter	a measuring instrument that measures the oxygen in arterial blood
skyward	空に向かって
woeful	悲惨な|情けない|みじめな
femtosecond	フェムト秒
hunker	(hˈʌŋkɚ)うずくまる|しゃがむ|ブラブラ歩く|重々しく動く|前かがみになる|背を曲げる
malfeasance	違法行為
polluter	汚染者
egger	moth having nonfunctional mouthparts as adults; larvae feed on tree foliage and spin egg-shaped cocoons|moth having nonfunctional mouthparts as adults|larvae feed on tree foliage and spin egg-shaped cocoons
sylva	シルワ川
speedwell	オオイヌノフグリ|クワガタソウ
headscarf	a kerchief worn over the head and tied under the chin
voyageur	木こり|運び屋|船頭
defilement	汚すこと|穢れ
decapitation	(特に|処刑として)(人の)首を切る
divalent	二価|二価の
unacknowledged	not recognized or admitted|not openly acknowledged; "an unacknowledged emergency"|not openly acknowledged
revisionism	修正主義
harmonise	調和|嵌る|似あう|填る|合う|填まる|適する|嵌まる|和する|一致|ハモる|ハモる|ハモる
carven	彫られた|彫ってつくられた|彫刻した
maniacal	熱狂的な|狂気のような|狂人の|狂気の
alimentary	栄養の;消化の
cesspool	=cesspit
tuberculin	ツベルクリン注射液(結核感染の有無を調べるための注射液)
demodulator	復調器|デテクター|ディテクタ|ディテクター|探知機
declarer	宣言者|申告者
maintainable	維持できる|扶養できる|主張できる
ineffable	言いようのない|言いようのないほど大きい|言語に絶した
hearer	聞き手|傍聴者
brainiac	穎才|俊傑|秀才|俊邁|ジーニアス|俊豪|鬼才|俊英|英才|儁才
cuppa	1杯のお茶
abridge	要約する|短縮する|縮小する|削減する|弱める|要約
sadomasochism	加虐被虐性変態性欲
deadbolt	デッドボルト|猿|関の木|閂|桟|貫の木|貫木
tonality	(音楽で)調性;(美術で)色調
probity	清廉|誠実|実直
unflinching	ひるまない|しりごみしない;断固たる
gentrification	the restoration of run-down urban areas by the middle class (resulting in the displacement of low-income residents)
triumphal	勝利の|戦勝の|祝勝の
wildebeest	ヌー
affable	愛想のよい|ものやわらかな|優しい
diol	ジオール|グリコール
extensor	伸筋
resurgent	よみがえる|蘇生する|復活する|生き返った人
determinative	限定詞|決定因子|要因|決定要因|最終的な|決定的な
serger	a sewing machine that overcasts the raw edges of a fabric with a V-shaped stitch
pimpernel	ルリハコベ(小さな赤や白の花で曇ると花を閉じる)
helpfully	親切
pericardial	located around the heart or relating to or affecting the pericardium; "pericardial space"|located around the heart or relating to or affecting the pericardium
thrombolytic	血栓溶解剤
sarcophagus	彫刻などを施した大理石製の古代の)石棺
contracture	an abnormal and usually permanent contraction of a muscle
gingival	歯肉の
countermeasure	対策
bisexuality	両性愛|両性具有
eland	エランド
eln	a Marxist terrorist group formed in 1963 by Colombian intellectuals who were inspired by the Cuban Revolution; responsible for a campaign of mass kidnappings and resistance to the government's efforts to stop the drug trade; "ELN kidnappers target foreign employees of large corporations"|a Marxist terrorist group formed in 1963 by Colombian intellectuals who were inspired by the Cuban Revolution|responsible for a campaign of mass kidnappings and resistance to the government's efforts to stop the drug trade|a terrorist organization in Bolivia that acts as an umbrella for numerous small indigenous subversive groups; a revival of a group with Marxist-Leninist ideologies originally established by Che Guevara in the 1960s|a terrorist organization in Bolivia that acts as an umbrella for numerous small indigenous subversive groups|a revival of a group with Marxist-Leninist ideologies originally established by Che Guevara in the 1960s
ardor	熱情|灼熱|熱意|意気込み
cryostat	低温保持装置
didion	ディディオン
tinny	スズの(ような)|ブリキのような音のする|かん臭い|安っぽい
serovar	血液型亜型
manikin	マネキン|ホムンクルス|マヌカン|マネキン|ファッションモデル|雛型|モデル|マネキン人形|マヌカン|マネキン
annoyingly	うるさく
satisfiable	充足可能な
acquit	無罪にする|放免する|解放する
windswept	吹きさらしの|風にさらされた|風に吹かれて乱れた
talus	(くるぶしの)距骨;くるぶし|足首
republicanism	共和制|共和主義|《『R-』》(米国の)共和主義[政策]
disputation	論争|議論|討論
colourless	lacking in variety and interest; "a colorless and unimaginative person"; "a colorless description of the parade"|lacking in variety and interest|weak in color; not colorful|weak in color|not colorful
paediatrician	=pediatrician
unyielding	弾力に欠けた|がんこな 
flabby	たるんだ|肉が弛んでしまりのない|気力のない|軟弱な
somatosensory	of or relating to the somatosenses
apace	たちまち|すみやかに|と歩調を合わせて|遅れないで
carob	イナゴマメ(地中海沿岸産の豆に似た実のなる木)|イナゴマメの実
mangold	マンゴルト
sard	a deep orange-red variety of chalcedony
stringy	糸を引く|ひもの
carboxylate	カルボン酸塩
sonorous	鳴り響く|響き渡る|格調の高い
stet	〈校正で訂正された箇所が〉生きる|もとへもどる|〈いったん訂正した箇所〉‘を'もとへもどす|生かす|‘に'「イキ」と記す
scriptwriter	(映画・テレビ・ラジオなどの)脚本家|シナリオ作者
boric	of or relating to or derived from or containing boron; "boric acid"|of or relating to or derived from or containing boron
constitutively	構造的に
endorphin	エンドルフィン
gallic	of or pertaining to Gaul or the Gauls; "Ancient Gallic dialects"; "Gallic migrations"; "the Gallic Wars"|of or pertaining to Gaul or the Gauls|of or pertaining to France or the people of France; "French cooking"; "a Gallic shrug"|of or pertaining to France or the people of France
phobic	恐怖症の人|恐怖症患者|病的に怖がる
tubule	尿細管
kayo	ノックアウト(knockout)|(ボクシングで)〜‘を'ノックアウトする
noninstitutionalized	not committed to an institution
patriarchate	patriarchの地位(職権・在位期間・支配区域)
undershirt	アンダーシャツ
thermonuclear	熱核反応の|原子核融合反応の|(a thermonuclear bomb 水素爆弾=hydrogen bomb(HB)|fusion bomb)
groat	グロート|4ペニーの価値の旧英国の銀貨|わずかな金銭|少し
esophagitis	食道炎
decant	静かに注ぐ
dross	かなくず|(溶けた金属の)不純物|無価値なもの
solidity	堅固であること
bronc	an unbroken or imperfectly broken mustang
indecisive	決断力のない|優柔不断な|不明確な|決定的でない
yucky	(俗)すごくまずい|気持ちが悪い|不快な|不潔な
epicure	飲食に対する洗練された感覚の持ち主|美食家|食通
remediate	規正|更正|矯正|修める|矯める|修する|匡正|是正|改正
cinnabar	辰砂(しんしゃ)(水銀の主要鉱石|赤色または赤褐色)
gargle	〈うがい液・水など〉‘で'うがいする|〈口・のど〉‘を'うがいする|うがいする|うがい[すること]|うがい液|うがい薬|うがいの音
levity	(おおげさに)軽率|無思慮|場違いな陽気さ
freewheel	(ペダル・エンジンを止めて)惰性で走る|自由に行動する
cofounder	one of a group of founders
oppressor	迫害者|暴君
metrical	韻律の|韻文の|測定の|測定に用いる
scram	逃げる|すぐに出て行く
immeasurably	非常に|測り知れない程の
risperidone	リスペリドン|セロトニン・ドーパミン拮抗薬|(SDA)と呼ばれる非定型抗精神病薬
urologist	a specialist in urology
oxidize	酸化させる|さびさせる
pigeonhole	ハト穴|書類整理棚(に入れる)|分類整理する|棚上げする
fiendish	悪魔のような|残忍な|《話》(行動が)賢い|《話》かなりの|ひどい
hasp	(ドア・ふたなどの)留め金|掛け金|〈ドア・窓など〉‘に'留め金(掛け金)を掛ける
glorification	賛美|称賛
forebrain	前脳
dorky	役立たずの
satsuma	蜜柑|蜜柑
hypothetically	by hypothesis
irrepressible	抑えられない
stickler	頑固に言い張る人|難問
sigint	intelligence information gathered from communications intelligence or electronics intelligence or telemetry intelligence
ciliate	繊毛虫(ゾウリムシなど|繊毛のある微生物)
tinfoil	アルミ箔
skybox	an elevated box for viewing events at a sports stadium
copulation	性交|交接|連結|結合
drumbeat	太鼓の音|ドラムビート|声を大にして唱える主義
bruch	マックス・ブルッフ
midyear	一年のなかごろ|(大学の)中間試験
unmediated	ダイレクト|直接的
serzone	ネファゾドン
magnesia	マグネシア|酸化マグネシウム
aperitif	食前酒
impassable	通れない|通行不能
ipsilateral	on or relating to the same side (of the body)
nicotiana	タバコ
signor	(イタリア語)《S-》〜君(様|殿|閣下)(英語のMr.|Sirに相当)|(特にイタリアの)貴族|紳士
phlegm	痰|粘液
subatomic	Subatomic particle|亜原子粒子|物理学や化学において原子よりも小さい粒子
paddler	someone paddling a canoe
scruff	えり首 cf|scruffy(うす汚れた)
hermetically	密閉(密封)して
uncommonly	極めて
inhospitable	もてなしの悪い
hallucinogenic	幻覚を生じさせる
looseleaf	加除式
coleslaw	キャベツサラダ
kooky	(俗)ばかげた|気違いの|妙な
interventionist	政府干渉を主張する人|干渉主義者
overproduction	生産過剰
tacrolimus	タクロリムス|免疫抑制剤の一種|臓器移植や骨髄移植を行った患者の拒絶反応を抑制する|アトピー性皮膚炎に対する塗布剤でもある
necropolis	《文》(古代都市などの)大墓地
windstorm	暴風
boxy	箱に似た|箱のような
grosgrain	グログラン
ritualistic	儀式を偏重する|儀式主義の|儀式的な
verbiage	冗漫
salutary	健康によい|有益な|健康回復によい
matric	admission to a group (especially a college or university)
ipecac	トコン(南米産のアカネ科の低木)|吐根剤(トコンの乾燥根で吐剤|下剤に用いる)
capitalistic	資本主義的な
cosmetologist	=beautician
xylem	木質部
rotatable	capable of being rotated; "the theater had a rotatable stage"|capable of being rotated
infanticide	幼児殺し|嬰児殺し|間引き
bradycardia	徐脈
percept	知覚|知覚経験
porphyria	ポルフィリン症
recip	reciprocal|reciprocity
combust	燃やす
effectually	in an effectual manner; "Bismarck was constantly criticised by the more liberal newspapers, and he retaliated by passing an emergency decree that effectually muzzled the press"|in an effectual manner
escutcheon	紋章の描かれた盾(たて)|盾形の紋地
unprovoked	(特に悪い行為が)正当な理由(動機)のない|いわれのない
apocryphal	出所のあやしい|出所の怪しい|偽作の
pallid	青白い|淡い
sulphuric	of or relating to or containing sulfur; "sulphuric esters"|of or relating to or containing sulfur
borzoi	ボルゾイ種(ロシア産の猟犬)
pernambuco	レシフェ
diddley	ジャック
individualise	個別化|個別化
wheelwright	(特に昔の)車大工|車輪製造(修理)人
cornel	ミズキ|ヤマボウシ
interleave	(白紙などを)〈本〉‘に'はさむ《+『名』+『with』+『名』》
glabrous	(動植物が)無毛の
glaciation	the condition of being covered with glaciers or masses of ice; the result of glacial action; "Agassiz recognized marks of glaciation all over northern Europe"|the condition of being covered with glaciers or masses of ice|the result of glacial action|the process of covering the earth with glaciers or masses of ice
bleacher	漂白者(器･剤)|屋根なし観覧席
unknowable	計り知れない
lozenge	菱形|菱形面|菱形の糖菓|菱形窓ガラス|トローチ剤|飴|甘味入りの錠剤
outlive	より長生きする
illusionist	幻想家|迷妄論者|奇術師|手品師
steelman	a worker engaged in making steel
teasdale	ティーズデール
touristy	(観光)旅行者の|(観光)旅行者に人気のある
crikey	(驚いて)おや|ありゃ
separatism	分離主義
meerkat	ミーアキャット
oiler	タンカー
covalently	共有結合
spangle	スパングル(特に衣服につけるぴかぴか光る小さな薄い金属やプラスチックの飾り)|ぴかぴか光る小さな物|(光る物などで)〜‘を'飾る;〜‘を'ぴかぴか光らす
ideation	観念の形成|観念化
milage	マイル数
cession	(領土の)割譲|(権利・財産の)譲渡|譲与;〈C〉譲渡されたもの
beneficent	慈善心に富む|奇特な
occultism	神秘論|神秘主義(超自然・超能力的な力の存在を信じること)|神秘学
luxuriant	うっそうと茂った|繁茂した|豊富な|肥えた|はなやかな
waif	放浪者|浮浪児|漂着物|拾得物
plausibly	もっともらしく
recuperation	(健康などの)回復
agronomist	農学者
unfocused	焦点の合っていない
courtly	みやびた|上品な|宮廷風の|へつらう
conflagration	大災害|大火災|(正式)花火
dampness	じめじめすること|意気消沈
circulator	循環器|流布(伝達)する人|循環小数
lightheadedness	立暗み|立ち暗み|眩暈症|眩瞑|目眩|眩暈|めまい|浮動性めまい|目眩い|立ち眩み
downsize	小型化する
kampong	a native village in Malaysia
wheeze	ぜいぜいいう|ぜいぜい息を切らす
adsorbent	吸着性
silversmith	銀細工師
phallic	陰茎の|男根[崇拝]の
pigweed	アカザ|アカザ|アカザ
porphyry	斑岩 (ex|a porphyry that has a phenocryst of quartz or orthoclase 石英や正長石の斑晶を有する斑岩
breakneck	危険きわまる
mesenchymal	間葉系幹細胞|骨や血管|心筋など間葉系の細胞への分化能をもつ
drover	牛や羊を市場に追って行く人|家畜追い
backbencher	(UK英)(下院の)後方席の議員|平議員
teratology	奇形学
curation	キュレーション|インターネット上の情報を収集し|まとめること
mechanization	自動化|機械化
underappreciated	過小
distributer	someone who markets merchandise|electrical device that distributes voltage to the spark plugs of a gasoline engine in the order of the firing sequence
calligrapher	書家|代書人|能筆家|筆耕
cordage	なわ類|(船の)索具
loath	いやがって|嫌って
multivariable	多変量
unsophisticated	単純な
nightie	ねまき|ネグリジェ
meatless	lacking meat; "meatless days"|lacking meat
institutionally	by an institution; "institutionally controlled"|by an institution
dynastic	王朝の
cognizance	(〜の)認識|知識|知覚《+『of』+『名』》|知識(認識)の範囲;理解能力
casbah	カスバ
vaginitis	膣炎
nearness	(〜への)近さ|接近|近似《+『to』+『名』》
plebiscite	国民(住民|一般)投票|世論表明
internationalize	put under international control; "internationalize trade of certain drugs"|put under international control|make international in character; "We internationalized the committee"|make international in character
leftism	傾向
cftr	嚢胞性線維症膜コンダクタンス制御因子
reinterpretation	a new or different meaning|a new or different interpretation
plaintive	悲しげな|哀調に満ちた|哀れな|憂鬱な
disreputable	評判の悪い|悪評の|不評の
strikeout	三振
seraph	最高位の天使(聖書の中の人の形をした3対の翼のある天使)
pseudogene	偽遺伝子
cartwheel	(荷馬車･荷車の)車輪|側転|(口)大型硬貨
thymic	胸腺の
frill	フリルを付ける|フリル
reaffirmation	再確認
noradrenaline	ノルアドレナリン|ノルエピネフリン
bookclub	a club that people join in order to buy selected books at reduced prices
hemangioma	血管腫
dollop	(dάləp)|塊|ちょっぴり|ひとさじ分|少量|たっぷり塗る|どっさり配る
neutralizer	中立化させる人;中和剤
exudate	浸出液
smokescreen	煙幕|(一般に)隠す(ごまかす)ためのもの
afterimage	(心の中に残った)残像
gook	(俗)ごみ|泥|ねっとりした液|まぬけ|東洋人
hedonistic	快楽主義の
ballade	バラード|物語詩|譚(たん)詩(フランス詩の一形式)|(音楽の)バラード|譚詩曲
skimp	けちけちする|ちびちび与える
pipet	ピペット
tyro	初心者|ビギナー
harpy	ハーピー(顔と体が女で鳥の翼とつめを持った貪欲な怪物|ギリシア神話)
yellowtail	ブリ
outshine	に光り勝つ
obsessively	しきりに
handily	手近に
untruth	虚偽
ponderous	非常に重い|重々しい|重苦しい
scrupulously	良心的に|注意して|細心に|実直に
technobabble	technical jargon from computing and other high-tech subjects
blat	(羊がメーメー|犬がクンクン)鳴く|騒々しい音(を立てる)|を大声でしゃべりまくる|うっかりしゃべる
blurt	口を滑らす|うっかり口に出す
carbonaceous	炭素質の;炭素を含む
quixotic	ロマンチック|ロマンティック|浪漫的|ローマン的|空想的
panicum	キビ属
athleticism	運動競技熱|スポーツ熱
deride	あざ笑う|あざける|あざわらう|ばかにする
antipasto	(食事の主品の前に出る)前菜
nasopharyngeal	鼻咽頭
marginalize	relegate to a lower or outer edge, as of specific groups of people; "We must not marginalize the poor in our society"|relegate to a lower or outer edge, as of specific groups of people
relaxer	any agent that produces relaxation; "music is a good relaxer"|any agent that produces relaxation
nother	その他の何もない|Ex|nother thing just occurred to me
unequaled	類ない|無類|類の無い|又ない|並び無い|類いない|又無い|類のない|並びない|類い希
plucky	勇気のある|元気な|断固たる
eusebius	エウセビオス
untidy	だらしない
loggia	ロジア(片側に壁のない柱廊)
baobab	バオバブ(の木)|マダガスカル|豪|アフリカに分布|高さ30ｍ|直径10ｍになり|年輪が無いが樹齢数千年とされる|果肉|若葉は食用|種子は油|樹皮は編んで強靭なロープになる
subluxation	亜脱臼
multicellular	多細胞の
cedarwood	durable aromatic wood of any of numerous cedar trees; especially wood of the red cedar often used for cedar chests|durable aromatic wood of any of numerous cedar trees|especially wood of the red cedar often used for cedar chests
workroom	仕事部屋|作業室
phlebotomy	瀉血
sundeck	サンデッキ(住居・ホテルなどの日光浴用のテラス)|(客船の)上甲板
rubus	キイチゴ属
unjustifiable	incapable of being justified or explained
boor	オランダ人小作農|小百姓|粗野な男|田舎者|不作法者
pedant	学者ぶる人|衒学者
vetch	ソラマメ|ヤハズエンドウ|カラスノエンドウ
shuffler	足を引きずって歩く人|(配る前に)カードを切る人
goiter	甲状腺腫
dramatize	脚色する|劇にする|戯曲化する|劇的に表現する
microscopically	顕微鏡で;顕微鏡で見るように
defibrillation	電気的除細動
animism	アニミズム(自然物・自然現象などに霊魂があるとする信仰)|精霊説(人および物の活動はすべて霊の力によるとする信仰)
conciliatory	懐柔的な|なだめるような
credibly	信用できて|確かな筋から
syncytial	合胞体|複数の核を含んだ細胞のこと(動物に見られる)
psalmist	賛美歌作者
nefertiti	ネフェルティティ
runnel	小川(runlet)
hemerocallis	east Asian rhizomatous clump-forming perennial herbs having flowers on long leafless stalks; cosmopolitan in cultivation: day lilies; sometimes placed in subfamily Hemerocallidaceae|east Asian rhizomatous clump-forming perennial herbs having flowers on long leafless stalks|cosmopolitan in cultivation: day lilies|sometimes placed in subfamily Hemerocallidaceae
filtrate	ろ過水|ろ過液|=filter
plantae	植物界
pyre	(pάɪɚ) (火葬用の)積み薪|(一般の)積んだ薪
twiddle	もてあそぶ|ひねり
basswood	=bass
patrimony	世襲財産|伝承|遺伝
terrify	こわがらせる|を恐れさせる|をおびやかす
downtrodden	踏みにじられた
strix	owls lacking ear tufts
reflexion	返照|反映|反射|照り返し|反照|リフレクション|照りかえし|表われ|エキスプレッション|顕れ|反映|表現|現れ|現われ|表れ|エクスプレッション|顕われ|熟考|潛心|思索|思慮深いこと|観照|観想|黙想|深慮|黙考|沈思|反射|鏡像|写|映像|倒影|映像
demerol	メペリジン
amanita	genus of widely distributed agarics that have white spores and are poisonous with few exceptions
croup	クループ|上気道のウイルス感染による疾患|小児の15%が一度は感染し|生後半年から6歳までの小児に多く10代や成人の感染例はまずない
lintel	まぐさ(楣|入り口･窓の上の横木|建築用語)|楣石|リンテル
humperdinck	フンパーディンク
broadcloth	幅広の黒ラシャ|ブロード(緻密な木綿・絹・レーヨンなどの生地で|ワイシャツ・パジャマ・婦人服などに用いる)
disuse	不使用|廃止
nock	印す|銘打つ|刻む|標す
ineptitude	不適当|愚かさ
classless	(社会が)階級制度のない|(人が)特定の社会階級に属さない
alkaloid	アルカロイド(Alkaloid)|窒素原子を含み|塩基性を示す天然由来の有機化合物の総称|微生物|真菌|植物|動物等の生物によって生産され|他の生物に対し有毒である
glittery	キラキラ輝く
vicariously	代理に|身代わりに
amendatory	effecting amendment; "added amendatory phrases to the text"|effecting amendment
handedness	利き手|側性
esthetician	a worker skilled in giving beauty treatments (manicures and facials etc.)|a philosopher who specializes in the nature of beauty
psychoanalyst	精神分析学者
appealable	capable of being appealed especially to a higher tribunal; "decisions...appealable to the head of the agency"- New Republic|capable of being appealed especially to a higher tribunal
waw	the 6th letter of the Hebrew alphabet
garish	ぎらぎら光る|けばけばしい|派手な|ごてごて飾りたてた
pappa	パパ|お父ちゃん|父っつぁん|ちゃん|父ちゃん
hcfc	ハイドロクロロフルオロカーボン
toupee	(はげ隠し用)男性かつら
baronet	准男爵|従男爵(英国世襲位階の最下級でbaronの下knightの上)
atresia	閉鎖
bombastic	誇大な|大げさな|大言壮語の|豪語する
turnoff	分岐点
remount	〜に再び乗る|再び登る|〈軍隊など〉‘に'新馬を供給する|新馬を入れる|〈絵・写真など〉‘を'新しい厚紙に貼りかえる|再び馬(自転車など)に乗る|新馬|補充馬;新馬の補充
blowback	バックファイア
circumpolar	北極(南極)周辺の|(星が)天極の回りを円を描いて回る
unearthly	この世のものとも思われない|気味悪い
bacteremia	菌血症
predestination	運命・ 宿命; 【神学】（運命）予定説・宿命論(この世のすべての事は神の予定によるとする考え)
aalto	アルヴァ・アールト
fiducial	relating to or of the nature of a legal trust (i.e. the holding of something in trust for another); "a fiduciary contract"; "in a fiduciary capacity"; "fiducial power"|relating to or of the nature of a legal trust (i.e. the holding of something in trust for another)|used as a fixed standard of reference for comparison or measurement; "a fiducial point"|used as a fixed standard of reference for comparison or measurement|based on trust
alberti	アルベルチ
regulus	レグルス|レグルス
dishevel	〈髪など〉‘を'ぼさぼさに垂らす;〈着物など〉‘を'だらんと着る
extramarital	婚外性交の
radiograph	レントゲン写真|〈人体など〉‘を'レントゲン写真にとる
reclassify	再分類
oligopoly	独占
trichloroethylene	トリクロロエタン
carcase	枝肉
languid	不活発な|だるい
anachronistic	時代錯誤の
starkly	全く
ratty	ねずみのような
fearfully	すごく
fingerless	not having or having lost fingers
outdoorsman	a person who spends time outdoors (e.g., hunting or fishing)
phalaenopsis	コチョウラン
musketeer	銃兵
unhindered	not slowed or blocked or interfered with; "an outlet for healthy and unhampered action"; "a priest unhampered by scruple"; "the new stock market was unhampered by tradition"|not slowed or blocked or interfered with
upstage	舞台の後方の|内気な
smokestack	重工業の
homogenization	均質化
pilaf	ピラフ
neurofibromatosis	神経線維腫症
fondle	かわいがる|愛撫する
scree	小石|砂利
lithe	しなやかな|柔軟な
humanely	思いやりをもって|人道的
uncoordinated	lacking in cooperative planning and organization ; "uncoordinated scheduling often resulted in conflicting games"|lacking in cooperative planning and organization |lacking the skillful and effective interaction of muscle movements; "his movements are uncoordinated"; "an uncoordinated toddler"|lacking the skillful and effective interaction of muscle movements
teletype	teletypewriterの商標名|テレタイプ社|テレタイプで送る
incompletely	不完全に
phrasal	句の|句からなる
sigmoid	curved in two directions (like the letter S)|of or relating to the sigmoid flexure in the large intestine
gaiety	はで|陽気
gadolinium	ガドリニウム
azonic	not restricted to any particular zone or region
frangipani	インドソケイ|プルメリヤ|プルメリア
uttermost	最も遠く離れた|最もはずれの|最大限の|極度の|最大限度|極限
squib	爆竹|導火爆管|小花火|(政治家攻撃)機智に富んだ文|風刺
gladiolus	グラジオラス|グラジオラス
microbrewery	地ビールの醸造所
aeolian	a member of one of four linguistic divisions of the prehistoric Greeks|the ancient Greek inhabitants of Aeolia|of or pertaining to Aeolus, the Greek god of the winds; relating to or caused by the wind|of or pertaining to Aeolus, the Greek god of the winds|relating to or caused by the wind|of or relating to Aeolis or its ancient Greek people
gunny	(袋などを作る)目のあらい麻布
lave	〜‘を'洗う(wash)|浸す|〈流れなどが〉〈岸〉‘を'洗う
headstock	主軸台
crabgrass	オイシバ(ヒメシバ属)の草
porker	(食用に肥らせる)子豚|《おどけて》豚
dugong	ジュゴン(インド洋に住むイルカに似た水生哺乳(ほにゅう)動物)
trie	順序の付いた木構造 (データ構造)の一種|トライ木(Trie)|語源は|検索 retrievalの単語の真ん中(trie)に由来|発音はtriː に近い
phoney	=phony・〔話〕 にせの; 〔話〕 にせ物; 〔話〕 いかさま師
sheepish	(羊のように)内気な|恥ずかしがる|気の弱い|おどおどした
encephalomyelitis	脳脊髄炎
decimate	10人に1人をくじで殺す|殺す|倒す|多量に殺す
incestuous	近親相姦の|排他的な
antic	おどけた(しぐさ)|風変わりで滑稽な|怪奇な
reopen	再開する|再び始める
rein	手綱|統制|手段|拘束|指揮|制御する
technologist	科学技術者
divider	分割機|分割者|分配者|分裂のもと|離反者|仕切りページ|大活字|小見出し
sprawl	ばらばらに広がる|だらしなく伸びる|手足を延ばす|大の字に寝そべる|這い歩く|スプロール現象
awning	日よけ
collide	衝突する|ぶつかる|一致しない
buoy	浮標|ブイ
minivan	ミニバン
tinker	(機械などを)下手に･間に合わせに修繕する|Tinker Bell|ティンカーベル(Tinkerbell|ピーターパンに出てくる妖精)
coupler	(車両の)連結器
injector	注射器(=syringe)
chariot	(古代の)一人乗り軽三輪戦車|立派な馬車|(俗)古くて大きな自動車
modulus	係数|率|絶対値(absolute value)|標準|規準(norm)
forester	林務官|森林の住人
seaman	船員
werewolf	狼人間|狼男
disgrace	の両目を失わせる|恥辱|不名誉
lefty	左利き
moot	議論の余地がある|未決定の|議題にのせる|討論する
treatise	学術論文|論文|報告書
giraffe	キリン
inbreed	同系交配する
chimp	chimpanzeeチンパンジー
announcer	アナウンサー
ointment	軟膏
redress	弊害を除く|直す|不正を償う|改善|ただすこと
hemorrhage	出血|(資産･頭脳の)流出|多量に出血する
montage	モンタージュ(技法)
whine	すすり泣く|ぐちをこぼす|哀れっぽい声|犬の鳴き声
realisation	認識|認知|現実化|実現|具体化|結実|履行|実現|実行|体得
arson	放火(犯)
payback	資本回収
dill	ディル|ヒメウイキョウ(セリ科の植物で|実と葉はピクルスなどの香味料)
cappuccino	泡立てクリームをのせたエスプレッソコーヒー
monsieur	様
masthead	マストの先|マストの先の見張人|マストヘッド|新聞名|発行人欄
chilli	トウガラシ|唐辛子|(薬味の)チリ (国名のチリはChile)
azimuth	(æzəməθ)|(天文)方位角|方位|発射方位|アジマス
fodder	まぐさ(馬草)|にまぐさを与える
geeky	おかしな
quantification	定量化
falsely	偽って
adultery	不倫|姦通|密通
midwestern	中西部の
charisma	カリスマ(性)(神授の力)|権威|人々を信服させる教祖的な指導力
patronage	後援|(ペｲﾄｩﾛﾆｯｼﾞ)(顧客の)ひいき|愛顧|保護|いばった態度|商店へのひいき
impetus	勢い|刺激|推進力|起動力|はずみ
malnutrition	栄養失調
intercultural	異文化間の
superfamily	生物上科(科の上)
functionally	機能的に
rabies	狂犬病
readability	読みやすさ;おもしろく読めること|判読できること
transatlantic	大西洋の向うの|大西洋横断の
glutathione	グルタチオン|3つのアミノ酸から成るトリペプチド|抗酸化物質の1つ
angina	狭心症
cayenne	(粉)トウガラシ|トウガラシの実
balboa	バルボア(パナマ共和国の貨幣単位)
wainwright	荷車製造
daimler	ダイムラー
tadalafil	virility drug (trade name Cialis) used to treat erectile dysfunction in men
brilliantly	あかあかと|あざやかに|キラキラと|すばらしく|水際だって
ionization	イオン化
congregational	集合の|集団の
qed	量子電磁力学
waterfowl	(集合的に)水鳥|(fowl にわとり)
madras	マドラス木綿(インド原産;しまやチェックあや織りで|シャツやドレス用)
faro	銀行|賭けトランプの一種
sonora	そのら
arginine	アルギニン
skepticism	懐疑論|懐疑主義|懐疑的な態度|無神論
simplistic	極度に単純化した|簡単に割り切りすぎた
psychotic	精神異常者|精神病の|病性の
individuality	個性
freehold	(不動産などの)自由保有権|自由保有不動産
agar	テングサ|寒天(培養基)
cyclobenzaprine	muscle relaxant (trade name Flexeril) used for muscle spasms or acute injury
polycarbonate	ポリカーボネート樹脂
placer	砂鉱床
irritable	おこりっぽい
scum	浮きかす|屑|灰汁(あく)|かすが浮かぶ|の浮きかすをすくう|くず|かす|泡|温めた牛乳に張る膜
cunning	抜け目のない|ずるい
associative	連合の|連想の|結合の
westside	ウェストサイド物語(映画名)
logistical	ロジスティック
occidental	西洋(人)の
vigor	元気|力|活力|活気|迫力|勢い|(植物などの)生長力
evasion	言い逃れ|回避|くぐりぬけ|脱税
jansen	ヤンセン
matrimonial	結婚の|夫婦の
tween	トゥイーン(MS Windowsで作動するTwitterのアプリケーション)
hydraulics	水力学|水理学
boucher	バウチャー|証書
prostitute	金のために売る|売春婦
prilosec	オメプラゾール
warmer	暖める人|加湿器
halftime	ハーフタイム
frye	フライ
giro	郵便振替
tenderness	柔らかさ|もろさ|敏感|愛情
wembley	a southeastern part of Greater London that is the site of the English national soccer stadium
ocular	目の|視覚による|ocular proof 目に見える証拠|接眼鏡
sandman	睡魔
dung	肥料(manure)|糞
conclusive	結論的な|決定的な|最終的な
undersign	sign at the bottom of (a document)|sign at the bottom of (a document) 
brutality	横暴さ
plentiful	たくさんの|豊富な|多くの|豊富の|たっぷりの
massively	大規模
stately	威厳のあった|威厳のある|堂々と
lunchtime	昼食の時間
aeronautical	航空の
lasalle	French explorer who claimed Louisiana for France (1643-1687)
pwr	a nuclear reactor that uses water as a coolant and moderator; the steam produced can drive a steam turbine|a nuclear reactor that uses water as a coolant and moderator|the steam produced can drive a steam turbine
circumcision	割礼(ユダヤ教などで宗教的儀式として男性の陰茎包皮を切り取ること)|《Circumcision》(カトリックで)キリスト割礼の祝日|(聖公会で)受割礼日(1月1日)
exhibitionism	自己宣伝癖|露出症
redux	戻ってきた
compensatory	償いの|賠償的な|報酬の
rayon	レーヨン|絹に似せて作った繊維|人絹(人造絹糸)や|ステープル･ファイバーからスフと呼ばれていた|Rayonは光線(ray)と綿 (cotton) の合成語
concurrence	一致
apnea	無呼吸
troublesome	やっかいな|骨の折れる
eucharist	聖餐(式)|聖餐用のパンとブドウ酒
objectivity	客観性
hereto	これに|この点(場所|事)へ
magnetism	磁力|魅力|磁気|人を引きつける力|磁気学
inventive	発明の才のある
rapporteur	a recorder appointed by a committee to prepare reports of the meetings
chromosomal	染色体の
cutting	割って入る
cyclical	周期的な(に起る)|循環する|循環株
mechanically	機械で|無意識的に
calumet	カルメット(北米インディアンが和解の印としてタバコを回し吸いする長い飾りパイプ)
doggie	(幼児語)わんちゃん
futile	無益な|無駄な|くだらない|役に立たない
saigon	ホーチミン市
hydra	ヒュドラ|海蛇座|海蛇座|スネーク川|ヒドラ
elliptic	=elliptical
experimentally	実験的に
musculoskeletal	筋骨格系の
affluent	豊富な|よどみなく流れる|裕福な|流れ込む
dix	ディックス
lonesome	寂しい|人里離れた
unconventional	慣例にとらわれない|自由な|(服装など)略式の
heartfelt	心からの
psf	a terrorist group of radical Palestinians who split with al-Fatah in 1967 but now have close relations with al-Fatah; staged terrorist attacks against Israel across the Lebanese border|a terrorist group of radical Palestinians who split with al-Fatah in 1967 but now have close relations with al-Fatah|staged terrorist attacks against Israel across the Lebanese border
telluride	テルル化物
victorious	勝利の|勝利を得た|勝った|戦勝の
mocha	コーヒー色|チョコレート色|モカ|上等のコーヒー|モカ革|モカ風味のケーキ|暗褐色|手袋用なめし革
sylvan	樹木の茂った|森の|森に住む
unnatural	不自然な|不思議な|人情にそむく|異常な
alphabetic	アルファベット順の
thrombosis	血栓症
symphonic	音の類似した|交響曲の|調和した
asker	未信者|求法者
modernity	現代性|現代的なもの
gangsta	ギャングスタ(テレビアニメ名)
luscious	(味･香りが)よい|おいしい|甘い
ethos	(特定の民族･社会･時代･文化などの)気風|精神|思潮|エトス
bil	billionの略|10億
argyle	(対照的な色を用いた)ひし形編み模様|ひし形模様編みの短靴下
prophetic	予言的な
bextra	a Cox-2 inhibitor (trade name Bextra) that relieves pain and inflammation without harming the digestive tract
consequent	当然の|結果
neutrality	(国家の)中立|中立政策|中立･不偏不党の状態
ovulation	排卵
euthanasia	安楽死|安死術|安らかな死
liter	リットル(1000cc)
fume	蒸発する|煙|蒸気|煙霧|熱気|怒気|煙を出す|をいぶす
unitarian	ユニテリアン派(プロテスタントの一派|三位一体の教義(The doctrine of the Trinity|父と子と聖霊)を排して唯一の神格を主張し|キリストを神としない)クリスチャン
lowercase	小文字
goldfish	金魚
witherspoon	ウィザースプーン
irreversible	逆にできない|逆転できない|取り消しできない
understanding	物わかりのよい|理解|知力|思慮|相互の理解|一致
tung	アブラギリ
postpartum	分娩後の
dove	ハト|ハト派
glib	口の軽い|口の達者な|ベラベラしゃべる|口のうまい|行き当たりばったりの
fictitious	架空の|偽の|創作上の|虚構|虚偽|架空
immortality	不死
saffron	サフラン|鮮黄色(の)
peerless	無比の|無類の
improbable	ありそうもない
jesuit	イエズス会士
atypical	異常な
excessively	過度に
devoid	欠けていて
extraordinarily	異常に|並外れて|異例に|特別に|法外に
idf	the ground and air and naval forces of Israel
haircare	ヘアドレッシング|ヘアケア
dishonest	不正直な
mailbag	郵便袋;郵便かばん(《英》postbag)
inert	(人など)のろい|生気のない|鈍い|不活性の
favorably	好意を持って|好意的に|好都合に|順調に|都合よく|有望に|有利に
postwar	戦後の
edwardian	someone belonging to (or as if belonging to) the era of Edward VII|of or relating to or characteristic of the era of Edward VII in England; "Edwardian furniture"|of or relating to or characteristic of the era of Edward VII in England
dryden	ドライデン
unfavorable	都合の悪い|不運な|不利な|逆の|好意的でない|好ましくない
anomalous	異常な|変則の|例外的な
jitter	(〜についての)神経過敏《+『about』+『名』》|いらいらする
feminization	女性化
frugal	節約する|倹約な|質素な|つましい
extremist	過激派
starry	星の多い|星のように輝いた|星形の
hobbit	ホビット
multipurpose	多目的の
cohesive	(日常などに)密接した|粘着性のある|結合性のある|密着する
caster	投げる人|配役係|鋳造者|(ピアノ|いすなどの)足車|キャスター|news casters(=news anchors)ニュース番組司会
medial	中間の|平均の|並みの|(文法)語中の
colossal	巨大な|素晴らしい|途方もない
conversational	会話の
brio	活気|元気
screener	審査官|しゃへい装置|スクリーナー
hanukkah	ハヌカー(ユダヤ教の祭り)
adsorption	吸着|吸着量
noc	an undercover agent who is given no official cover
cumbersome	扱いにくい|邪魔な|やっかいな
internationalization	国際化
transmembrane	膜貫通
firth	河口|入り江|湾
cer	条件情動反応
undated	日付のない
alternately	交互に|一つおきに|互い違い|ちゃんぽん|交互
technologically	技術的に
gracefully	優雅に|淑やかに
climber	登山者|はい登る植物(ツタなど)|出世主義者
avenger	復讐者
encapsulate	カプセルに包む|(事実･情報などを)要約する
evacuate	避難する|撤退する|疎開する|立ち退かせる|明け渡す|避難|退去|撤退
reunite	再び結合する|仲直りさせる(する)
restrain	抑制する|を押さえる|を制止する|防止する
tremble	震動する|(体が)震える|身震いする|おののく|揺れ動く|そよぐ|おののき
antidepressant	抗うつ剤
astronomer	天文学者
underwriter	保険引受人
inhale	吸い込む
drinker	酒飲み|飲む人|家畜用の給水機
immerse	没頭させる|浸す|沈める|つける
appraise	の価値を決める|を見積もる|評価する|見積もる|値踏みする|査定する
refrigerate	冷却する|冷やしておく
shingle	小さな看板|屋根板|小看板|を屋根板でふく|を短く刈る
chiropractor	脊柱指圧(調整)療法師
invertebrate	脊椎のない|無脊椎動物(の)|気骨のない
automaton	自動化|ロボット化
tropic	回帰線|熱帯の|熱帯地方の
perpetrator	加害者|犯人|下手人
macrophage	マクロファージ|白血球の一種|生体内をアメーバ様運動する食細胞|死んだ細胞や破片|体内に生じた変性物質や侵入した細菌などの異物を捕食し消化する
disqualify	無資格にする|資格を奪う|失格させる
amphibian	両生類(の)|水陸両用の|水陸両用飛行機･戦車|両生動物
grime	不潔
taint	汚れ|汚点|汚名|病毒|汚れる|を汚す
restock	(返品された商品を)在庫に戻す|仕入れ直す|新たに仕入れる|補充する
incubate	熟考する|卵を抱く
pollute	を汚染する|を汚す|を堕落させる|の神聖を汚す
segregate	分離する|差別する|隔離する|人種差別する
junky	麻薬患者|ジャンキー|中毒者|ナット
snore	いびきをかく|いびき|をぐうぐう寝て過す
toiletry	洗面化粧品
sufferer	苦しむ人|被災者|病人
millisecond	ミリ秒
condolence	悔み|哀悼|悔やみ
knocker	ノックする人|(また『doorknocker』)(玄関の)ノッカー|たたき金
jeweller	玉屋|宝石細工人|宝石商|宝石商
louse	シラミ(複数形lice)
astound	びっくり仰天させる
lamentation	悲嘆|哀悼|哀歌
abed	就床して
nubile	年ごろで性的魅力のある|(女性が)結婚適齢期の
dreadfully	すごく
uncool	格好悪い
contemptible	侮べつに値する|いやしむべき
dentin	象牙質|象牙質
crosstown	across a town or city; "he traveled crosstown"|across a town or city|going or extending across a town or city; "the crosstown bus"; "crosstown traffic"|going or extending across a town or city
unfailing	尽きることのない|絶えない|信誉できる|不変の|一定の
untoward	都合の悪い|困った|不幸な
contrive	考案する|工夫する|設計する|もくろむ|策する
acrylonitrile	アクリロニトリル
chlorite	緑泥石
bonehead	(俗)ばか
erving	アービング
synonymy	〈U〉同義[性]|〈U〉同義語(類語)研究|〈C〉同義語集|類語表|〈U〉(強調のため)同意語を重ねて用いること
threader	a blunt needle for threading ribbon through loops
zakat	ザカート
dolmen	ドルメン
theorize	理論づける|理論をたてる|空論にふける
hybridoma	ハイブリドーマ|ハイブリードマ
defloration	花の散らすこと;美(新鮮さ)を奪うこと|処女を奪うこと
maildrop	a drop where mail can be deposited
metaphase	(生物学用語)中期(核分裂の)|細胞分裂で染色体が赤道板状に並んだ時期
labile	変りやすい|不安定な
cushy	楽しい
trompe	だまし絵
indeterminacy	不確定(性)
playfulness	茶目っ気|遊び心
irrationality	不合理
pastiche	(仏語)文体を模写すること (音楽の)替え歌|パスティーシュ
whodunit	推理(探偵(たんてい))小説(映画)|ミステリーもの
confluent	合流する|支流
mistrial	誤審|裁判での誤った判決|無効審理
wilding	a wild uncultivated plant (especially a wild apple or crabapple tree)|an outrageous rampage usually involving sexual attacks by men on women
loaner	someone who lends money or gives credit in business matters|a car that is lent as a replacement for one that is under repair
gunfighter	銃(ピストル)を用いる決闘者
impingement	差し響き|インパクト|感化|差響き|差しひびき|影響|差響|さし響き|嵌入|衝突
chamfer	〈板〉‘の'かどをそぐ;〈板〉‘に'みぞをつける|(板・角材の)そがれたかど;板につけたみぞ
beckon	手招きする|(身振りで)招く|差し招く
pickpocket	スリ
grovel	腹ばう|ひれ伏す|屈服する|卑屈な態度をとる
grappa	グラッパ
haunting	絶えず心に浮かぶ
conglomeration	集塊|凝塊|かたまり|集まること
rejoinder	答弁|返答|応答|言い返し
lanolin	ラノリン|ラノリン
immunocompromised	免疫不全の
autoradiography	オートラジオグラフィー(放射線写真法)|放射性物質のベータ線やガンマ線で画像(autoradiograph)を作る手法|放射性物質はreceptor(受容体)や酵素や核酸に結合する
willet	large North American shorebird of eastern and Gulf Coasts
overzealous	熱心過ぎる
gilt	金メッキする|金の|金箔の
sapper	工兵隊員|敵前工作兵
karyotype	カリオタイプ|核型|(体細胞の染色体の構成の様相)
hydrazine	ヒドラジン
incommunicado	(特に囚人が)他との連絡を断たれた
fossilize	石化|化石|化石
unheated	not having been heated or warmed; "an unheated room"; "unwarmed rolls"|not having been heated or warmed
chitin	キチン質(節足動物の殻などを構成する角質の成分)
nihil	ニヒル
ovine	of or pertaining to or of the nature of or characteristic of a sheep or sheep
unsay	〈言ったこと〉‘を'取り消す|撤回する|言わなかったことにする
vizsla	Hungarian hunting dog resembling the Weimaraner but having a rich deep red coat
maleate	マレイン酸塩
lanky	やせ気味の
reave	分捕る|奪い取る|掠め奪う|押取る|略取|押し取る|寇掠|略す|掠める|収奪
turnbuckle	引き締めねじ|締め金具
waterhole	水たまり|泉|パブ|ホテル
globalism	グローバリズム(孤立主義に対し|一国が国際関係に積極的にかかわること)
axially	軸方向
officiant	祭式執行者
familiarization	the experience of becoming familiar with something
collude	共謀する
emirate	アラビアの首長の権限(身分)
frontrunner	(競技で)先頭を走る選手(馬など);ペースメーカー
ermine	鼬|オコジョ|鼬鼠
inventiveness	the power of creative imagination
corroboration	裏付け|確証する|補強する
steinman	スタインマン
refract	〈水・ガラスなどが〉〈光〉‘を'屈折させる
cottontail	ワタオウサギ(綿毛のような白い毛のウサギ;米国産)
capitulation	条件付降伏|降伏|降伏文書
tuning	音合|音合わせ|音合せ|チューニング|音取|調律|音取り|調弦
pestis	ペスト|疫癘
thyrotropin	甲状腺刺激ホルモン
banality	陳腐さ|ありふれていること
downdraft	下降気流
dryad	ドリュアス(ギリシア神話の樹木の精)
internode	節間(植物の茎などの節(ふし)と節の間の部分)
fallible	誤りに陥りがちな|誤りを免れない
pantheism	汎神(はんしん)論(神と自然とを同一視する)|多神教;自然崇拝
ploughshare	=plowshare
incalculable	数え切れない
hierarch	高僧|主席主教|貴僧|主席司教|高位聖職者
figurehead	船首像|名目上の頭首|表看板|名目上の頭主
pearlescent	真珠光沢のある
mammy	ママ|黒人の乳母|(mummyもママの意味がある|ミイラの意も)
organon	a system of principles for philosophic or scientific investigations; an instrument for acquiring knowledge|a system of principles for philosophic or scientific investigations|an instrument for acquiring knowledge
bloodstock	(競走馬としての)サラブレット
colorimetric	of or relating to colorimetry
shindig	にぎやかな社交の集まり|(陽気な)パーティー|宴会|舞踏会
numismatics	貨幣(古銭)の研究(収集)
cheapen	安くなる(する)|見くびる
indolent	無精な|怠惰な|なまける
whitefly	minute insect that feeds on plant juices; related to scale insects|minute insect that feeds on plant juices|related to scale insects
quayside	波止場地域|(quay|波止場)
meanderings	遊歩;遊歩道
banns	結婚予告(教会での挙式前に新郎新婦の名前を公表し|その結婚に対いる異議の有無を問う)
subsidization	下付金|交附|下げ渡し|供与|附与|施与|下渡し|恵賜|交付金|付与
fixative	固定液
asparagine	アスパラギン(アミノ酸のひとつ)
ennui	(仏語)倦怠|退屈|手持ちぶさた|アンニュイ
daystar	夜明けの明星|一つ星|明の明星
drome	空港|ドローム|エアポート|飛行場
intentionality	expressive of intentions
accusative	accusative case対格|名詞がもつ格のひとつ|他動詞の直接目的語を示す(ご飯を作る|など)|対格はすべての印欧語族に存在
pusey	ピュージー
cohesiveness	結合力のあること|結合の緊密さ|結合|纏り|纏まり
verdigris	緑青
expunge	消し去る|抹消する|ぬぐい取る|破壊する|絶滅させる|(語など)を削除する|抹殺する
employable	(人を)雇用できる;(物が)使用できる
hydrography	水路学|水路測量術
equilibration	平衡
exigent	(事情などが)切迫した|緊急の|(人が)しつっこい|しきりにせがむ
breadwinner	(一家の生計を支える)稼ぎ手|大黒柱
bactericidal	殺菌の
carbamate	カルバメート
spacing	間隔|スペーシング
feverishly	無我夢中で
ventriloquist	腹話術師
hairball	毛球(猫などが飲み込んだ毛が腸の中で球状になったもの)
forecourt	フォアコート|前庭
molest	妨害する|苦しめる|乱暴する
tailpiece	終りの部分|末端のもの;終りの付加物|(書物の章末・巻末の)装飾図案
porgy	タイ|鯛(sea bream)|タイの類
persuasively	説得力のある
walloon	a member of the French-speaking people living in Belgium|a dialect of French spoken in Belgium and adjacent parts of France
patisserie	a bakery specializing in French pastry
septicemia	=blood poisoning
squalor	不潔さ|むさ苦しさ|卑劣
lyophilize	凍結乾燥
pretreated	前処理された
peristaltic	(腸壁などの)蠕動(ぜんどう)運動の[ような]
violative	violating or tending to violate or offend against; "violative of the principles of liberty"; "considered such depravity offensive against all laws of humanity"|violating or tending to violate or offend against
clincher	決定的な決め手|理由
painlessly	without pain; "after the surgery, she could move her arms painlessly"|without pain
legwork	足を使った詳しい調査|取材
ebon	=ebony
radioisotope	放射性同位元素
chanticleer	おんどり
mesmerize	催眠術をかける
ascender	アセンダ|アセンダ|アセンダ
filbert	ハシバミ;ハシバミの実
bougainvillea	ブーゲンビリア|熱帯性の低木で美しい密集した花をつける
paraplegia	対麻痺(ついまひ)(病気による両下肢(し)の麻痺)
triticum	コムギ
relent	やわらぐ|気持ちが和らぐ
dinge	discoloration due to dirtiness|make a dent or impression in; "dinge a soft hat"|make a dent or impression in|make dingy
fluorocarbon	フッ化炭素|フルオロカーボン|過フッ化炭化水素
valiantly	果敢に
infallibility	絶対無謬性
varmint	害虫|有害動物|(話)下劣なやつ
glutton	大食家|凝り屋|熱心家|クズリ(イタチ科)
ipv	ソークワクチン
adamantly	頑として|頑固に
kennan	ケナン
neoliberalism	新自由主義
unscripted	(ラジオ・テレビ放送で話題・談話が)台本なしの|草稿なしの
catchphrase	標語|キャッチフレーズ
herbivore	草食動物
pappy	おやじ|ドロドロの|パン粥状の|柔らかな
suppository	座薬
tailgater	a driver who follows too closely behind another motor vehicle
neurotrophic	神経栄養
tanka	短歌
seesaw	シーソー遊び|変動する
frighteningly	驚くほど恐ろしい
flaccid	たるんだ|だらけた|弛緩した|弛緩性の|ゆるんだ
drier	ドライヤー|乾いた
putrid	腐った|悪臭を放つ
unguarded	不注意な|うっかりした|無防備の
collinear	堂一直線上にある
obliteration	消すこと|抹殺(まっさつ)|削除;消滅
internist	内科医
downstate	州の南部|州南部へ(で)|州南部の|州南部特有の
carpetbagger	渡り政治屋|山師
womanly	女らしい|婦人にふさわしい
ringleader	張本人|首謀者|発頭人
cooter	large river turtle of the southern United States and northern Mexico
rightist	右翼の|右派|保守主義者
chorizo	チョリソ
judiciously	慎重に|賢明に
pneumothorax	abnormal presence of air in the pleural cavity resulting in the collapse of the lung; may be spontaneous (due to injury to the chest) or induced (as a treatment for tuberculosis)|abnormal presence of air in the pleural cavity resulting in the collapse of the lung|may be spontaneous (due to injury to the chest) or induced (as a treatment for tuberculosis)
hypersensitive	過敏な
photosensitive	感光性の
scavenge	清掃する|あさる
worshipper	崇拝者|礼拝者|参拝者|愛好家
severable	分離可能
overpay	に払いすぎる
fibroid	(腫瘍などが)線維から成る|線維状の
leathery	革のような|(革のように)頑丈な|(肉などが)固い
extradite	送還する|引き渡す
packing	パッキング|包装
sophist	《しばしばS-》ソフィスド(古代ギリシアの一般教養・修辞・政治などを教えた教師)|詭弁(きべん)家|理屈屋
carburettor	キャブレター
guardsman	監視人|州兵|近衛兵|衛兵
trivialize	つまらなくする|平凡化する|矮小化する
subvention	(政府などからの)補助金|助成金
unbecoming	似つかわしくない|不適当な;(〜に)似つかわしくない《+to(for)+名》
deject	〜'を'落胆させる|がっかりさせる
parotid	relating to or located near the parotid gland
comely	美しい|みめよい|顔立ちのよい|器量のいい|ふさわしい
prow	船首
sprig	小枝|子孫
suss	疑い|容疑(者)|疑わしい|見抜く|突き止める|調べる|犯罪の疑いをかける
empathic	showing empathy or ready comprehension of others' states; "a sensitive and empathetic school counselor"|showing empathy or ready comprehension of others' states
ovate	(特に葉が)卵形の
tinea	infections of the skin or nails caused by fungi and appearing as itching circular patches|type genus of the Tineidae: clothes moths
bonefish	ソトイワシ
genotypic	遺伝子型
gazpacho	ガスパーチョ|スペイン料理とポルトガル料理の冷製スープ
fiberboard	ファイバーボード|繊維板
seismological	of or concerned with seismology
euthanized	安楽死させる
comparably	同等に
plaything	遊び道具|玩具|おもちゃ(にされる人)
unoriginal	not original; not being or productive of something fresh and unusual; "the manuscript contained unoriginal emendations"; "his life had been unoriginal, conforming completely to the given pattern"- Gwethalyn Graham|not original|not being or productive of something fresh and unusual
pravastatin	プラバスタチン
calfskin	子牛の皮|カーフ(子牛のなめし皮)