inundate	水浸しにする|氾濫させる|充満させる
uncleanness	不潔[さ]
foldout	(雑誌などの)折り込み写真
ritzy	きざな|贅沢な|とてもハイカラな|デラックスな|高級な|豪華な|豪勢な|豪奢な|俗物の|優雅な
jingo	好戦的愛国主義者
deportment	《米》(特に若い女性の人中での)態度|ふるまい(behavior)|《英》(特に若い女性の)立ち姿|歩く姿
quotidian	日々の|ありふれた|平凡な
steelwork	鋼鉄製品;鋼鉄部品
freeholder	土地・不動産自由保有権者
invidious	しゃくにさわる|不愉快な|ねたましい
abortus	流産児
cager	バスケットボール選手
outtake	技術上のミスなどの理由でフィルムやテープから削られた部分|引用(文)|抜粋
shitload	大量のもの
birddog	鳥猟犬
transience	一時的であること|はかなさ
seraphic	天使のような;気高く神神(こうごう)しい
malevolence	(məlévələns)悪意|敵意
aeronautic	航空の|飛行の|飛行船操縦者の
alcalde	(スペイン・米国南西部で)司法権を持つ市長
judicature	〈U〉司法[権]|裁判[権]|《集合的に》裁判官
antsy	じっとしていられない|そわそわした|不安な|(性的に)むらむらしている
premed	医科大学予科(生)|医進
lymphoproliferative	リンパ増殖
committeeman	(委員会の)委員
shoeshine	みがいた靴の艶|靴を磨くこと|靴磨き(人)
libation	献酒|神酒|(おどけて)祝い酒|飲酒
miasma	(沼沢地などから発生)毒気|瘴気(しょうき)|悪影響を与える雰囲気
interactor	インタラクター|相互作用物質
plasmin	プラスミン|タンパク質分解酵素(プロテアーゼ)の一種|フィブリンやフィブリノーゲンを分解して血栓を分解する
blackball	〈人が組織の一員になること〉‘に'反対投票する|〈人〉'を'排斥する|村八分にする|反対投票[古代ギリシアで黒い球で反対の意を表したことから]
angiosperm	被子植物|顕花植物|(種子植物のうち|胚珠が子房に包まれ受精後結実するもの|反:gymnosperm)
nonchalantly	無頓着に|冷淡に|無関心に
trespasser	[家宅]侵入者;違犯者
kvetch	(kvétʃ)|不平|不満をいう|愚痴をこぼす|不平|苦情|愚痴
trammel	馬かせ(馬に側対歩を教えるときに使う足かせ)|《複数形で》(自由を)拘束するもの|束縛|障害|〜の自由を拘束する|‘を'束縛する
irresponsibly	無責任に
chorea	舞踏病(顔面筋および四肢のけいれんを起こす神経系の病気)
oligomer	モノマー(単量体)が少数結合した重合体がオリゴマー(oligomer)|ダイマー(dimer|二量体)|トライマー(trimer|三量体)|テトラマー(tetramer|四量体)等|多数の重合体はポリマー(polymer)
millivolt	ミリボルト(1ボルトの1000分の1)
tkt	ticket
kaftan	=caftan
gruel	罰する|かゆ
transgressive	慣習に逆らう
decriminalization	非犯罪化
muggy	むし暑い
loofah	(体を洗う)ヘチマ|ヘチマの海綿状繊維|ヘチマ布巾
seersucker	シアサッカー(しまのある縮れた薄織りリンネル･紳士用スーツ生地)
knowable	近づきやすい|理解できる
cytarabine	シタラビン|抗がん剤の一種|商品名キロサイド(Cylocide)|核酸の誘導体である
hesitancy	尻込み|ためらい|ちゅうちょ
interposition	介在|介入|干渉|仲裁|挿入物
calling	職業|転職|点呼|召集
amphibole	角閃(かくせん)石(カルシウム・マグネシウムを含む石)
distrustful	信用しない
lodestar	(航海などの)道しるべの星;(特に)北極星|指導原理
hooky	ずる休み
nightjar	ヨタカ(鳥の名)
heartthrob	鼓動|(俗)熱情|恋人
incredulously	疑い深く|簡単には信じないで
obsequious	こびへつらう
mislabel	〜‘に'ラベルをはり違える
dissolute	自堕落な|放埓な|放蕩な|放蕩の自堕落な
reck	〜‘を'気にかける|こだわる|(〜を)気にかける《+『of』+『名』》
whorehouse	売春宿|女郎屋
scrutineer	検査官;(特に)開票検査人
procaine	パロカイン(局所麻酔な用いる薬品)
lamplight	灯火
mistrustful	疑い深い
schnitzel	シュニッツェル(ドイツ料理で子牛肉のカツレツ)
cutworm	ネキリムシ(根切り虫)(植物の根を食い切る害虫の総称)
hereon	ここにおいて|この直後に|このすぐ後で
coevolution	共進化
unprincipled	無節操
backspin	バックスピン(ビリヤード・卓球などで球に逆家転をつけること)
envelopment	包むこと|包囲
pacification	なだめること|和解すること|平和|講和;講和条約
sackcloth	(ズックなどの)袋地|(昔|服喪または悔悟のしるしとして着た)粗麻服
pathologically	病理学的に|病的に|異常に
enrapture	〈人〉‘を'有頂天にする|うっとりさせる
entrap	〜‘を'わなにかける|〈人〉‘を'計略にかける;〈人〉‘を'欺いて(〜)させる《+『名』〈人〉+『into』+『名』(do『ing』)》
graben	(地質で)地溝
overcapacity	設備過剰|生産能力過剰
mudslide	土砂崩れ
fidgety	落ち着かない|せかせか(そわそわ)している|(細かいことにうるさく)気難しい
barroom	酒場
intriguingly	興味深いことに
vitrify	〜‘を'ガラス[状]にする|ガラス[状]になる
recordist	(特に映画の)録音係
orientalist	東洋学者|東洋に通じた人
sophistry	詭弁(を弄すること)
quoin	(建物の外壁の)かど;(そのかどを造る)すみ石|くさび石|くさび;くさび型の物
durbar	(インド土侯・旧インド総督の)公式会見|謁見
brazenly	厚かましく
catechol	カテコール|フェノール類の有機化合物|ウルシオール(漆の主成分)|カテキンなどのポリフェノールほか多くの生体物質の骨格に含まれる
earwax	耳あか|耳くそ
fractious	怒りっぽい|気むずかしい|手に負えない|面倒を起こす
conformable	一致した|適合した;(慣例・規範などに)準拠した《+『to』+『名』》|従順な;(〜に)よく従う《+『to』+『名』》
toothy	歯を見せる
cheesecloth	チーズを作るときに用いる目のあらい綿布
hemline	裾の線 (hemはヘリ)
gallantly	優しく|勇敢に|雄々しく|慇懃に
ectoderm	外胚葉
bended	曲がった
confidante	confidant(親友)の女性形
watchband	腕時計のバンド
untiring	疲れない|疲れを知らない|たゆまない|不屈の
brer	=brother
unionize	労働組合を組織する|労働組合に加入する|を合体させる|統一する
numberless	(比較変化なし)《おもに文》無数の|数えきれない|番号のない
intemperance	不節制;暴飲[暴食]
submergence	水中に沈めること|水没|浸水
fuller	円型溝づけ器|丸溝|縮充工|洗い張り屋|に丸溝をつける
numeration	数えること|計算|数え方|計算法
interleague	インターリーグ|スポーツでの交流戦の意
forgivable	許してよい
peevish	気難しい|怒りっぽい|不平を言う
greaser	(機械に)油を差す人|《俗》《軽べつして》ラテンアメリカ人|(特に)メキシコ人
splashdown	(宇宙船の)着水
facing	上塗り|向く
multiform	多くの形態を持っている;多様な
locknut	ゆるみ止めナット
nonfood	食料品以外の商品
flattop	=crew-cut|《まれ》航空母艦
indelibly	消えないように|永久に
aphelion	遠日点(月・遊星が太陽から最も離れる点)
expositor	説明者|解説者
ashy	灰の(ような)|灰まみれの|灰色の|蒼白な
goner	死者|死に体|落ちぶれた人|見込みのない人
submersion	=submergence
signifier	意味されているもの|表されているもの
picaresque	悪漢を題材とした
gourmand	大食家|美食家|食道楽|食通
slavish	独創性のない|卑屈な|卑劣な|奴隷の|奴隷のような|すっかり模倣する
awestruck	打たれた
felicitous	適切な|ぴったりの|うまい|表現の巧みな|幸運な
caravel	キャラベル(15-16世紀の軽快な帆船)
carboy	カーボイ|大きなガラス製の酒入れ|箱入り大型ガラスビン
necromancy	交霊による占い|いかがわしい魔術
plaudit	拍手かっさい|賞賛|拍手|喝采
benefice	(牧仕|特にvicar|rectorの)聖職禄;受禄職者の地位
trilobite	三葉虫(甲殻類に属する最古の化石動物)
marginalia	《複数形》(本の)欄外の注|傍注
jackdaw	=daw
snood	(女性が後ろの髪を束ねる)ヘアネット;ヘアネット式の帽子
hardboiled	(卵など)堅ゆでの|(人が)非情な|冷酷な;(物の見方などが)現実的な|ちゃっかりした;(文学の作風が)非情派の|ハードボイル派の
billow	大きく波うつ|大波|大きなうねり|もくもく|煙が上がる様子
cleft	裂け目|分裂|cleaveの過去･過去分詞|裂けた|割った
osseous	骨の|骨に似た
honorific	敬語
underhand	(野球などで)下手投げの|秘密の|ずるい|下手投げで|こそこそとずるく|陰険に
idolatrous	偶像崇拝の|偶像崇拝的|心酔する
translatable	翻訳可能な|言い換えられる
tradespeople	小売商人
polytheism	多神教;多神論・反対語の「一神教」は「monotheism」
ethnological	民族学[上]の
quitclaim	(不動産などの)権利放棄|〈財産・権利などの要求〉‘を'放棄する
stovepipe	ストーブの煙突
angsty	怒りを感じ|表示したりすること
cytokeratin	サイトケラチン|上皮性細胞の細胞骨格を成す蛋白群の総称
poultice	湿布|パップ
bombast	大言壮語|豪語|誇張
catbird	ネコマネドリ(北米産のツグミの一種)
hassock	(お祈りのときに使う)ひざ布団|草むら(tussock)
deregulate	規制を解除する
impulsively	衝動的に
giggly	クスクス笑う
tusker	(きばのある)象
gamekeeper	(密猟防止・鳥獣保護・飼育などのための)猟場管理人
cannibalize	(車･機械)分解･解体する|(人の)肉を食う|共食いする
milch	乳を出す
katydid	キリギリス科の昆虫の一種(米国産)
nonfunctional	機能しない
tortoiseshell	〈U〉べっ甲|〈C〉ヒオドシチョウ(タテハチョウの類の一つ)|〈C〉三毛ネコ
pedicle	=pedicel
temerity	向こう見ず|無鉄砲
collusive	なれ合いの|共謀の
ricer	ライサー(ゆでたジャガイモなどをつぶす台所用具)
adventitious	偶然の
horehound	ニガハッカ(ヨーロッパ原産のシソ科の多年草;苦い薬用の液が出る)|ハッカで風味をつけた薬(砂糖菓子)
fleecy	羊毛でできた;羊毛でおおわれた|羊毛のような
bigamy	二重結婚|重婚
impoverish	貧弱にする|貧乏にする|を貧しくする|低下させる
unanswerable	答えられない|反論できない|責任のない
holism	全体論(全体はその構成部分の総和よりも価値があるという哲学理論)
seaborne	海上[輸送]の
desiccate	〜‘を'からからに乾燥させる
forevermore	常に|絶えず
miserly	けちな|欲深い
troth	忠実|誠実|真実
contemptuously	見下げるように|軽蔑して
mercaptoethanol	メルカプトエタノール|劇物取締法による毒物|引火性で炎や酸化剤などに接触すると発火する|還元剤として働く
ideologue	イデオロギーの信奉者|空論家|夢想家
ironmonger	《英》鉄器商|金物屋
impugn	非難する|論難する|異議を唱える|反駁する|疑いを差し挟む
antipodean	(にとって)対蹠地の|(と)正反対の(to)
catchall	種々雑多なもの(がらくた)をなんでも含む(収める)もの|広範囲の
blase	歓楽に飽きた|無関心な|世慣れた
stamen	おしべ|雄ずい 
dissenter	反対者|国教反対者|非国教徒(Nonconformist)
pornographer	ポルノ製作者
metallurgist	冶金学者|冶金技術者
twitchy	引きつった
tangentially	接線方向に
malocclusion	不正咬合(こうごう)(歯がうまくかみ合わないこと)
imperishable	不滅の|不朽の
insolation	日光にさらすこと|日光浴|日謝病
fixate	固定する|定着する|凝視する|固定させる|定着させる
famish	〜‘を'飢えさせる|飢える
separateness	別々になっていること|分離
deponent	(法廷における)宣誓証人
ulna	(人の腕|動物の前肢の)尺骨
generalizability	一般化可能性
blackhead	上部が黒いにきび(吹出物)
expropriate	(特に|公共の用にあてるため|個人・企業から)〈私有財産〉‘を'没収する|〈人〉‘から'(財産を)没収する《+『名』〈人〉+『from』+『名』》
civet	ジャコウねこ(civet cat)から採る香料
tollgate	通行料金徴収所
transept	翼廊|(十字形教会堂の)左右に直角に張り出す部分|トランセプト
dispensable	無くてもすむ
plink	(銃などで練習･遊びとしてを)撃つ|(楽器などを)ポロン･ペンと弾く|(チリン･リンなど)軽く響く音を断続的に立てる
abstruse	難解な|難しい|深遠な
embryonal	胎生の|胚性の|胚
shakeout	急反落|暴落
televangelist	テレビ伝道師
succour	=succor
telekinesis	念動[作用](外力を加えず念力で物を動かす)
forsythia	レンギョウ|早春に黄色い花を鈴なりに付ける低木
protean	Proteusプロテウス(ギリシア神話|変幻自在の海神|)の(ような)|変幻自在な|多方面の
carpel	(花の)心皮(生長して果皮となり|そこに実がなる)
stoat	貂|テン|イタチ(夏に毛が褐色)
spirt	=spurt
bulrush	《米》フトイ|《英》ガマ(水辺・沼にはえる植物)
contiguity	広がり|接近|接触|隣接|隣接性|連続
cattleman	牛飼い|牧場主
alphabetize	〜'を'アルファベット順に並べる|〜'を'アルファベットで表す
grounder	簡単に解決できる殺人事件|(野球)ゴロ(= ground ball)
strew	をばらまく
trachoma	トラコーマ|トラホーム(眼の伝染病)
verdure	(草木の)新緑|緑の草木
exclusiveness	排他[性]|独占
misapplication	誤用|乱用
bosun	=boatswain
spinney	雑木林|木立
etiological	因果関係の(ある)|病因の|因果関係学の
mummification	ミイラ化
passbook	銀行通帳(bankbook)
murk	真暗やみ|暗黒
hullo	やあ
butterfat	牛乳の脂肪
firkin	(バター・ラードなどを入れる)小型の桶(おけ)|ファーキン(英国の容量単位|1|4barrelに相当)
coxswain	(競漕用ボートの)舵(だ)手|かじ取り|艇長
spat	ささいなけんか|いさかいをする|spit(つばや悪口を吐く)の過去分詞
misquote	誤って引用する
protestor	抗議者
baleful	有害な|不吉な|悲惨な|元気のない|悪意に満ちた
chafer	コガネムシ
volitional	意志の|意志に関する|意志に基づく
jerkin	(16‐17世紀ごろ男子が用いた)袖無しの上着
foist	(偽物など)を人につかませる|押しつける|そっと挿入する|偽って～の作だとする
theodolite	経緯儀(鉛直角・水平角を測定するのに使う器械)
alar	翼のある;翼の形をした
workfare	勤労福祉制度
glottal	(のどにある)声門の
pachyderm	(pˈækɪd`ɚːm)厚皮動物(カバ･ゾウ･サイなど)|鈍感な人
irrationally	非合理的に
slake	満足させる|を和らげる|を満たす|を晴らす|を消す
unalterable	変えられない|不変の
jetport	ジェット機用空港
sandblast	砂吹き(噴砂機でガラスや金属を切磨すること)
inexpressible	言い表せない
mercuric	(特に)第二水銀の(を含んだ)
inrush	突入|侵入，来襲・流入，殺到 〔of〕
purslane	スベリヒユ(サラダなどに入れて食べる雑草)
pettitte	(仏語)ペティット(小柄な|小さい)
wantonly	きまぐれに|きままに|浮気に
squeezer	圧搾器|(レモンなどの)絞り器|搾取者
samovar	サモワール(おもにロシアで用いられているお茶用の湯沸かし器)
indoctrinate	に教え込む|吹き込む
beheading	断頭
footstep	足音
acrimony	(言葉･気質など)辛辣さ|とげとげしさ|厳しさ
bristly	剛毛の
lockjaw	=tetanus
deaden	弱める|鈍らせる|消す
conciliate	〈人〉'を'なだめる|懐柔する;〈人〉‘の'好意を得る
soever	《who|what|whereなどと連結して》どんな〜でも|たとえどのように〜とも|《否定語を強調して》全然[〜でない]
tracing	さかのぼる|透写|追跡|捜索|複写
ruefully	残念そう
slothful	不精な
hallucinogen	幻覚剤
tomfoolery	ばかなまね
ruthlessness	無慈悲
gnash	歯ぎしり(する)
unglued	取り乱した;狂気の
pompadour	ポンパドゥール(男性のオールバック|または女性の前髪をなで上げて後ろで束ねた髪型)
reassuringly	安心させるように|はげみになるように
pisum	エンドウマメ|別名グリンピース|サヤエンドウ
preclusion	防止|妨害
grownup	『成長した』|成人した|『おとならしい』|おとなに適した|『おとな』
engram	エングラム(経験によって生ずる神経系細胞内の構造別化)|(記憶の)痕跡|印象
snaffle	(馬の)はみ|小勒(しょうろく)
miscible	混和できる
coif	頭布(ずきん)(騎士がかぶとの下に修道女がベールの下につける)|=coiffure
parachutist	落下傘で降りる人|落下傘兵
calorific	熱の|熱を生じる
fief	(封建時代の)領土|封土
estrous	発情期の
osteoblast	骨芽細胞
electroshock	電気ショック療法
shakeup	(事業・政治上の)大異動|大刷新
stopgap	当座しのぎ|穴ふさぎ|間に合わせの
phosphorescent	リン光性の;青光りする
inchoate	始まったばかりの|初期の|不完全な|未完成の|組織化されていない|形の定まらない
surtax	所得税|付加税
anechoic	(録音室・スタジオなどが)反響のない|無響の
scatterplot	散布図
foundling	拾い子|捨て子
illiberal	心の狭い|狭量の|物惜しみする|けちな
lento	(音楽が)おそい|ゆっくりした|ゆっくりと[演奏して]
voyeuristic	(vwὰːjɚ(ː)rístɪk)覗き見の|覗き見趣味の
stationer	文房具商
albinism	先天性白色症|白子
onlooker	傍観者|観客|見物人
firebrick	耐火れんが
deathless	不死の|不滅の(immortal)
garbanzo	=chickpea
tarsal	足首の|足根骨
debase	の品性を落とす|の品質を低下させる
coactivator	コアクチベーター(共に活性化する要素)
deice	〈飛行機・自動車・冷蔵庫など〉‘の'結氷(結霜)を取り去る|結氷(結霜)を防ぐ
treadle	(ミシンなどの)踏み子|ペダル|踏み子(ペダル)を踏む
hearthside	炉ばた
scummy	浮きかすの多い|下等な
gateau	クリームケーキの一種
chiaroscuro	(イタリア語)キアロスクーロ|白と黒のスケッチ (light and dark)
gimmicky	見てくればかりの|からくりで人目を引く
propulsive	推進力のある|推進する
ensnare	(人･動物を)わなに掛ける|誘惑する
bellicose	好戦的な|敵意に満ちた|けんか早い|けんか好きな
hypogonadism	性腺機能低下症
undergird	〜‘に'しっかりした基礎を与える|‘を'強化する
nonsectarian	特定の宗派に属さない|無宗派の
hydrophone	水中聴音器;(医学用の)通水聴診器
megalomaniac	誇大妄想狂
tipple	(恒常的に)酒を飲む|アルコール飲料
abscissa	横座標
freckle	そばかす
allergist	アレルギー性疾患専門医
tansy	〈C〉コモギギク[属](小さな黄色い花の房をつける)|〈U〉(薬用・食用の)ヨモギギクの汁
congruency	=congruence
flab	ぶよぶよ|ぜい肉
paroxysm	発作(sudden attack)|けいれん(spasm)|ひきつけ(fit)
ouzo	ウーゾ|ブランデーにアニス(地中海産のセリ)の香りをつけたギリシアの無色のリキュール
liveliness	元気のあること;陽気|鮮やかさ
godson	洗礼で教父母が名づけた息子|Cf|godchild(〃幼児)
toddle	よちよち歩く|赤ちゃんの歩く様子|toddlerヨチヨチ歩きの赤ちゃん
adjectival	形容詞的語句|形容詞の･を作る
feckless	無効な|無能な|役に立たない
stereophonic	ステレオの|立体音響(効果)の
hoedown	(スクエアダンスを中心にした)地域ぐるみのダンスパーティー
circumnavigate	周航する
niggle	めんどうな
likeminded	同じ心(意見|趣味)をもった
deckchair	甲板いす
artificer	技術者|(船の機関室の)技術兵
funicular	ケーブルカー|鋼索鉄道|ロープによる|ロープの|索状の|珠柄の|吊り重り作用の
medulloblastoma	髄芽腫
clapboard	かちんこ|羽目板|に下見板を張る
stirring	感動的な|活発な|多忙な
gluconeogenesis	糖新生(とうしんせい|gluconeogenesis)|飢餓状態に陥った動物が|乳酸|プロピオン酸|グリセロールなどの糖質以外の物質からグルコースを生産する経路
pipedream	非現実的な(夢のような)考え(話|計画)・夢想
stepmom	継母
indolence	怠惰|なまけ
comedienne	喜劇女優|女性コメディアン
profundity	深遠
dewdrop	露のしずく|露の玉
turgid	腫れ上がった|大げさな
exigency	緊急性|危急|緊急事態|急場|急迫(した事情)|切迫
muchly	大いに
catchword	欄外見出し語|スローガン
vivarium	生態動物園(動物が自然に近い状態で飼育されている)
interlinear	(本の)行間にある|行間に書き入れた
unenviable	あまりうらやましくない|あまり欲しくない
antinuclear	原子力開発に反対の|反原子力主義
unfeeling	無感覚の|無情な|冷酷な(cruel)
catatonia	緊張[型分裂]病(筋肉硬直や精神混迷を伴う)
enunciate	発音する|明確に系統立てて説く|宣言する|公表する
evaluable	評価が可能な
flapjack	ホットケーキ|クッキー|揚げパン
revolutionist	革命家;革命論者
irascible	怒りっぽい|かんしゃく持ちの|短気な|怒った|(人･性質など)おこりっぽい
jackknife	(また『clasp knife』)ジャックナイフ(刃のたためる大型のポケットナイフ)|えび型飛込み|ジャックナイフダイブ|(トラクター・トレーラーなどが)まん中でVの字に折れ曲がる
blare	鳴り響く|耳障りな響き
denude	〜‘を'裸にする;(物を)〈人・物〉‘から'はぎ取る《+『名』+『of』+『名』》
misreport	《しばしば受動態で》〜‘を'虚報を伝える|‘を'誤って報告する
roadwork	ロードワーク(長距離ランニングによる体力作り)
seminarian	神学校の学生|神学生|(神学校出身の)聖職者
stele	(文字や模様を彫刻した考古学上の)石柱|石碑
jowl	顎(特に下顎)
dreck	安物
incorporeal	体のない|無形の|霊的な
gherkin	(酢づけにする)小キュウリ
crape	クレープ|クレープの喪章|ちりめん|縮らせる|crape myrtle百日紅(サルスベリ)
mouldy	=moldy
softie	気が弱い人|人の言いなりになる人
hydroplane	水上滑走艇|水上飛行機(seaplane)
teatime	(午後の)お茶の時間
woodenware	木製台所用品(木ざら・木さじなど)
pushover	くみしやすい相手|カモ
breathy	気息音の交じる|息遣いが聞こえる
hysteric	=hysterical|《複数形で》ヒステリーの発作|〈C〉ヒステリー患者
exultation	(〜での)大きな喜び《+『at』+『名』》(〜に対する)勝ち誇った気持ち《+『over』+『名』》
selfsame	全く同一の
glaucous	《文》淡い青緑色の|(ぶどうなど)白い粉の吹いた|白色を帯びた
soberly	真面目に|冷静に|酔わないで
pulverize	(議論などを)粉砕する|粉にする|粉々に砕く|液体を霧状にする
knobby	でこぼこの|こぶだらけの
schmaltz	過度の感傷主義|感傷性
fetid	強い悪臭を放つ|臭い
singleness	単独;独身|専念|専心
kaput	やられて|だめになって|ぶちこわされて
tailspin	きりもみ降下(落下)|(経済的)混乱|狼狽|動揺
blackface	黒綿羊(くろめんよう)|黒人に扮した役者|肉太活字(の)
indefiniteness	不確定|不定
windsock	(風向表示用の)吹き流し(空港などに設置される筒状の布製風見)
yearning	切望している|あこがれる|あこがれ|同情
unquiet	平静でない|落着きのない|不安な
herbage	草|(特に)牧草|(草の)葉と茎
twaddle	無駄口
running	走ること|走力|経営|管理|運転|走る|現行の|広まっている|(植物が)つる性の
chanterelle	アンズタケ(黄色の食用キノコ)
unutterable	言いようのない|言語に絶する|発音できない
beefeater	ロンドン塔の守衛|英国王の護衛兵(yeoman of the [English royal] guard)|牛肉を食べる人
inelegant	優美でない
shoehorn	靴べら|詰め込む|押し込む|(何かにフィットするように)合わせる
veep	(vice presidentの頭の文字から)副大統領
poppycock	ばかげた話|たわごと
nebular	星雲の;星雲状の
taciturn	口数が少ない
translocase	トランスロカーゼ(酵素)|転位酵素
eutrophic	(湖が)富栄養の|(動植物の)栄養物が豊かな
laterality	左右差
superpose	(〜の上に)〜‘を'重ねて置く《+名+on(upon)+名》|(幾何で)〈図形〉‘を'重ね合わせる
betrothal	婚約
nippy	(幼児語)おしゃぶり(=pacifier)|すばしこい|厳しい
trimaran	三胴船
boorish	百姓風の|野卑な|無骨な|無粋な
crampon	つかみ金(氷・材木・石などの重い物をつかむ)|《複数形で》(また『climbing irons』)アイゼン|鉄かんじき
glaciology	氷河学
millpond	(水車用)貯水池|水車池
gullibility	だまされやすいこと
densitometer	(写真現像の)濃度計
barmy	愚かな|少し気が変な(《米》balmy)
unclog	〜‘から'障害を除く|‘の'じゃまをなくす
microtiter	マイクロタイター
ignoramus	無学な人
melancholia	憂うつ病|憂鬱病
pilothouse	(船の)操舵(そうだ)室
microinjection	マイクロインジェクション(微小噴射)
ramification	事態の波及|なりゆき
skitter	水面すれすれに飛ぶ|速やかに進む|流し釣りをする
incarcerate	幽閉する|監禁する|閉じ込める
keratinocyte	ケラチノサイト|角質細胞|ケラチン生成細胞|角化細胞|ケラチン細胞
mordant	辛らつな|皮肉な|刺すように鋭い|ヒリヒリする|色止め料|粘着剤|腐食剤で処理する
computerize	コンピュータ化する
torturer	苦しめる人|拷問にかける人|拷問者
somnolence	傾眠(始終眠気を催す状態)
diatomic	(1分子中に)2原子の(を含む)
pharmacologist	薬理学者|薬物学者
pinstriped	極細縞の|(極細縞の服を着る)実業家|弁護士|銀行家の|金持の
kittiwake	ミツユビカモメ(長い翼を持つ鳥)
mafioso	マフィアの一員
dormouse	ヤマネ(リスに似たネズミで冬眠する)
smidgen	ほんの少し|ごくわずか(の量)|ごく少量|みじん|非常に小さなもの|非常に小柄な人
bunion	腱膜瘤(足の親指の内側にできるはれ物)
snobbish	俗物の
haymaker	干し草を作る人(機械)|《米話》強烈な一撃
anodyne	鎮痛薬
cultic	熱狂的な|狂信的な
intension	(精神の)緊張|努力|強度|激しさ|猛烈さ
merchantable	販売用の|売り物になる
dearie	deary|かわいい人|(ねえ)あなた|darling|dear
cloaca	下水|便所
comeuppance	当然の罰(報い)
doyen	(団体などの)古参者|長老|大御所
disbar	〜‘の'弁護士の資格をはく奪する
wive	〜‘を'めとる|妻帯する
finny	漁の|魚がたくさんいる|ひれのような|ひれのある
hyperopia	遠視
jazzercise	ジャザサイズ(ダンスのフィットネスプログラム)
ultramodern	超近代的な
conjectural	憶測上の
rumination	反芻|沈思|黙考
auscultation	聴診
hydrosphere	(地球の)水圏|(大気中の)水気
raconteur	話しじょうず
stopcock	コックのせん(turncock)
misogynist	女嫌いの人
spiff	きちんとした(気の利いた)ものにする|めかす(up)
pieta	ピエロ(キリストの遺体をひざにだいて嘆く聖母マリアの絵や像)
idler	怠け者|なまけ者|役立たず
quintuple	5倍の|5重の;5部(5人)からなる|5倍|5倍の量(数)|5倍になる|〜‘を'5倍にする
castigate	厳しく罰する|きびしく非難する|添削する
compulsorily	強制的に|義務的に
packhorse	(荷物を運搬する)駄馬(だば)
effusive	感情むき出しの
sapsucker	シルスイキツツキ(くちばしで穴をあけ樹液を吸うキツツキ)
yearend	年末の
dutiable	(輸入品などが)関税を課せられる|有税の
cubical	=cubic1
supernumerary	規定数以上の|定員外の|(せりふのない)端役(人)
loden	ローデン(オーバーコートなどに用いる厚い防水布地)
duplicitous	二枚舌の|不誠実な|いかさまの
flintlock	(昔の銃の)火打ち石式発火装置|火打ち石銃
cissy	=sissy
catacomb	地下墓地
atonal	(音楽)無調の|調子のない
ploidy	倍数性
teleplay	テレビドラマ
audiometer	聴力測定器
anteriorly	前方に
spendthrift	金使いの荒い人|金使いの荒い
dateless	終りのない|年代の分からない
standee	(劇場・汽車・バスなどで席がなく)立っている人
handwork	手製|手細工
pedicel	小花柄|小花梗(こう)(大きい花柄から分れて一つの花をつけている小さい花柄)|(昆虫や海洋生物の)柄|肉茎
poach	密猟する|他人の土地などに侵入する|(人の考えなどを)不正手段で盗む|(卵を)割って熱湯の中でゆでる|(魚などを)ゆでる
proscenium	プロセニアム|前舞台|幕の前部|前景
muckraker	醜聞をあさる人|不正追及･摘発者
armyworm	ヨトウムシ(夜盗蛾の幼虫;農作物害虫)
polarize	対立する|二極間に分かれる|極性をもつ
cantabile	(演奏の指示で)カンタービレ|歌うような調子の(で)|カンタービレの曲
mollify	和らげる|軽減する
tablespoonful	(〜の)大さじ1杯[分](小さじ3杯分)《+of+名》
gasworks	ガス工場|ガス製造所
valueless	価値のない|つまらない
imperceptibly	気付かれないほどに|いつのまにか
whish	ピュー(スー)という音|ピュー(スー)と鳴る(動く)
spirochete	スピロヘータ|らせん状の形態をしたグラム陰性の真正細菌の一グループ|(Spiro=らせん状の)
brilliancy	=brilliance
tike	tyke
traitorous	反逆的|裏切りの
sandlot	(一般の人が楽しむ)スポーツ用の砂地|スポーツの|アマチュアスポーツの
tetralogy	四徴 (病気の特徴を示す4種類の徴候)|四幕|オペラ|小説などの四幕構成
mattock	根掘りぐわ(一種のつるはし)
kerchief	ネッカチーフ(neckerchief)|ハンカチ(handkerchief)
matriculate	(試験の結果によって)〈人〉‘に'大学の入学を許す|(大学に)入学資格を得るための試験を受ける《+『at』(『in』)+『名』》
scorekeeper	(競技などの)公式記録員|スコアラー
greenhorn	経験のない|初心者|だまされやすい人
highlife	《しばしばthe~》上流社会の生活|西アフリカの強烈なリズムの踊り
roadbed	(鉄道の)路盤;(道路の)路床
remunerative	引き合う|益になる
intricacy	複雑
pendulous	ぶら下がっている
moneymaking	金がもうかる|金もうけのできる|金もうけ
mourner	哀悼者|会葬者|ざんげ者
backstabbing	陰で中傷する行為
inconsiderable	重要でない|取るに足りない|ささいな
bricklaying	れんが積み[の仕事]
sallow	(皮膚などが)黄ばんだ|血色の悪い|土色になる|(植物)サルヤナギ
allmusic	音楽ガイド
polygamist	一夫多妻者|一妻多夫者
thiosulfate	チオ硫酸塩|チオ硫酸塩は自然に存在する化学物質で|「チオ」は硫酸イオンの酸素原子が硫黄原子で置換された「S₂O₃²⁻」 を含む塩を示す
sharecropper	小作人
ostentation	見せびらかし|見栄
tetrahymena	テトラヒメナ|水中に生息する繊毛虫で多数の繊毛で運動する|細胞核のうち大核には染色体の末端が多数あり|テロメア研究のモデルに用いられる
stodgy	つまらない|重苦しい|不消化の
bookend	ブックエンド|本立て
wrathful	激怒した
mefloquine	メフロキン(抗マラリア剤|内服する)
glockenspiel	鉄琴|グロッケンシュピール
ghat	ガート|インド|ガンジス川下流のバラナシ市の川へ下る階段状の地形|沐浴する聖なる場所
stickleback	トゲウオ(ひれにとげのある魚)
cockerel	(特に生後1年以内の)若いおんどり
pothead	マリファナ常用者
mummer	無言劇の役者|役者
friendless	友のない
proboscis	(ゾウなどの)鼻|(昆虫などの)吻(ふん)|(口)(人間の)大きい鼻
wholehearted	心を込めた|心からの
fitful	発作的な|変わりやすい
unstressed	(音声が)アクセントのない;強調されない
unquestioning	疑わない;無条件の
aquatint	〈U〉アクアチント(食刻板画法の一種)|〈C〉アクアチント版画
desultory	気まぐれな|とりとめのない|散慢な|とびとびの|脱線的な
pitifully	哀れなほどに|くだらないほど
withe	(柳などの)細枝(まきなどを束ねる材料)
seasickness	船酔い
disincline	嫌気をおこさせる
codicil	遺言書の補足条項;(一般に)補足
puerile	たわいもない|子供の(らしい)
editorially	社説で|編集者として
lubricator	滑らかにする人(もの);潤滑装置|注油器
necrology	(一定期間内の)死亡者名簿;死亡告示
stockyard	(市場などの)家畜置き場
trophoblast	栄養膜
tripos	(英国Cambridge大学の)卒業試験　（Cambridge大学で学位B.A.の）優等試験、優等試験合格者名簿
misspend	使い方を誤る
palaver	おしゃべり|むだ話
balalaika	バラライカ(ギターに似た3弦のロシアの楽器)
unvarnished	塗装してない|生地のままの
thiazide	チアジド|心臓|肝臓|腎臓病による高血圧や浮腫を治療するために使われる利尿剤
jotter	書き留める人|メモする人|小さな手帳
personify	を擬人化する|体現する|擬人化する|具体化する
clingy	粘着性の|くっついて離れない
sidearm	横手投げの|横手投げで
piddle	(口語)(子供|動物が)おしっこをする|ダラダラ時を過ごす|食べ物をいやいや食べる
statecraft	国政術|政治的手腕
synthetically	総合して|総合的に;合成的に
woozy	頭がぼんやりして|頭がフラフラする|目まいがして|気分が優れない|気分が悪い|混乱した|酔った|酔っぱらった|不鮮明な
ribcage	胸郭
studiously	注意して|熱心に|慎重に|わざと
kabob	=kebab
pitiable	同情すべき|哀れな|惨めな|いじらしい
hairpiece	ヘアピース|入れ毛;(はげ隠し用の小さい)かつら
neckband	(衣服についたひも・レースの)首飾り
reiteration	繰り返し|反復
mortice	=mortise
indiscreet	無分別な
shoelace	靴ひも
pedantry	ペダントリー|衒学趣味(げんがく|知識をひけらかす|自慢すること)
hitchhike	ヒッチハイク
oho	(驚き・嘲笑・喜びなどを表して)おお|ほほう|ふーん
pastorale	牧歌曲|田園曲
helipad	(商業施設のない)ヘリコプター発着場
unbutton	〜‘の'ボタンをはずす
looseness	緩いこと|ばらばらであること;散漫|締まりのなさ
appendectomy	虫垂切除[手術]
neglectful	不注意な
misapprehension	誤解|思い違い
reasoning	推理
ransack	くまなく探す|掻き回す
umpteenth	何度目かの
backcross	戻し交配or戻し交雑|交雑で作った雑種に対し|最初の親のうち片方を再び交配すること|ある特性を別の生物に取り込ませるための品種改良技術の一種
worthily	ふさわしく|立派に
athletically	競技的に|運動家らしく
septet	7人(7個)一組のグループ|七重奏(唱)曲
goofball	間抜け
insomuch	〜の程度まで|...ほどに (as|that)・ 〜の故に (as)
expensively	費用をかけて|高価に
salivation	つばを出すこと;だ液分泌過多|流涎(りゅうぜん)
macromolecule	高分子
mesenchyme	間葉または間充組織と呼ぶ|胚の胚葉から派生した結合組織|内胚葉･外胚葉の間に生じる
scruple	良心のとがめ|気がとがめる
boozy	酔っぱらって|大酒を飲む|大酒飲みの
coolie	苦力|日雇い労働者
communalism	地方自治主義|地方分権主義
benzoin	安息香(香水・化粧品に用いられる)
unripe	(果実などが)未熟の|(時機などが)早すぎる;(人が)未発達の
throaty	しわがれ声の
shipmate	(同じ船の)船員仲間
compartmentalization	区画化
secularist	俗主義者|教育(政治)宗教分離論者|世俗(現世)主義の
seagoing	(またocean-going)遠洋航海用の|=seafaring
cleanness	清潔|潔白;清浄
unmolested	悩まされない|煩わされない|平穏な
adjoin	に隣接する
xeric	乾燥した|湿度の低い
chemoattractant	化学誘引物質
redolent	芳香のある|においが強くて
impudence	〈U〉厚かましさ|無遠慮;(〜する)厚かましさ《+『to』 do》|〈C〉無遠慮な言葉(行為)
polyclinic	総合病院診療所
dairyman	酪農場で働く男|酪農場主(経営者)|酪農製品販売者|牛乳屋
mariculture	海水魚人工養殖
firebomb	焼夷弾|火炎ビン|発火物|焼夷弾(火炎ビン･発火物)を投げ込む
generalizable	一般化
daydreamer	空想家|夢想家
mukluk	マクラク(エスキモーのはくアザラシやトナカイの皮で作った長靴)
weakling	弱虫の|虚弱者|弱虫|弱い
misanthropic	厭世的な
trophoblastic	絨毛(性の)|栄養膜の
primp	きちんと着飾る|めかす|整える|着こなす|着飾る
tremulous	震えるような|震えた|震える|おののく|わななく|揺れる|振動する|臆病な
plosive	(音声で)破裂音([p]|[b]|[t]など)|破裂音の
menarche	初潮
carmaker	自動車メーカー
localism	地方偏狭主義|(地方独特の)話し方
leftie	(=lefty)|左利き(の人)|左腕投手|左派の人|左翼|左手の
whelm	〜‘を'水中に沈める|〜‘を'圧倒する
sclera	鞏膜(きょうまく)(角膜とともに眼球をおおっている堅くて白い膜)
cosmogony	宇宙成因論|宇宙生成論(宇宙の起源・生成などを扱う天文学の一部門)|宇宙創造説(宇宙の起源・生成に関する学説・物語)
invulnerability	傷つけられないこと|不死身|破られないこと|論破されないこと
manliness	男らしさ|りりしさ
textually	テキストで
trainable	訓練(教育)ができる|訓練のしがいのある
mammographic	マンモグラフィー(乳房X線検査)の
townscape	都会風景[画];都市造景[案]
derisive	嘲笑的な|笑うべき|嘲笑に値する
ascription	(〜の原因などを〜に)帰すること|(〜を〜の)せいにすること《+『of』+『名』+『to』+『名』》
equipage	〈C〉馬車と従者の一団|〈U〉(軍隊・キャンプ用の)装備一式;《古》(一般に)一そろいの物
bailiwick	執行吏bailieの管轄区|活動分野|得意ななわばり|(接尾辞-wickは村|部落の意を表す)
tamarisk	ギョリュウ(御柳)(地中海原産の低木でピンクの花をつける)
revile	(rɪvάɪl)悪口を言う|ののしる
americium	アメリシウム(人工放射性元素;化学記号Am)
uncontroversial	異論
upcountry	内陸の|奥地の(から来た)|内陸に(で)|奥地へ(で)
commandeer	徴発する|徴用する|奪いとる
windpipe	気管|のど笛(trachea)
guiltless	罪のない|潔白な
withholding	差し控え
burning	燃える
resampled	リサンプリングされた
intercostal	肋間の
cecum	盲腸
garnishee	〈金・財産〉‘を'差し押さえる|〈人〉‘に'債権差し押さえ通告をする
hallucinatory	幻覚の|幻覚的な
devilishly	極悪に|《話》ひどく|はなはだしく
firewater	火酒|(ウイスキー|ジン|ラム酒などの)強い酒
amuck	アモク 《急に興奮して殺人を犯す精神障害; 元来マレー人特有のものとされた》|殺気立って[た]; 怒り狂って[た].
housebound	家に縛られた|外出の時間のない
propound	を提出する
dalliance	戯れ|ふざけ|いちゃつき
phrenology	骨相学|フレノロジー
connivance	(悪事を)見逃すこと|黙認《+『at』(『in』)+『名』》
tizzy	興奮;身震い
tearjerker	お涙頂戴もの|感傷的な映画|涙を誘う|泣ける|感傷的な
miscreant	悪党|極悪な|邪悪な
radome	レーダーアンテナ収納ドーム
adipocyte	含脂肪細胞
thirtysomething	30代に見える|30代の
shatterproof	(ガラスなどが)粉々にならない|破砕防止の
uncertainly	曖昧に|はっきりしないで
wellborn	家柄(生まれ)のよい
endothermic	吸熱の|吸熱を伴う
misidentify	を誤認する
moussaka	ムサカ(肉とナスを材料にしたギリシア料理)
circumnavigation	周航｛しゅうこう｝;世界一周
grandly	雄大に
fictive	創作力のある|《まれ》=fictitious
purulent	化膿した|うみの出る
friary	(托鉢(たくはつ)修道士の)修道院
surfeit	を過度に食べさせる|食べすぎる|飽き飽きする|過度の|氾濫|洪水
ecclesiastic	(キリスト教の)聖職者|牧師|=ecclesiastical
ignominious	不面目な|不名誉な|恥ずべき|卑しむべき|屈辱的な
unfamiliarity	精通していないこと
fangirl	ファンの女の子
detente	(国際関係の)緊張緩和|デタント
ungainly	ぶかっこうな|見苦しい|ぶざまな
mimesis	(修辞上の技法としての)模写|模倣
bauble	つまらないもの|安ピカもの|子供の玩具|子供じみたこと
carborundum	炭化ケイ素(炭素から作る硬い物質で|研磨剤;商標名)
plagiarist	盗作者
seaworthy	航海に適する
retch	むかつく
aniseed	アニス(セリ科の一年草|地中海原産)の種のような果実をアニシードと呼び|香辛料とする
fantail	扇形の尾(部分)|クジャクバト(扇形の尾を持つハト)
skp	拡張子の一種
odorous	かんばしい
indefinable	定義できない
cedilla	セディラ(のように|フランス語などでcが[s]音になる符号.çの下部の符号)
ironical	皮肉っぽい
inkblot	インクのしみ
functionary	職員|役人
squiggly	よじれた|くねくね曲がった
hornbeam	〈C〉北米産のシデ属の樹木|〈U〉シデの木材
denigration	侮蔑|名誉毀損|汚すこと
magnanimity	雅量|腹の太いこと
samarium	サマリウム(銀色の希土類元素;化学記号は『Sm』)
pyrometer	高温計(高温を測定する温度計)
pouty	ふくれた|すぐふくれる
dexterous	器用な|巧妙な|機敏な|利口な|才覚のある|抜け目のない
bather	泳ぐ人|水浴びをする人|水着
seropositivity	血清反応陽性
groundskeeper	グラウンドの管理人
snit	イライラ|苛立ち|くだらん奴興奮|癇(かん)に障(さわ)る奴
metabolically	代謝的に
undignified	威厳のない|品位のない
confab	談笑|会談(する)
creeped	(女性が男性に対し)気味が悪い感じ|這い回るような
aneuploidy	異数性 
bioterrorist	生物テロリスト
blockhouse	丸太・角材造りの防塞(ぼうさい)(銃眼があり|真下が射撃できるように2階の部分が1階より突き出している)|小要塞|角材造りの小屋|ブロックハウス(ロケット発射台の近くにある観測・制御者が待機するコンクリートの建物)
virologist	ウィルス学者
urbanity	〈U〉都会ふう;洗練;礼儀正しさ|〈C〉《複数形で》礼儀正しい作法(ふるまい)
victimize	を犠牲にする|苦しめる
lecherous	(男が)好色な|淫乱な|みだらな
osteoclast	破骨細胞|骨のリモデリング(再構築)において骨を破壊(骨吸収)する役割を担う細胞
lawgiver	《文》立法者|法律制定者
triangulate	三角の|三角形から成る|三角模様のある
snowbound	雪に閉じ込められた
medevac	(戦場の)負傷者救出用ヘリコプター
pleasingly	楽しく
easterner	東部地方の人
packaging	荷造り|包装
feasibly	実行できるように|うまくいくように
dockage	〈C〉ドック使用料|〈U〉ドック設備
titrate	量を定める|滴定する
piker	けちな人|スポーツの下手な人|臆病者|詐欺師|野生の雄牛
folklorist	民俗学者
lightheaded	(酒で)頭がくらくらする|気の変わりやすい|軽率な
matzo	マツォー|種なしパン
fungible	代替可能の|(金銭･穀物など)代替可能なもの|代替物
sapwood	(木材の)辺材，白太(しらた) 《心材を囲む，樹液に富む白色の材部》・白木質
pegmatite	巨晶花崗岩|文象花崗岩(断面に文字模様のついたもの)
cicerone	名所案内人|ガイド
microenvironment	微環境
subhuman	人間以下の|(人間よりは)動物に近い|人間に近い|類人の
restlessly	落ちつきなく|休みなく
earful	小言|説教
oaken	オーク材製の
laughably	ばかばかしいほど
sugarless	糖分のない
fogey	=forgy
catamount	ネコ科の野獣;オオヤマネコ|アメリカライオンなど
slushy	雪解けの|ぬかるみの|くだらない;感傷的な
smolder	くすぶる|煙|くすぶり|くすぶる火
tracheotomy	気管切開術
inadvisable	勧められない;賢明できない|当を得ない
voltaic	(化学作用によって生じた)電流の|(化学作用によって)電流を生じる
maraschino	マラスキーノ|マラスカチェリーの果汁を発酵させ蒸留して造った無色甘口リキュール
trafficker	(悪徳)商人|(麻薬などの)密売人
hygroscopic	湿りやすい;吸湿性の
multifarious	多種多様の|さまざまの
songstress	(特に流行歌を歌う)女性歌手
wrack	波に打ち上げられた海草|難破船|漂着物
polecat	ケナガイタチ(ヨーロッパ産の肉食動物;攻撃されると悪臭のある液体を出す)|《米話》スカンク(skunk)(北米産)
putsch	(pˈʊtʃ)反乱|暴動|一揆
vividness	鮮明|明りょう|生気|はつらつ
beatitude	至福
depilatory	脱毛力のある|(液状またはクリーム状の)脱毛剤
snakehead	雷魚|スネークヘッド
neuroscientist	神経科学者
decriminalize	免罪する|従来犯罪とされていた行為を合法とする|(人･行為を)有罪としない|(行為を)犯罪とみなさない
mannerism	マンネリズム|マンネリ
untruthful	真実性に欠ける|事実に反する|あそをつく
crinoline	クリノリンスカート|スカートをふくらませるためのペティコート|魚雷防御網
subaltern	《英》准大尉(captain(陸軍大尉)の下)|下級(下位)の人|下級の|下位の
signalman	(鉄道の)信号手|信号係;(軍隊の)通信兵
polymath	博識家|博学の
longingly	熱望して|あこがれて
episcopate	=episcopacy
moony	月の[光の];月の[光の]のような|《話》夢ごこちの|ぼんやりした
roseate	バラ色の(rosy);楽観的な
contralto	〈U〉コントラルト(tenorとsopranoとの間で女性最低音)|〈C〉コントラルト歌手|コントラルトの
lodestone	天然磁石・ 強い魅力・吸引力のあるもの
left	左の|左側
tenter	(織物の)張りわく
myna	九官鳥(アジア産のムクドリ科の鳥)
roil	(液体を)かき乱す|濁す|心をかき乱す|混乱させる
aweigh	(いかりが)今や海底を離れて
fibrosarcoma	線維肉腫
attaboy	《米》でかした|すごいぞ|あっぱれ[That's the boy.から]
rashly	軽率に|無鉄砲に
clearing	手形交換|清掃
syllabication	音節に分けること|分節法
pupal	蛹(さなぎ)の
roughneck	乱暴者|石油の井戸掘り人|粗野な
neocortical	大脳新皮質とは|大脳の表面を占める皮質構造のうち進化的に新しい部分|合理的な思考や|言語機能をつかさどる
seductress	(男を)誘惑する女|男たらし
clavichord	クラビコード(ピアノの前身であるけん盤楽器)
busyness	多忙|忙しくすること|忙しさ
fakir	(イスラム教・バラモン教などの)行者|たくはつ僧
endoderm	内胚葉
bairn	(スコットランド|北イングランド)子供|赤ん坊
thermosetting	熱硬化性の
ostracism	追放|排斥|村八分|貝殻追放
parhelion	幻日(げんじつ)(太陽の両側に現われる強い輝き)
atmospherics	空電(大気中の電磁波の妨害により受信器に混じる雑音)
doggerel	(内容もふまじめで|韻律もふぞろいな)へぼ詩
intertribal	種族間の|部族間の
unabomber	ユナボマー(米国の大学や航空会社に爆弾を送り|死者を出した事件の犯人|数学者で大学の助教|逮捕され服役中)
mendacity	うそをつくこと(癖|性格)|虚偽|うそ
buckram	バックラム(洋服の衿芯(えりしん)や製本に用いる|のり・にかわなどで固めた亜麻布または綿布)
collodion	コロジオン(皮膚の保護剤|写真湿版の感光膜用)
abortionist	人工中絶賛成者
gymkhana	体育祭;(乗馬・自動車レース・体操の)競技会
catholicity	〈U〉(趣味・見解・関心などの)広いこと|包容性;普遍性|《C-》=Catholicism
busker	大道芸人|旅回り芸人
bantamweight	(ボクシング・レスリングの)バンタム級選手(flyweight の上;112‐118ポンド|51‐53.5キロ)
solipsism	唯我論|自己中心主義
attune	(〜に)〜'を'一致させる|調和させる|《+『名』+『to』+『名』(do『ing』)》
flighty	軽はずみな|気まぐれな
windblown	風に吹かれた|(木が)強風で変形した|(髪型が)ウインドブロウン型の
potentiate	強化する
houseguest	泊まり客
gabled	(屋根が)切り妻の|破風(はふ)造りの;(家が)切り妻(破風)のある
mincemeat	細切れ肉|挽き肉|ミンスパイの中身|ミンスミート
ubiquitously	遍在的に
timesaver	時間節約装置(方策)
chirpy	愉快な|明るい
polonium	ポロニウム(放射性元素;化学記号はPo)
corundum	コランダム|鋼玉(硬度はダイヤモンドに次ぎ|研磨剤用)
trilby	フェルトの中折れ帽
gibber	訳の分からないことを早口でしゃべる
fatalistic	運命論者
tantalize	じらす|人をじらす
loyally	忠義を尽くして|忠実に
redskin	北米インディアン(軽蔑的に)
cutlet	(羊肉・仔牛肉などの)薄い切り身(骨つきのすね肉・あばら肉なども含む)|薄くて平たいコロッケ
noontime	昼
riskiness	危険|危ないこと|冒険的なこと
bwana	(アフリカ人がヨーロッパ人などに対して)親方|かしら|ボス
subservience	卑屈|役立つこと|貢献|おべっか
crackerjack	(俗)優秀な(品)|一流の(人･物)
apoplexy	卒中
pantsuit	パンツスーツ
poorhouse	(昔の)救貧院
nationalize	国有(国営)にする
folksong	民謡|フォークソング|民謡調の歌
lifejacket	救命胴着
inflectional	語形変化する|屈折の
slaver	よだれを流す|奴隷売買者
cyanobacterial	藍色細菌の
umpteen	非常に多くの
disrobe	衣服を脱ぐ
tingly	ゾクゾクする|ヒリヒリする
octogenarian	80歳(代)の
dignitary	高位の人|貴人
superego	超自我|super-ego
improbability	ありそうもないこと|本当らしくないこと
shrewdly	抜け目なく|利口に
meed	相応(当然の)報酬|正当な報い
waggle	揺れる|振れ|揺れ動く|を振る|揺する|振れる
impish	茶目な|鬼の|腕白な|ちゃめな
seneschal	(中世の王族・貴族の)執事|家令
descant	(定旋律につく)随唱|随奏|随唱(奏)する|《文》(〜について)長々と(詳しく)述べる《+『on』(『upon』)+『名』》
mintage	〈U〉化幣鋳造|《集合的に》鋳造された貨幣|〈U〉貨幣鋳造費|〈C〉貨幣の極印(品質証明のために押す)
bushwhack	〜'を'やぶにひそんで襲う|森林地を切り開く
dejection	落胆
psychogenic	心因性の(精神・心理作用から生じる)
distractor	気を散らすもの|誤った選択肢.
tattler	おしゃべりな人;他に秘密をもらす人
nitwit	まぬけ
prophetess	(女性の)預言者|予言者
ghrelin	グレリン|胃から産生されるペプチドホルモン|成長ホルモン(GH)分泌を促進し|食欲を増進させる働きを持つ
pneumococcus	肺炎球菌
funereal	葬式の|しめやかな|悲しい|陰うつな
humorless	ユーモアのない
hotcake	ホットケーキ
demesne	(封建領主・貴族などの)私有地|領地
briny	海|大洋|塩辛い|塩水の|海の|涙の
nimbly	すばやく
verger	聖堂番 《教会堂の掃除をしたり礼拝者を座席に案内する》《英》 (大聖堂・大学などで主教・副総長などを先導する)権標捧持者
holoenzyme	ホロ酵素|(酵素本体となるタンパク質分子に|非タンパク質性の分子が結合して初めて酵素として機能するものを呼ぶ)
bloodstained	血痕のついた
unfix	〜‘を'はずす|緩める|〈心・気持ち〉‘を'ぐらつかせる
clansman	氏族の一員;同氏族の人
gunwale	舷(げん)の上縁|船べり
catchup	ケチャップ|ketchup
chicanery	ずるい言い抜け|ごまかし
counterspin	反回転
disastrously	悲惨に
upend	を逆さまに置く(立てる)|ノックダウンする|負かす
enterocolitica	Yersinia enterocolitica|(食中毒原因菌)エンテロコリチカ菌|(エルシニア･エンテロコリチカ)
hematoxylin	ヘマトキシリン|アカミノキの心材から抽出される染料|媒染剤により色調が異なり青白色や青黒色となる
formamide	ホルムアミドはギ酸から誘導されるアミド|サルファ薬の製造やビタミンの合成|紙や繊維の柔軟剤に使われる
acquisitive	欲ばりの|欲深い
boffin	科学者
dago	《軽べつして》スペイン(ポルトガル|イタリア)系の人
pressgang	水兵強制徴募隊(18世紀に英国海軍が兵集めに組織した)|《話》(部隊などへ)〜‘を'強制編入させる《+『名』+『into』+『名』》
laburnum	キングサリ(マメ科キングサリ属の有毒な小さい木)
heterodox	異端の
fermenter	発酵槽
outwear	〜‘より'長もちする|〜‘を'着古す|使い尽くす
cagey	抜け目のない
swaddle	赤子を産着(細長い布)でくるむ|(to swaddle a baby)
debility	(病気による)衰弱
copulate	交尾する
disenfranchise	(個人から)公民権(選挙権･公職権)を奪う
archaeon	archaea(古細菌)の単数形
dully	不活発に
weepy	お涙頂戴の|ジクジク染み出させる|涙ぐんだ|涙もろい|涙を流さんばかりの|滲出する
seethe	沸騰する|泡立つ|腹をたてる
shorthorn	ショートホーン(短い角を持った英国原産の肉牛)
asphodel	アスフォデル(白・ピンクまたは黄色の花をつけるユリ科の植物)
minutia	(〜の)細目|詳細|ささいなこと《+『of』+『名』》
hussar	(はでな姿の)軽騎兵
scow	大型平底船
copyist	写字生|筆耕|謄写人|模倣者
depredation	[通例複数形で] 略奪行為|破壊
espadrille	エスパドリーユ(キャンバス地で底の平らなサンダル)
insignia	記章|勲章|バッジ|しるし
bootlegger	(コンピューターソフトウェアなどの)違法コピー業者
satiate	=sate
phasic	相の
lumberman	材木切り出し人;材木商
sanitarian	[公衆]衛生の|公衆衛生学者
remorseful	後悔している
admonishment	=admonition
traditionalism	(宗教上の)伝統尊重主義
crosslink	架橋
aggrandizement	大きく見せること|誇張すること
explainable	説明できる;弁明しうる
impermanent	永続しない|一時的な
unpopularity	不人気|不評判
ragamuffin	ぼろを着た子供(人)
paraformaldehyde	パラホルムアルデヒド|パラホルムともいう|ホルムアルデヒドの重合体
disgorge	吐き出す
chiropody	podiatry
roughshod	(馬が)滑り止めのてい鉄を付けた
loner	一人で居たい人|孤独が好きな人
beanery	安い二流のレストラン
hafnium	ハフニウム(金属元素;原子記号は『Hf』)
ebullient	沸きこぼれる|沸騰している|あふれるばかりの|ほとばしり出る
tropism	向性|屈性(植物が一定の刺激の方へ|または反対方向に成長する性質)
murex	ホネガイ(熱帯地方の海産巻き貝の総称;古代人はこれから紫色染料を採った)
thermionic	熱イオンの
shantung	山東絹|シャンタン(つむぎ風の平織絹布)
swelling	膨れる|隆起した|はれ|はれもの|こぶ|腫脹
tiptop	絶頂|全盛|最高級の|すてきな|優秀な
teensy	ごく小さい