pocketful	《a~》ポケット一杯(の〜)《+『of』+『名』》|たくさん(の〜)《+『of』+『名』》
practicability	実行できること|実用性
transcriptionally	転写
bluenose	清教従的な人|禁欲的な人
dreamily	夢のように|うとうとと
exactitude	几帳面|厳正|厳密さ|正確さ|精密さ|精密度
syndromic	症候群の
myristate	ミリスチン酸エステル|ミリスチン酸(化合物名)
uremia	尿毒症
dromedary	ヒトコブラクダ|(=Arabian camel)|背中のこぶはhump
rootless	根のない|社会的足場のない
inviolate	(約束などが)破られていない|(場所が)汚されていない
obsolescent	すたれかかった
militarist	軍国主義者
pawl	(歯車の)歯止め|つめ
discrepant	不一致|矛盾
overeat	食べすぎる
lordly	君主にふさわしい|堂々とした|立派な|横柄な|君主らしい|堂々と
dolorosa	ヴィア･ドロローサ(ラテン語Via Dolorosa「苦難の道」の意)|新約聖書によるイエスの最後の歩みのこと|ヴィア･クルキス(via cruces十字架の道)とも呼ばれる
assiduous	勤勉な|根気強い
dredger	浚渫(しゅんせつ)人夫|=dredge
thenceforth	それ以後ずっと|その時以来
neologism	新語|新造語|新表現
nonbank	ノンバンク|銀行ではない金融機関
delist	上場廃止にする
portentous	もったいぶった|縁起の悪い|前兆の
steelworks	製鋼所
unbend	まっすぐにする|(心を)休める|くつろぐ
drowning	溺死
papoose	北米インディアンの赤ん坊|赤ん坊を背負う袋
fireweed	焼け跡の雑草
oilcloth	油布
wildtype	野生型(遺伝形質の種類)
pinta	1パイント(ヤード･ポンド法)の飲み物|1パイント=約473cc=8分の1ガロン　2|ピンタ島(ガラパゴス諸島)
venal	金で動かされる|買収できる|腐敗した
orthology	異種間の遺伝子が共通の祖先に由来する場合|オーソロガス(相同)という|外見や機能は似ているが|共通の祖先に由来しない相似(analogous)の対義語
corrugation	〈U〉波形にすること;波形のついた状態|うね状|〈C〉(波形を構成する)うね|溝|しわ
kibitzer	(特にカードゲーム)の見物人;おせっかい屋
wearisome	退屈な|疲れさせる
apologetically	わびて|謝って|済まなそうに
clime	地方|国土(from northern climes|北の国から)|気候|(clime地方･気候|crime犯罪)
blowhard	《米話》ほら吹き
absurdist	不条理主義の|不条理主義者(作家)
accusatory	告訴の|非難の|非難めいた
licit	合法の
bipartisanship	2党主義
bogy	おばけ|幽霊|人の悩ますもの|人につきまとうもの
electroencephalogram	脳電気図|脳波図
wrongness	不正行為
risch	スタイリッシュ
sublethal	致死量以下|亜致死の|亜致死性
mating	交配
abstinent	節度のある|禁欲的な|禁酒の
empyrean	最高天(古代天文学で五天のうちで最高の天上界)|天空|大空|最高天の;天空の
unsex	〜‘を'性的能力を奪う|〈特に女性〉‘を'女らしくなくする
prettily	きれいに
transpacific	太平洋横断の|太平洋の向こう岸の
lapdog	小さな愛玩犬|吠え声ばかり大きい無力な人|盲信者|心酔者
wunderkind	神童|天才児|(実業界での若手)成功者
protuberance	隆起
gassy	ガスが充満した;ガスを含む|ガス状(質)の
frizzle	[髪]‘を'ちぢらせる|カールにする《+『up』+『名』》|ちぢれる|(髪などの)ちぢれ|ちぢれ髪
epistolary	書簡(形式)の|書簡体の
blear	(涙などで)目がかすんだ|曇った(blurred)|(涙などで)〈目・視力〉'を'かすませる(blur)
cornea	角膜
dodder	よぼよぼになる|(老齢などのために)よろよろと歩く
fastidiosa	Xylella fastidiosa|ぶどうのピアース病(PD)を引き起こす細菌|ヨコバイが媒介し北米で広く蔓延|ナパバレーに大きな損失を与えている
shading	陰にすること|陰影法|わずかな変化(相違)
neap	小潮(こしお)(潮の干満の差が最小の日)
dudgeon	立腹
sexless	男女の別のない|性的魅力のない|セックスレス
strop	(かみそりをとぐ)皮砥|〈かみそり〉‘を'皮砥でとぐ
horsefly	ウマバエ|ウシアブ|虻(あぶ)|(=gadfly)
superintend	〈仕事・人・組織など〉‘を'監督する|指揮する|管理する
tartaric	酒石の
plenitude	豊富|十分
rosebush	バラの木(茂み)
intersperse	散らばせる|まき散らす|蒔き散らす
premedical	医学部進学課程の
scurrilous	(言葉づかいの)下品な|野卑な
uncannily	不思議なほど
pyromania	放火癖
compellingly	強制的に|やむにやまれず
floorboard	床板
ethnographer	民族誌学者
phlebitis	静脈炎
pinna	(動)羽|翼|ひれ|ひれ足(flipper)|耳殻|耳介(auricle|耳穴の周りにある音を集める構造)|(植)(シダの葉など複葉の)羽片
syncopation	(音楽の)切分音|シンコペーション(普通は弱い拍子にアクセントをつけてリズムを変えること)|(文法で)語の中略
corruptible	(人が)堕落しやすい|(物が)腐敗しやすい
pedlar	=peddler
impassive	無表情の|感情を示さない|無神経な|無感覚な
abasement	(品位・地位などの)低下|失墜;屈辱
smilax	サルトリイバラ(ユリ科の植物の一種)|クサナギカズラ(ユリ科のつる草;観賞用)
globule	(glάbjuːl)|液体の小球|小滴
jonquil	キズイセン(黄水仙)
eyecup	洗眼用コップ
nonscheduled	予定外の;(飛行機運航が)不定期の
bloodsucker	吸血動物|ヒル(leech)|搾取者|高利貸し
terroristic	テロリズムの|暴力主義的な
pomade	ポマード|〈髪〉‘に'ポマードをつける
bimetallic	2種の金属から成る|(金・銀)複本位制の
jodhpurs	乗馬ズボン
subtenant	(家・土地などの)また借り人|転借人
tollhouse	通行料金徴収事務所
prickle	とげ|針
yeomanry	地方の地主|自作農|義勇農騎兵(現在では英国民義勇軍(Territorial Army)に編入されている)
outsized	特大の
verisimilitude	ありそうなこと|本当らしく見えること|迫真性
sideswipe	(すれ違いざまに)〜‘を'横殴りする
pinworm	ギョウチュウ(人間の腸に寄生する蟯虫)
penknife	(壊中用の)小型ナイフ
terrifically	ひどく
lyse	(生命科学)細胞溶解する
truelove	恋人|愛する人
comradeship	僚友関係|同志の交わり;友情|同志愛
inopportune	時機を失った|折の悪い|不適当な|折あしく
bodkin	ひも通し[針]|千枚通し|(先に飾りのついた)ヘアピン
gumshoe	ゴム靴;《複数形で》スニーカー|《俗》刑事|探偵(たんてい)
europium	ユーロピウム(希土類元素;化学記号は『Eu』)
dapple	まだらにする|まだらの
poesy	=poetry
cheapness	安っぽさ|安価
cordovan	コードバン皮(柔らかななめし皮)
bionics	生体工学(人や動物の生態をもとにコンピューターなどの設計に応用する学問
intronic	イントロン(遺伝子関連)の|遺伝情報として転写はされるが最終的にはアミノ酸の塩基配列から除去される配列をintronという
undistinguished	区別されない|平凡な
eyedropper	点眼器
clustal	Clustal|広く用いられている多重整列プログラム|clustalWとclustalXがある
countersink	(ねじなどの頭を埋めるために)〜‘に'さら穴をあける;〈ねじなどの頭〉'を'さら穴に埋める|(さら穴をあける)さらぎり|さら穴
lackadaisical	気力のない|意欲のない|怠惰な
ribald	下劣(野卑)な|みだら(不敬)な(ことを言う)
seachange	急激な変化 = sea-change
omnipresence	同時にどこにでもいること|遍在
emend	〈原稿〉‘を'校正する|‘の'誤りを正す
shadowbox	シャドーボクシングをする(相手を予想して一人で動きの練習をする)
foldaway	折り畳み式の
brusque	ぶっきらぼうの|無愛想な
functionalist	機能主義者|機能主義の
indecipherable	解読できない
unserviceable	(壊れたり使い古して)使用できない|役に立たない
officious	おせっかいな|さしでがましい|非公式の
pilchard	ニシン科の魚
spindrift	(海の)波しぶき
snippy	痛烈な
wayfaring	旅をして歩く|徒歩旅行の
recombinase	リコンビナーゼ|酵素(enzyme)の名
pulsate	鼓動する|脈打つ
tektite	テクタイト(天然のガラス質物質)
gearshift	(特に自動車の)ギヤ転換装置
antigravity	反重力(陽の質量の物体が陰の質量の物体と反発する力)
rheostat	加減抵抗器
oilman	石油企業家|石油業者|油田主
equivocation	あいまいな言葉
gustatory	味覚の
windage	弾丸に与える風の影響|偏流|(弾丸の)偏流度
hummock	小さい丘(knoll)|(氷原の)氷の丘
laundress	洗濯女(人の家に行って|あるいは自分の家に持って帰って洗濯する女性);クリーニング屋の女性従業員
polysemy	多義性
demoiselle	未婚の女性
bottler	瓶詰め業者
orientate	=orient
avaricious	どん欲な|貪欲な
popish	ローマカトリック教的な|ローマカトリック教に特有の
resinous	樹脂の・樹脂質の・ やにの多い
paramour	情夫|情婦|愛人|恋人
enunciation	発表|発音(ぶり)|(理論･主義などの)言明|宣言
returnee	帰国子女
kickstand	キックスタンド(自転車・オートバイなどを倒れないよう支える装置)
voiceprint	声紋(声の特徴を表す音響分析図)
glycolytic	解糖|糖分解
dropsy	=edema
kielbasa	キルバサ|ポーランドの豚肉･牛肉の薫製ソーセージ
nutria	ヌートリア(南米原産の水中生活に適応した動物|ビーバーに似る)
hardscrabble	(土地が)苦労してやっと生活できる|不毛の
cowpoke	=cowboy
moneyed	金のある|金持ちの|金まみれの
discordance	=discord1|2
vivisect	〈動物〉‘を'生体解剖する|生体解剖をする
coffeepot	コーヒー沸かし器
handbill	広告ビラ|散らし
drizzly	霧雨の[降る]
angostura	アンゴスツラビターズ(南米産の木の皮から作り|アルコールの香料に用いる)
mantelpiece	暖炉の前飾り
imitator	模倣者|偽造者
meerschaum	〈U〉(パイプの火皿に用いる)海泡(かいほう)石|〈C〉火皿が海泡石製のパイプ
floodgate	(水量の調節をする)水門
chemicon	ケミコン(社名|分子生物学|遺伝子学関係)
impiety	不信心|不敬|不孝
hindquarter	(牛・羊などの体の)後四半部の肉・後部・臀部・《複数形で》(動物の足を含めた)腰から下の部分
caesium	=cesium
suddenness	突然
baneful	有害な|有毒な
furtively	ひそかに
betrayer	裏切り者|売国奴|誘惑者
lovebird	つがい鳥(ボタンインコの俗称)|《複数形で》《話》愛し合っている恋人同士
flunky	事大主義者
cycad	ソテツ(蘇鉄)
pish	くだらんこと|ウイスキー|フンと言う
domesticate	家庭的にする
arrowroot	クズウコン(病人食として用いられた熱帯アメリカ産の植物)
jostle	乱暴に押す|押しのける|競いあう
handsaw	(片手で使う)手のこぎり
castrate	去勢する|精巣を除去する|骨抜きにする
humph	ふふん
splenomegaly	巨脾症|脾腫(ひしゅ)
bandolier	(兵士が肩からかける幅広の)弾薬帯|負い革
scrunch	ボリボリかむ|(紙などを)丸める|押しつぶす|ばりばり噛む
expwy	expressway
schmo	うすのろ|まぬけ　馬鹿
wrongdoer	悪事を働く人|犯罪者|悪事を働く者|非行者
hydrous	水を含む;(鉱物・化合物が)含水の
blotchy	シミだらけの
conk	パンチ|一撃|縮れ毛を(アルカリ溶液などで)伸ばすこと
haemodynamic	血行動態
pronominal	代名詞の|代名詞のような
animatronic	アニマトロニクス(ロボットや機械を利用し|人の動きを再現すること)
pillion	(馬に堂乗する人の)添え鞍|(オートバイなどの)後部座席
recidivist	常習犯
unswerving	(意志などが)確固とした|不動の
sealevel	(満潮時と干潮時の間の)平均海面|海面　海抜 = sea level = sea-level
theretofore	それ以前に
sonority	鳴り響くこと|反響|朗々とした話
cosmopolis	国際都市
dabbler	カモ(鳥)|水遊びをする人|道楽半分に事をする人|素人
straightedge	直[線]定期
tetraploid	4倍体(4つで1対から成る染色体のセットを持つ細胞)
immodest	慎みのない
oviduct	卵管
sympatric	同所性の|(種分化について同様か重なった地理的地域において起きる)
freethinker	自由思想家(既成の考え|特キリスト教会の型にはまった考え方にとらわれない人)
wassail	(もと英国で用いた)乾杯のあいさつ|《おもに文》酒宴|酒盛り|乾杯する;酒盛りする|〜‘に'乾杯する
redecorate	改装する|模様替えをする|装飾し直す
beatification	幸せにすること
bullring	闘牛場
biochemically	生化学的に
eviscerate	(議論などを)骨抜きにする|(動物の腸を)抜く
icecap	(高山・極地などの)万年雪
pseudonymous	ペンネームで書かれた|偽名(変名)を用いる
premeditation	前もって慎重に計画すること
unsettle	動揺させる(する)|乱す|不安にする|取り乱す
agoraphobic	広場(空間)恐怖症にかかった
sinter	温泉沈殿物|湯の花|焼結製品|焼結する
villus	絨毛
pugnacious	けんか好きな|けんか早い
parainfluenza	パラインフルエンザウイルスは|関連した数種類のウイルスを含み|感冒からインフルエンザ様症候群|肺炎まで多数の呼吸器疾患を引き起こす
bedeck	《文》(〜で)〜'を'飾りたてる《+『名』+『with』+『名』》
holdback	〈U〉抑制|妨害|〈C〉(馬車のながえに取り付けた)制御用の留め金
topicality	〈U〉話題になっていること(状態)|〈C〉《複数形で》時事問題
brolly	コウモリ傘|パラシュート
wintery	wintry
adventuresome	大胆な|勇敢な
flaxen	亜麻の|亜麻製の|亜麻色の
mender	修理(改良)者
tempter	〈C〉誘惑者|《the T-》悪魔(the Devil)
vampirism	吸血鬼
hierarchic	=hierarchical
aquaporin	アクアポリン|細胞膜に存在する細孔(pore)を持ったタンパク質|水分子のみを選択的に通過させることができ|細胞への水の取り込みに関係
lovelorn	恋人に捨てられた;失恋に悩んでいる
counterrevolutionary	反革命主義者
emissive	放射性の;放射の
tractate	論文
hydrolyze	加水分解する
copybook	習字の手本帳|《米》複写薄
hootenanny	フォークソングの集まり(会)
psychosexual	性心理の
brakeman	ブレーキ係|制動手
regretful	(人が)後悔している
yawl	(2本マストの)小型帆船|(オールでこぐ)船載ボート
juristic	法律専門家の|法学者の|法律上の
presort	並べ替え済み
bowline	もやい結び(船をつなぎ止めるときの結び方)
nixie	宛先不明郵便物
perceivable	感知できる|知覚できる|認知できる
licentious	放縦な|放蕩な
intransigent	非妥協的な
postbag	《a ~》《話》(ある人に一度に配達された)郵便物|=mailbag
subcompact	サブコンパクトカー(中型自動車(compact car)より一回り小さい車)
bounder	育ちの悪いがさつ者|下品な成り上がり者
agog	(期待･興奮で)わくわくして|～したくてうずうずして
mastoid	乳様突起の|〈C〉乳様突起(耳の後ろの側頭骨にある)
millstream	水車用導水路の流れ
weightlifter	重量あげ競技者
grassroot	草の根
metastasize	転移する
nightdress	=nightgown
erecta	エレクタ (黄色オレンジ色の花が咲く花の名) 
ethnocentrism	自民族中心主義
belligerence	交戦|闘争性
gouty	痛風の|痛風にかかった
bisector	2等分線(面)
inviolability	侵してはならないこと|不可侵性
resister	抵抗する人
obstructionist	議事妨害者
walkover	楽勝
corbel	持ち送り積み(壁面から突き出た桁(けた)・はりの受け材)
sylph	空気の精|ほっそりした美しい女
erogenous	(体のある部分が)性感を刺激する
lexeme	(ˈlɛksiːm)|(文法)語彙素|言語学の形態論的単位|異なる形態だが同じ語の集合|例|child-children|go-goes-went-gone-going|big-bigger-biggest|各同じ語彙素
cynosure	注目(賞賛)の的
sourpuss	(渋い顔をする)気難しい人|ひねくれ者
chalcopyrite	黄銅鉱(銅の原鉱)
expansionism	拡張論(政策)
horseplay	馬鹿騒ぎ
mistreat	虐待|酷使する
neurotrophin	ニューロトロフィン|神経栄養因子として|神経細胞の生存|発生|機能に必要とされるタンパク質
stiffener	堅くする人(物);(表紙・えりなどの)芯(しん);〈U〉補強材
floret	小花
entreaty	懇願
flypaper	はえ取り紙
cohabit	同棲する
invitee	招待客
residuary	(法律上)残余遺産の取得権を持つ|残留物の
officialdom	《集合的に》官僚|役人|《しばしば軽べつして》お役所風なやり方
wynd	小路|路地
passkey	=master key
splitting	裂ける|割れる|割れるように痛む|キリキリ|腹が痛む様子
headlock	ヘッドロック(レスリングで相手の頭を脇の下で締めつける技)
doxology	栄光の賛歌|頌栄(しょうえい)(礼拝で歌う短い賛美歌)
hyperbola	双曲線
syndicalist	サンディカリズム主義者|サンディカリズム主義の
luxuriate	大いに楽しむ|ぜいたくをする|繁茂する|ぜいたくに暮らす|ふける
immunocompetent	免疫応答性
handhold	手づかみ|手がかり
phantasmagoria	(夢や想像上の)めまぐるしく移り変わる光景|走馬灯のように去来する幻影
papilla	乳頭(状小突起)|柔軟小突起
orderliness	秩序(順序)正しさ|行儀よいこと
homodimer	ホモダイマー|ホモ2量体(生化学)
glutinous	粘着性の
liniment	塗布薬|塗り薬
underling	下役|手下
primitivism	原始主義(自然ないし自然的なものを人間的価値の規準とする立場)
hyphenate	ハイフンでつなぐ
tumorigenic	腫瘍形成性の
disbarment	弁護士資格のはく奪
antennal	触角の
coiffure	ヘアスタイル
aliment	食物(food);滋養物|扶養;扶養料
spindly	細長い
ratan	=rattan
gavotte	ガボット(古いフランス舞踊;その曲)
ambassadorial	大使の|使節の
penetrative	浸透性の|入り込む|鋭い|鋭敏な;感銘を与える
rearm	再軍備する
leakproof	漏れ防止の
cartilaginous	軟骨の
ignominy	屈辱|不名誉
reseat	〈劇場など〉‘に'新しい席を設ける|〈人〉‘を'再び座らせる
browbeat	脅す
postbox	《おもに英》郵便ポスト(《米》mailbox)
ectodermal	＜ectoderm|外胚葉(発生初期における胚の外表面の細胞層|将来表皮や中枢神経系|感覚器官などに発達する)の|性の
solvability	解決しやすさ|解きやすさ
contrail	飛行機雲
superficiality	〈U〉(内容・性質が)表面的であること|皮相|浅薄さ|〈C〉浅薄なもの
adsorbate	吸着物
quoit	《複数形で》《単数扱い》鉄輪投げ|{C}(鉄輪投げの)鉄輪　尻の穴
stocktaking	在庫調べ|たなおろし|(現状の)調査
mountie	(カナダの)騎馬警官隊員
congener	同種|同類の物(人)|同属の動植物
avocation	副業|趣味|職業
misrule	悪政|矢政|〜‘の'統治(政治)を誤る
unasked	問われない|求められない|頼まれない|招かれない
narthex	拝廊(教会の正面入口から本堂の至る広間になっている廊下)
pantheist	汎神(はんしん)論者
perpetration	悪事を犯すこと;〈C〉犯行|悪事
candlepower	燭光(しょっこう)(candelaで測る)
chinaware	=china2
fistfight	拳骨での殴り合い
hollowware	銀・ガラス・銀器製の深皿(容器)
orthodontia	歯列矯正術
threescore	60の|60束の|~and ten 70束
monism	(哲学理論での)一元論
simper	作り笑い(をする)|にやにや(にたにた)笑う
swathe	包帯
scornfully	軽蔑して
puerperal	出産の|分娩(ぶんべん)の;産婦の
magnetize	を磁化する|磁気を与える|磁化する|引き付ける|魅了する
worldliness	俗っぽさ|俗心
howbeit	〜とはいえ(nevertheless)|〜だけれど(although)
fieldtrip	(博物館・工場・農園などの)見学旅行|実地研究旅行
altarpiece	祭壇画|祭壇の
braze	〈金属〉'を'はんだづけ(ろうづけ)する
sisterly	姉妹の;姉妹のような;仲のよい
windbreak	防風林|(塀などの)風よけ
cowherd	牛飼い
simulacrum	幻影|面影||像|似姿|にせ物
submerse	=submerge
ghostwrite	〈著作・演説原稿など〉‘を'代作する|代作する
sixpack	(ビールやかん詰めなどの)6本入り[パック] = six-pack
avidity	熱心さ|強い熱意|貪欲
polyphosphate	ポリリン酸塩(重合リン酸塩ともいい|正リン酸が脱水縮合した化合物)
thrombospondin	トロンボスポンジン(血小板タンパク質の一種)
accustom	習慣づける|を慣らす|に対して慣らす
megalomania	誇大癖|誇大妄想
nuthouse	精神病院
naiad	(ギリシア神話・ローマ神話で|少女の姿をして川や泉に住む)水の精
graphology	筆跡学|筆跡観相学
egad	やあ|いやはや!
blucher	上端が両側に折り重なる皮製の半長靴
dippy	気がふれた|ばかげた
molecularly	分子的
pantograph	写図器(一端を固定して伸縮できるパンタグラフ状の器具;比率を変えて写図できる)|(電車の)パンタグラフ
poetess	女流詩人
leguminous	マメの|マメ科の
quarrelsome	けんかっ早い|短気な|けんか好きの|口論好きの
executrix	女の遺言執行者
packrat	モリネズミ(北米産;小さく光る物を巣に集める習性がある)
blowtorch	トーチランプ
hypochondriac	心気症の(人)|憂鬱症の|健康なのに病気だと思って悩む
sympathizer	シンパ|共鳴者|支持者|同情者|同調者
damnable	地獄に落ちるべき
hagiography	聖人伝|聖人研究
necrophilia	死体姦(かん)症(死体に性的魅力を感じること)
blasphemer	(神や神聖なものに対して)不敬なことを言う人|冒瀆する人
myocyte	筋細胞
ragtag	社会のくず|下層民
moodiness	むら気な|むっつりした|不機嫌な|ふさぎ込んだ
navigability	(川・海などの)航行可能(性)
interregnum	(国王の死などによる)空位期間|(政治の)空白期間
antitoxin	〈C〉抗毒素|〈U〉抗毒素血清
oedipal	エディプス複合(Oedipus complex)の
enthrall	魅了する|夢中にさせる
aspectual	(動詞の)相の
quantitated	定量の
lassa	Lassa feverラッサ熱|アフリカ起源のウィルス性の出血熱のひとつ
shockproof	(時計・機械・装置などが)耐震性の
dethrone	退位させる
coexpression	共発現
drippy	(水の)滴る|雨の多い|ありふれた|弱虫の
partway	ある程度;途中まで
saturnalia	〈C〉《文》お祭り騒ぎ|どんちゃん騒ぎ|《the S-》《単数・複数扱い》(古代ローマの)農神祭
downshift	〈自動車のトランスミッション〉‘を'低速ギアに替える|低速ギアへの切り替え
reliquary	聖骨箱|遺物の
contrabass	コントラバス(最低音の弦楽器)
breadfruit	パンノキ|パンノキの実(メロン大で果肉の主成分は澱粉)
hepatica	ユキワリソウ(薄紫・白などの花を咲かせるキンポウゲ科の植物)
flagellation	鞭打ち|鞭毛運動
synovitis	滑膜炎
timesharing	(電算機の)タイムシェアリング|時分割[方式]
venipuncture	静脈注射
deathtrap	危険な場所(老朽建造物，ぼろ船など)|死のわな(交通事故の起こりやすい場所や逃げ場のない炎上している建物のように非常に危険な場所・環境)
farfetched	こじつけの
insuperable	打ち勝ちがたい|克服できない
brainteaser	むずかしい問題(パズル)
chemiluminescent	化学発光
wariness	警戒|慎重さ
starlit	星に照らされた|星あかりの
inauspicious	不吉な|不運な|不幸な
cullin	カリン(細胞周期の制御に関与する酵素の名)
overhand	(野球・クリケットの)オーバーハンドの|上手からの(手を肩より上にあげて行う);(水泳の)抜き手の|(テニスで)オーバーハンドの(腰より上のボールを打つ)|(クリケット・テニス・野球などで)上手で|オーバーハンドで;(水泳で)抜き手で
prescience	先見|達識|洞察|予知(能力)
nightspot	ナイトスポット
narcosis	(麻酔剤による)昏睡(こんすい)状態
colicky	激しい腹痛の
aconite	トリカブト(有毒性植物)
novelette	感傷的な中編小説
coccyx	尾骨
bubo	横痃(おうげん)(そけいリンパ腺の炎症によるはれ物)
preoccupy	いっぱいにする|心を奪う|先取する
academical	=academic|《複数形で》大学の式服
monophyletic	単一系統の
davit	ダビット|救命ボートなどを吊って上げ下げするためのクレーン状の装置|a crane-like device for suspending or lowering equipment (as a lifeboat)
enzymatically	酵素的に cf|enzyme(酵素)
ploughman	農夫|いなか者|ploughは鋤(すき)
hokum	いんちき商品|おべんちゃら|でたらめ|安物のキャンディー|役にも立たない代物
roughage	粗い食物(飼料)(繊維を大量に含み腸の蠕動(ぜんどう)を刺激する)
servitor	(男性の)従者|従僕|召使い
axolotl	アホロートル(メキシコ産のサンショウウオ)
goatskin	〈C〉ヤギの皮|〈U〉〈C〉なめしたヤギの革|〈C〉(酒を入れる)ヤギ革の袋
adrenalectomy	副腎摘出
cowrie	タカラガイ|コヤスガイ
jokey	愉快な|面白い|お調子者の
acceptation	(語句の)一般に認められた意味
chromosphere	彩層(太陽の周辺を取り巻いている白熱ガスの層)|恒星を取り巻くガス層
hardwearing	(衣類・靴など)長持ちのする
henhouse	鶏小屋|鶏舎
bullfighter	闘牛士
pushcart	手押し車
cripes	(驚いて)おやまあ|これは|おやおや
caboodle	一群の人(物)|ひとかたまり|一団
bunco	いかさま|ぺてん
tieback	(カーテンを片側に寄せて止める)止め飾り
rivulet	小川|細流
oarsman	(ボートの)こぎ手
proselytize	改宗させる|変節させる
scrapple	スクラップル(トウモロコシの粉を使った揚げ料理の一種)
tenderfoot	《米》(米西部の牧場などの荒い仕事に不貫れな)新参者|新前|(一般に)無経験者|初心者(novice)
requite	(〜で)〜‘に'報いる|返礼する(reward)|〜‘に'報復する《+『名』+『with』+『名』》
obiter	傍論|付随的意見　
grizzle	〈特に小さな子供が〉しくしく泣く|(〜のことで|〜だと)だだをこねる|不平を言う《+『about』+『名』|+『that節』》
explainer	説明者
outrank	より高い地位を占める|重要性でに勝る|より上位にある
zealotry	《軽べつして》熱狂|狂信
chloral	クロラール(DDTに用いる)
onomatopoeia	擬音|擬音語
digging	採掘
bellybutton	へそ
olfaction	嗅覚
ferryboat	連絡船
weeny	ちっちゃな|ちっぽけな
jetlag	時差ぼけ
exoneration	免罪|罪を晴らすこと
intimal	血管内膜の
metamorphose	魔術などで違ったものに変身する|変える
dehydrate	〜'を'脱水する|脱水状態にする|水分を失う|〈体が〉脱水状態になる
fretwork	雷文飾り
woodcutter	きこり
cytochalasin	サイトカラシン(がん研究用試薬|細胞分裂･アポトーシス関連の基礎研究用試薬)
apposite	適切な|きわめて適切な
uncial	アンシアル書体の|アンシアル書体(4‐8世紀にギリシア・ラテンの写本に用いられた)
flooring	床|床張り(材料)
sloppiness	だらしなさ|乱雑;いいかげんさ
limpid	透明な
tuppence	=twopence
forecastle	(船の)前甲板|船の前甲板下の船員部屋
calculable	計算できる|信頼できる;予想できる
statuesque	彫像のような
maladministration	やりそこない;悪政|失政
cogitation	〈U〉熟考|熟慮;思想力|〈C〉《しばしば複数形で》熟慮の結果;考案|着想
farsighted	先見の明のある|遠視の
grippe	インフルエンザ(influenza)
subcloned	サブクローンされた
salivate	つば(よだれ)を出す
maleficent	害をなす|有害な
bema	聖堂内陣|ユダヤ教の会堂内にある壇
reversionary	復帰権のある・復帰権のある，将来享有すべき.
shogunate	(日本の)幕府の
dolorous	悲しみを誘う|悲しそうな|悲しい|痛ましい
unenlightened	あることによく通じていない|無学の|無知の|偏見をもつ
wholesomeness	体によいこと|健全さ
capably	りっぱに|うまく
nosedive	急降下|～以上|～に勝るとも劣らない
magistracy	magistrateの職; （the ～） ((集合的)) 行政官; 治安判事・行政長官、判事の職(任期|管区)・《the ~》《集合的に》長官(判事)たち
foretaste	当て込み|予測|予想|前触れ|予知|(将来の苦楽を)前もって味わうこと|予期
ladylike	貴婦人らしい|淑女にふさわしい;上品な|しとやかな
actinomycin	アクチノマイシン|放線菌が産生するポリペプチド系の抗生物質|20種以上が知られている|試薬や抗がん剤に使われる
panpipe	パンの笛(管を長さの順に並べた原始的な吹奏楽器;牧神Panが作ったとされる)
interrelate	(〜と)相互関係にある《+『with』+『名』》
vagrancy	放浪|浮浪
coterminous	=conterminous
segregationist	分離主義の
palpably	明らかに
softy	センチメンタルな人|情にもろい人|だまされやすい人|あほ|=softie
ganger	(労働者の)組がしら|人夫がしら
improbably	たぶんそうでもない
expressionless	無表情の|表情に乏しい
bowstring	弓のつる
pumpernickel	ライ麦パン|黒パン
hellhole	不快な(不潔な)場所
shipbuilder	造船技師(業者)
seismogram	震動記象(地震計によって描かれた記録)
transcendentalism	(カントの)先験論;(エマソンの)超絶論
soundless	音をたてない|静かな
rennet	レンネット(チーズなどを作るときの牛乳の凝固剤)
cooperativity	共同性
unspeakably	口では言えないほど|お話にならない
viand	《通例複数形で》《大げさに》食物;ごちそう
dinkum	本物の|真正の;正直な
subnormal	正常以下の
unconquerable	征服(克服)できない
offertory	(ミサ・聖餐(せいさん)式における)パンとぶどう酒の奉献|(教会の礼拝式で集められる)献金;(その時用いられる)祈とう文
perisher	困ったやつ|うるさいやつ;がき
pasteboard	ボール紙|厚紙
sunbathe	日光浴をする
sophomoric	(高校･大学)2年生の|青くさい|知ったかぶりの|生意気な
mangy	軽蔑すべき|卑劣な
catarrh	カタル(特にかぜなどで鼻・のどなどの粘膜に起こる炎症)
terrycloth	テリークロス(両面のけば(毛羽)の輪奈を切らずに残した布地;タオル地など)
torchbearer	たいまつを持つ人|啓蒙する人|文化人
leav	去る|残して去る|許可|休暇
dislocate	〜‘の'場所を移す|位置をずらす|〜‘を'脱臼(だっきゅう)させる(disjoint)|〈正常な状態〉‘を'乱す|混乱させる
reverential	敬けんな|恭(うやうや)しい|慎重な
schoolmate	学校友達
ophthalmoscope	検眼鏡
warhorse	(昔の)軍馬|百戦練磨の兵士;(政界などの)古つわもの
snowdrift	雪の吹きだまり(堆積)
sensationalist	扇情的な人|(哲学で)感覚論者
inerrant	誤りのない|間違いのない
infallibly	絶対確実に|全然誤りなく|《英話》いつも|きっと
violist	ビオラ奏者
unbidden	招かれない
valency	=valence
gumdrop	ガムドロップ(ゼリー菓子の一種)
eugenic	優生学上の|優秀な子孫を残す
preincubation	前保温
prefatory	序文の|前置きの
extirpation	根絶|撲滅
diagnostician	診断専門医
craver	切望する人|懇願する人
pawpaw	=papaw
adventuress	女性冒険家|女やま師
turbojet	タービン式噴射推進機関(turbojet engine)|ターボジェット機
politicize	政治に携わる|政治を論じる|政治化する|政治に関心を持たせる|政治的に扱う|政治問題化する|政党化する
commodious	(いすが)ゆったりとした;(部屋・家が)広々とした
skullduggery	=skulduggery
industrialism	産業(工業)主義
midlevel	中間レベル
busboy	食堂の下働き(食卓を片付け次の客がつけるように準備するボーイ)
margrave	(中世ドイツの)辺境伯(国境地域防衛を任とする地方官)
conurbation	都市集団|(特に)大都市圏
plainclothes	(警官が)私服の
gimlet	(T字形の柄をもつ)錐(きり)|ギムレット(カクテルの一種)
anlage	(生物)原基(細胞群で器官に成熟する前の段階のもの)|(心理)素質|遺伝的素質
bleah	あかんべー
conduce	(ある結果に)導く|貢献する《+『to』(『toward』)+『名』》
passing	過ぎて行く
maidservant	お手伝いさん|女中(maid)
wheal	(腫れてかゆい)虫さされ|(蚊の)刺し跡|みみずばれ(=wale)
ingenuous	無邪気な|率直な|淡白な|純真な|あどけない
syndicalism	サンディカリズム(労働組合が生産と分配の手段を握るべきだとする理論)
assignation	あいびきの約束|指定|割当て
worrier	悩む人|心配症の人
smutty	黒穂病にかかった|汚れた
nonplus	〜‘を'困惑させる;〜‘を'途方に暮れさせる
gudgeon	セイヨウカマツカ(釣りやすいコイ科の淡魚;釣りえ|および食用)・《英》だまされやすい人|かも
beefsteak	(ステーキ・フライ用)牛肉の切り身;(それを焼いた)ビフテキ
triploid	3倍体(3つで1対から成る染色体のセットを持つ細胞)
womanizer	女たらし|女遊びにふける男
glassblowing	ガラス吹き;(フラスコなどの)ガラス器製造
pneumatically	圧縮空気を含んで|圧縮空気の作用で
exploiter	(人・物などを)利用する人|搾取者;開発者
gyroscopic	ジャイロスコープ(回転儀)の
oratorical	演説の|雄弁の|雄弁家の|雄弁家ふうの
sacerdotal	聖職者の|司祭の;聖職制の
crosshatch	(ペン画･製図などで)網状線(を描く|で陰影をつける)
eventuate	(〜の)結果になる|結局(〜に)なる《+『in』+『名』》
armhole	そでぐり(そでを付けるための穴)
premolar	小臼歯|小臼歯の
remora	コバンザメ(頭上の吸盤で他の魚の腹部なとに吸着する)
farmhand	作男|農場労働者
disembarkation	陸揚げ;上陸
intraperitoneally	腹腔内に
hibachi	火鉢、小型のバーベキュー用コンロ
mislay	置き忘れる
mesosphere	中間圏(地表約40から80キロメートルの所に広がっている大気層)
conciseness	簡潔さ
rotund	丸まると太った|丸い|太った
coattail	(燕尾服)上着のすそ|人のおかげで|人の助けで
bentwood	曲げ木製の
pleather	人工レザー|合皮|語源plastic and leather|polyurethane製が主
aspic	アスピック(肉・魚・野菜の煮汁から作るゼリー)
swordsmanship	剣術の腕前;剣術|剣道
hormonally	ホルモン性の
blandly	(人･態度など)人当たりがよい|穏やかな|穏和な|口当たりのよい
mutability	変わりやすさ|無常|むら気|かわりやすさ
imperforate	穴のあいていない|(切手に)ミシン目のない|ミシン目のない切手
mainspring	(時計などの)主ぜんまい|主因|主要動機
myelitis	脊(骨)髄炎
internecine	互いに殺し合う|共倒れの|多数の死傷者を出す|血なまぐさい
nasogastric	鼻腔と胃の|鼻腔から胃に挿管された
cupful	茶わん1杯[の量]|カップ1杯の量(1|2pint=《米》0.47l|《英》0.57l)
dimorphic	二形性の|両形|2つの異なる形式で生じるまたは存在する
polestar	北極星・= Polaris
dimwit	ばか|うすのろ
limited	制限された|特別
legation	公使館|(集合的)公使館員
electrify	に電気を流す
leafless	葉のない・葉の落ちた
chauvinistic	熱狂的(盲目的)愛国主義の|熱狂的性差別主義の
gainsay	(主に否定文で)を否定する|反対する|反論する
contortion	ねじれ|ゆがみ|歪曲|こじつけ
sunstroke	日射病
pedigreed	血統の正しい;由緒(ゆいしょ)のある
greenmarket	グリーンマーケット
birdseed	つぶえ(小鳥のえさ)
miscegenation	(白人と黒人の)異種族混交|雑婚
echolocation	レーダー反射法(レーダーを使って物体の位置を決定する方法)
chlorthalidone	クロルタリドン|利尿剤|高血圧や浮腫(むくみ)を制御する
ungrammatical	文法に合わない
taconite	タコナイト|角岩(鉄鉱石の一種)
gluttonous	食いしんぼうの|大食の|(〜に)どん欲な《+『of』+『名』》
ragout	ラグー(野菜と肉や魚の煮込み料理)
youthfulness	若々しさ|青年らしさ
grandam	祖母|老婆|おばあさん
brickfield	《英》= brickyard
revalue	〜‘を'再評価する|〈通貨〉‘を'切り上げる
hypotenuse	(直角三角形の)斜辺
living	生き生きしている|生計|暮らし|生命のある|活発な|燃えている|生存|暮らし方
systole	心臓収縮
catenary	垂曲線|懸垂線
ferryman	渡し守|渡船業者
mockingly	あざけって|ばかにして
recondition	を修繕する
nymphomaniac	(女性が)色情狂の|淫乱な女性
epitomize	典型的に示す|概略を作る
phosphorylate	リン酸化する
xenograft	異種移植片
cogently	(議論など)説得力をもって|効果的に|適切に
tenpin	《複数形で》《単数扱い》十柱戯(10本のピンを使うボウリング)|〈C〉そのピン
prognosticator	予言者|占いをする人
equipoise	〈U〉釣り合い|均衡|〈C〉平衡おもり;対抗勢力
duckweed	ウキクサ科の植物;浅い水面に茂る
sepulcher	墓|を埋葬する
filch	くすねる
loquacious	おしゃべりな|多弁な|騒々しい
mercantilism	重商主義
pastorate	牧師の職(任期)|《集合的に》牧師団
frumpy	=frumpish
pterodactyl	テロダクティル(絶滅した翼竜の一種)
afters	《英話》食後のデザート(菓子など)
velar	(比較変化なし)軟口蓋の|軟口蓋と舌との接触により発音された|軟口蓋|軟口蓋音
prudish	極端に潔癖でお堅い|淑女ぶる|とりすました
pentagonal	五角形の|五辺形の
dextrous	=dexterous
cinquefoil	キジムシロ(バラ科の植物;ある種は五弁の葉を持つ)
soothingly	なだめるように|和らげるように
sugarplum	小さな砂糖菓子|ボンボン(bonbon)
heavenward	天に向かう|天の方へ
fallibility	誤りやすさ
imbed	=embed
valedictory	告別の辞|告別演説|別れの言葉|告別の|別れの
osier	コリヤナギ[の枝](枝はかご細工に用いる)
repugnance	大嫌い|いや気|反感|嫌悪|in (with) repugnance憎悪して
demurrage	(船の)超過停留|停留日数超過割増金
joyless	喜びのない|楽しくない|わびしい
execrable	憎むべき|呪うべき|忌まわしい|実にいやな|劣悪な
stolid	ぼんやりした|鈍感な|無神経な|感情を見せない
cabinetmaking	家具の製作|家具製作業(技術)
bullfinch	ウソ(短く厚いくちばしを持つ美しい鳴き鳥)
gamely	勇敢に(game:遊び･闘志･勇気の副詞形)|遊戯|遊び|ゲーム|競技|スポーツ|冗談|戯れ|からかい
abase	〈品位・地位など〉'を'落とす|下げる;〈自分〉'を'卑しめる
misname	《しばしば受動態で》〜‘を'誤って名を呼ぶ
leaseholder	借地人|借家人
titter	クスクス笑い|パイかぶれ|女好きの男|忍び笑い|クスクス笑う|忍び笑いをする|クスクス笑いながら言う
wackiness	狂気さ
legatee	遺産受取人
concertmaster	コンサートマスター(オーケストラの主席奏者;通例主席第一バイオリニスト)
dissemble	隠す|偽る|装う|のふりをする|見ないふりをする|無視する
countin	counting 数え上げる
epigraph	碑文
amputate	切断手術をする
swimmingly	すらすらと|順調に
truncheon	杖
firebug	放火魔
marketeer	市場商人
conchology	貝類学
precognition	[超感覚的]予知
disproportion	不均衡|不釣り合い|の均衡を破る|不釣り合いにする
romanticize	ローマ的にする
counterpane	(装飾的な)ベッドカバー(bedspread)
stomachache	『腹痛』|胃痛
coagulate	〈液体〉'を'凝固させる|〈液体が〉凝固する
potbelly	太鼓腹
venerate	尊ぶ|崇拝する
sartorial	仕立て屋の|裁縫(師)の|衣服に関する
guesstimate	当て水量|推測で見積もる
exemplification	〈U〉例をあげること|例示|〈C〉実例(example);好例
pleader	申立て人;嘆願者|弁護人
nucleate	核を持った|核になる|〜‘を'核にする
casque	(中世に用いた)かぶと
vainglory	非常なうぬぼれ|強い虚栄心
lowermost	最低の|どん底の
backburner	(順位・権利で)後に回されること|他より劣ること
estrange	遠ざける|引き離す|の心を離す|の仲を裂く|疎遠にする
syrinx	牧羊神パンの笛|鳴管(鳥の発声器官)
woodworm	(各種の)木くい虫
fecund	よく実る|多産の|よく肥えた|創造力豊かな
expressively	表情たっぷりに;意味ありげに
driftnet	流し網
euphony	音調のよさ
fishmonger	魚屋
kissable	(特に女性が肉体的魅力のために)キスしたくなる
cepacia	地中等に住む環境細菌
notability	〈U〉顕著|著名|〈C〉《複数形で》名士
peristalsis	蠕動(ぜんどう)運動(筋肉の収縮と弛緩(しかん)の運動)
ostler	=hostler
megalopolis	メガロポリス(いくつかの大都市と隣接する複数の都市から成る大都市圏)
extortionate	(値段・要求などが)法外な|途方もない
sparerib	スペアリブ
synteny	生物学において「ゲノム上で遺伝子の並びが保存されている」度合い　cf|syntenic
drachm	dram|drachma
avow	率直に言う|(率直に|公然と)認める
firebreak	(山火事などをくい止めるための)防火帯(線)
hepcat	ジャズ気違い|新事情通|ジャズ通|ジャズミュージシャン
macrocosm	《the ~》大宇宙|〈C〉(小さな体系を含む)大体系
puissant	権力の|勢力のある
egoistic	利己主義の|自己本位の
divertissement	楽しみ|娯楽|=divertimento
chummy	仲よしの|親しい
baddie	悪役|悪玉
heatstroke	熱射病
godown	(アジア諸国で)(港の)倉庫
cloudburst	(突然の)穀雨|どしゃ降り
ethnocentric	自民族中心主義の
pigsty	豚小屋|きたない所
demarche	(仏)(外交)手段|転換策|処置|政策の変更
dolman	トルコ人の前の開いた長い外とう|そでがケープのような婦人用コート
slipway	船架(造船所などで船を進水させたり水から引き上げたりするために用いる水面に向って傾斜した台)
permeabilized	透過処理
multimillionaire	億万長者|大富豪
brokenhearted	失意の|悲嘆にくれた;失恋の
disparagement	軽蔑|非難
fisticuffs	げんこつでのなぐり合い
repercussion	(好ましくない間接的な)影響|(音の)反響|(銃などの)反動|はね返り
quaver	震える|震音|声が震える|声の震え|震え声
stonecutter	石工|石切り工;石切り機
favouritism	=favoritism
unmentionable	口に出せない
unimpeachable	非難できない|非の打ちどころのない|申し分のない
simpatico	気の合う|同じ性質の
malleability	(mˈæliəbl)|展性(箔に広がる性質|cf|引っ張って伸びる性質は延性ductilityという)
cheerily	元気よく|陽気に|元気で
sickbay	(通例船内の)病室
ziggurat	ジッグラト(古代バビロニア・アッシリアのピラミッド形の間院)
damselfly	イトトンボ
crazily	夢中になって
beguile	欺く|だます
guzzle	鯨飲する|がぶがぶ飲む|がつがつ食う
upperclass	上流の|上流階級の|(米国高校・大学で)上級の
docudrama	ドキュメントドラマ
inhere	〈性質などが〉(〜に)固有のものとしてある《+『in』+『名』》
rearguard	(軍隊の)後衛|しんがり
officeholder	公務員
inextricable	(結び目などが)ほどけない|手がつけられないほどこみいった|脱出できない|抜け出せない
popery	ローマカトリック教[の教義・儀式]
trustful	信じやすい|人をすぐ信用する
faille	ファイユ(絹・レーヨンなど柔らかくうねのある布地)
misguide	間違った方へ導く|間違って指導する
breezeway	建物間の屋根つき通路
looter	＜loot|略奪者
transvestism	服装倒錯(同性愛者などが異性の服装をすること)
coyly	はにかんで
malinger	(特に軍務|労働などを避けるために)仮病を使う
gerrymander	ゲリマンダー(自党に有利なように選挙区を区割りすること;その選挙区)|〈選挙区〉‘を'自党に有利に改正する
woad	(大青(たいせい)から採った)青色染料
plainsong	=Gregorian chant|(またplainchant)(中世の)無伴奏教会聖歌
contort	をねじる|本来の意味を曲げて解釈する
phonogram	発音文字
bifurcate	〈道路・川などが〉二またに分かれる|分かれて二本になる|二またに分かれた
embolus	塞栓(そくせん|embolism)|栓子(血塊などの塊|単数形embolus|複数形 emboli)が血液中に遊離し|血管が塞がれ血流が遮断されること
dogbane	バシクルモン(キョウチクトウ科の多年草)
tepee	ティピー(北米インディアンのテント小屋)
puffball	ホコリタケ(球形のキノコの一種)
dowse	=douse
flytrap	ハエトリソウ
busk	大道芸をする
elephantine	象の|象のように巨大な;のっそりした
measureless	限界のない|測りしれない|測れないほど大きい
northeastward	北東へ(に)|北東の;北東へ向かう|北東;北東部
scandalize	あきれさせる|あきれる|(人を)憤慨させる
jaybird	=jay
subtilisin	サブチリシン|スブチリシン|(枯草菌のタンパク質分解酵素)
burble	さらさら音をたてる
downspout	縦樋(=down pipe)|(石油化学工場などの蒸溜塔内にある)溢流管
trackless	道のない人|人跡未踏の|(雪などで)道の跡が消えた
demographer	人口統計学者
patroness	(仏語)patronの女性形
inconsolable	慰められない;あきらめがつかない
virtu	〈U〉(美術品などの)優秀性|よさ|値打ち|《集合的に》《複数扱い》美術品|骨とう品|{U}美術品(骨とう品)に対する造詣(知識) = vertu
explicable	説明できる|説明可能な
reincarnate	(〜として)〈新しい肉体〉‘に'生まれ変わらせる《+『as』+『名』》
trews	(スコットランド兵士がはく)細身の格子じまのスボン
gastropod	腹足類の動物(カタツムリ・ナメクジなど)
isobar	(地図上の)等圧線
manicurist	マニキュア師
intermingle	混りあう|混る|を混ぜる|混ざる
buggery	=sodomy
papist	(新教徒側から軽べつして)カトリック教徒
monozygotic	一卵性の
argot	(盗賊などの)暗語|隠語|符牒
punctate	点状の
tamer	ならし手|使い
halobacterium	好塩菌
fontina	羊乳から作ったイタリアチーズ
hypochondria	心気症|憂鬱症|気病み|うつ病
chervil	チャービル(セリ科の植物;芳香があり葉はスープ・サラダ用)
idealize	を理想的にする|を理想化する
propitiation	なだめること;〈C〉(なだめるための)ささげ物
sinewy	引き締まった|筋っぽい|筋骨たくましい|硬い|丈夫な|力のこもった|腱質の
phylogenetically	系統発生的に
interlaboratory	研究室間の
worshiper	参拝者|崇拝者
uproarious	騒々しい|騒然たる|爆笑させる|ひどくおかしい
penitential	後悔の|ざんげの
autophosphorylation	自己リン酸化 (細胞が自ら細胞内のタンパク質をリン酸化|脱リン酸化し|酵素活性や他のタンパク質との会合状態を変化させる機能)
phrenic	横隔膜の|(生理学上の意味で)精神の|精神活動の
belabor	(議論|仕事)長々とする(続ける)
autoantigen	自己抗原
fibril	小繊維|根毛
burnish	磨く
desegregate	人種的差別を廃止する
hyperpolarization	過分極
factionalism	派閥主義
sandpit	砂掘り場|砂坑|《英》(子供が遊ぶ)砂場
overdevelop	〜‘を'過度に発達させる
mastication	咀嚼(そしゃく)|かみこなすこと
hooey	ばかな(不承知・不信などを表す)|ばかなこと|くだらぬ話
pettiness	取るに足らないこと|つまらなさ|狭量
immanence	(物質・要因などの)内在|(神・神の意志の)宇宙遍在
uncork	コルクを抜く
ibidem	同じ箇所に|同書に|同章に|同節に
bent	傾向|好み|曲がった|熱中している|湾曲した
dawdle	時間を浪費する|ぐずぐずする|ぶらぶらして時を過ごす|空費する|ぶらぶら歩く
unapproachable	(人が)話しかけにくい|親しみを持てない
putatively	推定上|一般に考えられられているところでは
incapacitate	耐えられなくする
unnoticeable	人目をひかない|重要でない
salable	売り易い
cordiality	〈U〉心からの気持ち|温情|〈C〉心からの言葉(行為)
norovirus	ノロウイルス|非細菌性急性胃腸炎を引き起こすウイルス|貝類の食中毒や|感染者の吐瀉物から経口感染する
fedayeen	(特に反イスラエル運動している)パレスチナのゲリラ隊
thuggery	残忍な殺人強盗|暴行|暴力
inconstant	変わりやすい|気まぐれま|移り気の
cotyledon	子葉(胚の初葉)
effete	時代遅れの|退廃的な|衰えた|(男が)女々しい
crestfallen	うなだれた|意気消沈した
suchlike	このような
tangibly	触知できるよう(ほど)に;明白に
gloomily	暗く|薄暗く|憂うつに|意気消沈して
chondrocyte	軟骨細胞
adulterer	不義者|浮気者
fluoresce	けい光を発する
lexicographer	辞書編集者
incandescence	白熱[光]
fluorophore	蛍光色素分子
lucidly	明快に;透明に
astir	(〜に)わきたって|ざわめいて《+『at』+『名』》;(〜で)にぎわって《+『with』+『名』》|(ベッドから)起きて
metazoan	後生動物(Metazoa)の|後生動物は|動物分類学で動物扱いだった単細胞生物の原生動物に対し|多細胞の動物をまとめた呼び名として使用された
freakishly	気まぐれに
echinoderm	(ヒトデ･ウニ･ナマコなどの)棘皮動物
immiscible	(特に液体などが)混合できない|混じらない
undulate	波のようにうねる
divvy	分け合う|山分けする|分け前|配当
insidiously	陰険に|狡猾に|知らぬ間に
egregiously	とんでもなく|ひどく
ungulate	有蹄(ゆうてい)動物|ひづめのある動物
cootie	シラミ
shipshape	きちんとした|整然と
manacle	《複数形で》|手錠|束縛|拘束|〈人〉‘に'手錠を掛ける|〜‘を'束縛する
claptrap	場当たりな
odium	憎悪|反感|汚名|悪評
doctrinaire	空論家|教条的な|空論の
hustings	演説台
electromotive	電動の|起電の
charioteer	chariotを駆る人(御者)
adroitly	うなだれた|うつむいた
ovenware	オーブン用耐熱食器
transubstantiation	(宗教)全質変化|聖変化|カトリック教会のミサや正教会の聖体礼儀でパンとぶどう酒がイエス･キリストの体(聖体・聖体血)に変化するとされること
sloe	スロー(ベリー)|リンボク(スモモの一種)
altruist	利他主義者
catastrophically	悲劇的に|破滅的に
unflappable	(危機に臨んでも)動じない|冷静な|泰然とした
unformed	まだ形をなさない|定形のない|未発達の|未熟の
bouillabaisse	ブイヤベース(魚・エビ・トマト・サフランなどをオリーブ油でいため|水を加えて煮たフランス風寄せなべ)
erotically	性愛的に|好色に
schooling	学校教育|教育現場|教育する
apparat	旧ソ連の政治機構
irretrievable	(過失・損失などが)取り返しのつかない|元どおりにならない
roguish	悪党らしい
hallucinate	幻覚を生じる|幻覚を感じる
saltine	塩ふりクラッカー
uvula	喉ひこ|(俗称|のどちんこ)
housefly	イエバエ
rapacity	貧欲(greed)
sicken	吐き気がする|うんざりする
elopement	駆け落ち;家出;失踪(そう)
monosyllabic	(単語の音節が)単音節の|単音節語の
incontestable	明らかな|議論の余地のない
languor	(け)だるさ|倦怠|無気力|思い悩み|物思い
epochal	一新紀元を画する|画期的な|新しい時代をもたらす|新紀元の|前代未聞の|比類のない
ventriloquism	腹話術
slovenly	(服装・言語などが)だらしのない|いいかげんな|だらしなく|いいかげんに
hoarding	貯蔵
translucence	半透明
reckoner	計算する人|建算者|=ready reckoner
fortissimo	(音楽の演奏で)最も強く(《略》ff)|最も強い|フォルテシモの
dreamboat	魅力的な異性
purloin	〈ささいな物〉‘を'盗む|盗む
dibasic	(化学)二塩基性の
aquanaut	海洋潜水士(深海に設置された居住設備内に生活し|学術上のデーターをとる人)
mandrill	マンドリル(西アフリカ原産のヒヒの一種)
ingrate	恩知らず|忘恩の徒
talky	おしゃべりな
inanity	ばかなこと|愚鈍|空|空虚|考えのない行為|無意味な言葉
purposeless	目的のない|動機のない;無意味な
gobbledygook	分かりにくい言葉|ややこしい言葉|お役所言葉|チンプンカンプン
assort	〜'を'分類する|仕分ける
carryall	大きな手さげ袋|(数人乗りの1頭立ての)四輪馬車|乗合バス
careerist	出世第一主義者
bivalent	二価の(二つの原子価を持つ)
tableland	高原|台地
damned	のろわれた
unselfishness	無私|無欲
sycophant	追従者
goodby	さようなら=goodbye
paresis	不全麻痺|局部的運動麻痺
bagman	《米俗》わいろ(身代金)の受け渡しの使い走り
astrocyte	星状膠細胞
egoist	利己主義者|自己中心的な人|うぬぼれの強い人
cowman	牛飼い|牧畜業者
newspaperman	新聞記者
phenotypically	表現型(肉眼で見える生物の形質)
sublimely	卓越して|抜群に|荘厳に|すばらしく|全く|ひどく
destructible	破壊し(され)やすい|壊れやすい
kraal	(垣を巡らした)南アフリカ原住民の村|(南アフリカで|牛・羊などを飼うために)囲ってある場所
semitone	半音
airing	空気で乾かすこと|外出|散歩
alyssum	ニワナズナ(白・黄色の花をつける雑草)
avulsion	摘出|剥離|裂離|捻除
multitudinous	非常に多くの|多数の|多項目から成る
fishhook	釣り針