insecticidal	殺虫剤の|殺虫の
bridgehead	橋頭堡(きょうとうほ)(味方の渡河を援護する陣地)
sainthood	聖人の位
laceration	かき切り(裂き)|傷つけること|苦悩|裂傷|裂け口
hepatoma	肝細胞癌
kingly	王の(royal);王のような;王にふさわしい;威厳のある|王らしく
legionary	(古代ローマ軍の)兵士
slicker	長いゆるやかなレインコート|詐欺師|如才のない都会人
chela	(エビ・カニ類の)はさみ
pertinence	適切さ|妥当性
christening	命名式|洗礼命名式
basia	バスラ
inflexibility	曲げられないこと|不屈|不変性
akimbo	両手を腰に当て|肘を張って(with one's arms akimbo)
defecate	排便する|澄む|不純物がなくなる|排出する|精製する
revelatory	啓示的な|現す|天啓の|暴露の
jigger	ジグを踊る人・ジガー(カクテル処方の単位;1 1|2オンス);(1 1|2オンス入りの)小コップ|ウイスキーグラス・スナノミ ((ノミ［ダニ］の一種));〔話〕 代物 ((とっさに名称が思い出せない時用いる)).
hieroglyphic	象形文字(の)
cryosurgery	低温(凍結)外科療法(組織の破壊などに極度の低温を用いる療法)
scoter	クロガモ
gigahertz	ギガサイクル|gc
tensely	張り詰める|緊張する
motile	自動性の|運動性の|運動型の
unicameral	(議会が)一院(制)の
feint	見せかけ|陽動作戦|(～する)ふり|フェイント攻撃|フェイント|陽動|牽制
cerebrum	大脳|脳
rectus	直筋
pruner	トリマー
kuru	a progressive disease of the central nervous system marked by increasing lack of coordination and advancing to paralysis and death within a year of the appearance of symptoms; thought to have been transmitted by cannibalistic consumption of diseased brain tissue since the disease virtually disappeared when cannibalism was abandoned|a progressive disease of the central nervous system marked by increasing lack of coordination and advancing to paralysis and death within a year of the appearance of symptoms|thought to have been transmitted by cannibalistic consumption of diseased brain tissue since the disease virtually disappeared when cannibalism was abandoned
cartoonish	漫画っぽい
exportable	suitable for export; "exportable cultural achievements"|suitable for export
goop	べとべとしたもの|へどのでそうな食べ物|ぶしつけ(無神経･鈍感)な人
hasek	ハシェク
chesty	(特に女性が)胸の大きい|胸の底から響きわたるような
clampdown	(突然の)規制取り締まり
decamp	野営を引き払う
vocalize	声を出す|しゃべる|歌う|発音する|母音化する|言う
ghoulish	残忍な
unadorned	簡素な
achillea	any of several plants of the genus Achillea native to Europe and having small white flowers in flat-topped flower heads
arbitrariness	移り気|気まぐれ
paramedical	(看護婦・衛生兵などとして)医療の補助をする
microsurgery	顕微解剖|顕微手術(顕微鏡を見ながら組織や細胞を手術する技術)
plaint	〈C〉〈U〉不平|苦情|〈U〉《古》悲しみ|嘆き
fealty	(fíː(ə)lti)|忠誠|忠義
dendrite	樹状突起
tricuspid	(歯が)三つの先端のある|尖弁の
amphipod	端脚類
whoso	=whoever
vendee	買い主|買受人
sideman	(バンド・オーケストラの)器楽奏者|伴奏器楽奏者
synthesiser	シンセサイザー
sunstone	サンストーン
souther	強い南風
investiture	授与|任官|叙任
inderal	the first beta blocker (trade name Inderal) used in treating hypertension and angina pectoris and essential tremor
undeterred	引き止められていない|阻止されていない
balthasar	バルタザル|バルサザール
leftwing	左翼の政党(団体)|(政党・団体内の)左派(急進分子)
borosilicate	a salt of boric and silicic acids
ourself	myself|君主の公式用語･新聞の社説用語
efferent	遠心性の|(反)afferent
invariable	不変の
southey	サウジー
triiodothyronine	リオチロニン
cloche	(苗・若芽を保護する)つり鐘形(屋根形)のガラスおおい|つり鐘形の婦人帽
cohoe	fatty pinkish flesh of small salmon caught in the Pacific and Great Lakes|small salmon of northern Pacific coasts and the Great Lakes
bikeway	自転車専用道路|サイクリングコース
hypatia	Greek philosopher and astronomer; she invented the astrolabe (370-415)|Greek philosopher and astronomer|she invented the astrolabe (370-415 )
interpose	(会話や話などへ)〈批評・質問など〉‘を'差しはさむ|(二つの部分・物・場所などの間に)〜‘を'置く|挿入する(insert)《+『名』+『between』(『among』)+『名』》|〈異議〉‘を'唱える|〈拒否権〉‘を'発動する|割り込む|邪魔する
quesadilla	a tortilla that is filled with cheese and heated
ardently	熱烈に
bubonic	(医)横痃(おうげん)|もものつけねのリンパ節が炎症を起こして腫れること|黒死病(bubonic plague)
crumbly	砕けやすい
granitic	showing unfeeling resistance to tender feelings; "his flinty gaze"; "the child's misery would move even the most obdurate heart"|showing unfeeling resistance to tender feelings|hard as granite; "a granitic fist"|hard as granite
untried	試みられない|未経験の|未審理の
ruggedness	強靭さ|頑丈さ|凹凸|難さ
bronchus	気管|気管支
midriff	横隔膜
copse	雑木林|低林|矮林|低質林
boring	(人を)退屈させる(ような)
terminological	用語[上]の|専門用語[上]の:用語法の
asphyxiation	窒息
liberalise	自由化|自由化
kneecap	膝蓋骨|膝のお皿
backwardness	亜正常|遅滞
jammies	パジャマ
undiminished	減じていない|衰えない
mazel	運|好運
adsorb	〈ガス・液体など〉'を'吸着する
caput	頭|頭部
headman	首長|酋長|長
unforced	not brought about by coercion or force; "the confession was uncoerced"|not brought about by coercion or force|not resulting from undue effort; not forced; "a voice with a pleasingly unforced quality"; "his playing is facile and unstrained"|not resulting from undue effort|not forced
machiavellian	a follower of Machiavelli's principles|of or relating to Machiavelli or the principles of conduct he recommended; "Machiavellian thinking"|of or relating to Machiavelli or the principles of conduct he recommended
clammy	冷たくべとべとする|じとじとする
misdirection	宛先間違い
cholecystitis	胆嚢炎
slaying	殺人|圧倒すること
peavy	a stout lever with a sharp spike; used for handling logs|a stout lever with a sharp spike|used for handling logs
culm	stem of plants of the Gramineae
phaseolus	herbs of warm regions including most American beans
sidle	横歩きで進む|こそこそ歩く
reification	具体化;具象|具体物
indisputably	明白に
fluoroscopy	examination of body structures using a fluoroscope
percolator	パーコレーター|コーヒー沸かし器
houseplant	室内用鉢植え植物(のように家にじっとしている人)|出不精|おたく族
desiccation	脱水|乾燥|乾燥
succubus	サッキュバス|サクバス|夢魔(むま)淫魔|キリスト教の悪魔|夢の中に現れ性交を行う|女性型Succubus(は男性を誘惑し精を奪う
acerbic	刺々しい|酸っぱい|苦い|渋い
bitartrate	an acid tartrate; a hydrogen tartrate|an acid tartrate|a hydrogen tartrate
demote	の地位を下げる|(n|demotion)
flogger	a torturer who flogs or scourges (especially an official whose duty is to whip offenders)
deism	自然神教|理神論
survivable	存続可能な
shuttlecock	(バドミントンの)羽根
latterly	頃年|最近|この間|此の間|この節|此の程|此の節
disadvantageous	不利な
fiord	フィヨルド|峡湾
sprit	a light spar that crosses a fore-and-aft sail diagonally
flagella	flagellumの複数形
cohan	コーハン
philological	言語学の
enamour	引き付ける|引付る|魅惑|掴む|引付ける|惹きつける|引きつける|チャーム|捉らえる|惹き付ける
unpalatable	口に合わない|まずい|不快な
someway	どうにかして|なんとかして;どういうわけか
persistency	根気強さ|粘り|執念深さ
biracial	(特に白人と黒人の)二人種の|二民族から成る
hairstylist	理髪師|ヘアドレッサー|スタイリスト
prole	プロレタリアの(= proletarian)
bloodlust	殺意|殺害心
scarp	急傾斜|急坂
dualistic	of or relating to the philosophical doctrine of dualism; "a Manichaean conflict between good and evil"|of or relating to the philosophical doctrine of dualism
pervade	に行きわたる|に充満する|に浸透する|みなぎる|普及する|広がる|行き渡る
raspy	こするような|耳ざわりな|短気の
contextually	in a manner dependent on context
subcutaneously	皮下に
autocrat	独裁者
ovoid	卵形の
endarterectomy	動脈内膜切除
asper	20 aspers equal 1 kurus in Turkey
perestroika	(ロシア語)ペレストロイカ|1980年代後半からソビエト連邦で進められた政治体制の改革運動(改革|の意)
anaphase	細胞分裂後期|末期
aperiodic	not recurring at regular intervals
archduke	大公|(特に)旧オーストリア国皇子
cowtown	a small town in a cattle-raising area of western North America
potemkin	ポチョームキン
clambake	ハマグリ焼き[パーティー](海浜でハマグリなど海の幸を焼いて食べる)
enthuse	(〜に)熱狂する|感激する《+『about』(『over』)+『名』》|〈人〉‘を'熱狂させる|感激させる
farmworker	農場労働者
cytometric	サイトメトリー(細胞数測定の|血球計算の)
bronchiolitis	細気管支炎
emigre	移住者
egotism	自己中心主義|自己主義
dampener	a device that dampens or moistens something; "he used a dampener to moisten the shirts before he ironed them"|a device that dampens or moistens something
motherless	母のない
placing	配置
foghorn	霧笛
monosaccharide	単糖|単糖類
keratitis	角膜炎
svelte	(女性が)すらりとした|すんなりした姿の
brainpower	才智|知能|エスプリ|智恵|才|知力|学習能力|知性|頓知|ウイット
fastness	〈U〉しっかりしていること|固定|堅固|色があせないこと|〈C〉要塞(ようさい)|とりで
asymptote	(数学で)漸近線
longish	やや長い|長めの
yarder	(used only in combinations) the height or length of something in yards; "the golfer hit a 300-yarder to the green"|the height or length of something in yards
stonewash	wash with stones to achieve a worn appearance; "stonewash blue jeans"|wash with stones to achieve a worn appearance
avidly	熱心に
headmistress	a woman headmaster
confectioner	菓子製造(販売)人|菓子屋
loudmouth	大声でしゃべりまくる人|大口を叩く奴|ほら吹き|弁護士|に偉そうな口をきく
eosinophilia	好酸球増加症
interrupter	断続器
achy	うずく|痛みのある
seductively	魅惑的に
nabu	Babylonian god of wisdom and agriculture and patron of scribes and schools
representable	expressible in symbolic form; "uniquely representable in the form..."|expressible in symbolic form
unalienable	=inalienable
overreact	過剰反応する
psychophysics	精神物理学
arum	starch resembling sago that is obtained from cuckoopint root|any plant of the family Araceae; have small flowers massed on a spadix surrounded by a large spathe|any plant of the family Araceae|have small flowers massed on a spadix surrounded by a large spathe
acrid	(においなど)つんとする|辛い|苦い|冷酷な|辛辣な
uninhabitable	住居に適さない|住めない
emetic	催吐剤|吐き気を催させる|催吐性の
nonstructural	非構造的
hovel	小屋|物置|離れ家|あばら家
chari	シャリ川
brassy	真鍮の|真鍮のような|厚かましい
matey	相棒|仲間|気さくな|親しい|人付き合いがよくて
timecard	(また time sheet)タイムカード|就業時間記録カード|列車時刻表
ingeniously	独創的に
imprecision	the quality of lacking precision
snarf	失敬|掻っぱらう|がめる|窃取|掠める|くすねる|掻っ攫う|ガメる|盗みとる|ぱくる
nudibranch	ウミウシ
communitarian	共同体主義の
reticulocyte	an immature red blood cell containing a network of filaments or granules
crossbreed	〜'を'[異種]交配させる|雑種にする|交配種|雑種
discounter	ディスカウントストア|ディスカウントハウス
otorhinolaryngology	耳鼻咽喉科
paternalism	父たること|父親的温情主義|香り|人気|評判
surrealistic	起現実芝義の|シュールレアリズムの|無気味な
measurably	測ることができるほどに
overwinter	冬越|冬越し|越冬
hawkish	タカ派の
legionnaire	《しばしばL-》米国在郷軍人会員|軍団員
granulosa	顆粒
encaustic	(れんが・タイルなどが)ろう画の|ろう焼き付けした
mope	ふさぎ込む|落ち込む|意気消沈する
poulet	食鶏|チキン|鶏|ニワトリ|若鶏|若鳥|鳥肉
rutile	金紅石
hemispherical	of or relating to or being a hemisphere
troller	a fisherman who uses a hook and line
demeanour	身持|行儀|行ない|身性|仕打ち|振る舞い|身持ち|素行|行い|所作
resettle	〈人〉‘を'新しい土地に落ち着かせる|新しい土地に落ち着く
misogyny	女嫌い
articulatory	of or relating to articulation; "articulatory features"; "articulatory phonetics"|of or relating to articulation
morceau	a short literary or musical composition
fibula	(下腿部の)腓骨(ひこつ)
excruciatingly	耐え難いほどに
unceremoniously	形式張らずに|気楽に
genuineness	真偽|生粋|合法性|正真正銘|信憑性|真|信ぴょう性|真正|信頼性|真実性|確実性|正当性
impotency	非力|不能|非力さ|無力さ|無力
weepy	お涙頂戴の|ジクジク染み出させる|涙ぐんだ|涙もろい|涙を流さんばかりの|滲出する
rebind	provide with a new binding; "The tattered old book is valuable and we need to rebind it"|provide with a new binding
monomial	(数式で)一項から成る|単項式
terrine	テリーヌ
demitasse	食後の小型コーヒーカップ;その1杯分コーヒー
jihadist	聖戦に関与しているイスラム教徒
pedagogue	教師|先生|学者ぶる人|物知り顔をする人
frictionless	lacking all friction; "a perpetual motion machine would have to be frictionless"|lacking all friction
brouhaha	(brúːhɑːhὰː)|世論の沸騰|大騒ぎ
saquinavir	サキナビル
antiferromagnetic	反強磁性
skua	オオトウゾクカモメ(北大西洋産の海鳥)
vagal	of or relating to the vagus nerve
inspiratory	吸気の
minutely	細かく
bellhop	=bellboy
landmass	大陸地
seditious	扇動的な|反乱の
inarticulate	あいまいな|発音の不明瞭な|口がきけない|関節のない
strudel	シュトルーデル(リンゴなどの果物･チーズを薄い生地に巻いて焼いた菓子|語源ドイツ語)
publishable	suitable for publication
proinflammatory	前炎症性
defeatist	敗北主義者
predication	(logic) a declaration of something self-evident; something that can be assumed as the basis for argument|a declaration of something self-evident|something that can be assumed as the basis for argument
hyperventilation	an increased depth and rate of breathing greater than demanded by the body needs; can cause dizziness and tingling of the fingers and toes and chest pain if continued|an increased depth and rate of breathing greater than demanded by the body needs|can cause dizziness and tingling of the fingers and toes and chest pain if continued
labyrinthine	迷路のような
coruscant	閃々たる|輝かしい|赫灼たる|烱烱たる|金ぴか|煌か|烱々たる|きんきら|きららか|さん然たる
erbium	エルビウム(希土類元素;化学記号は『Er』)
hardhat	建設工事従事者|保安帽|保護用ヘルメット|保守主義者
dripping	ぽたぽた落ちる|したたること
lamppost	街灯の柱
ixc	being nine more than eighty
eruptive	噴出する;突発する;爆発しがちな|噴火する;噴火による
cholecystokinin	コレシストキニン
asceticism	禁欲主義|苦行(生活)|修徳(主義)
subjugate	を支配(征服)する|征服する|を押さえる|征伐する
simultaneity	同時に存在する(起こる|作用する)こと|同時性
facultative	任意
adulterous	偽の|姦通の|不義を犯す|不純な|浮気症の
slyly	ずるく|陰険に|ちゃめに
almshouse	《おもに英》救貧院|養老院
haberdashery	《英》〈U〉小間物類;〈C〉小間物販売店|《米》〈U〉紳士用服飾類;〈C〉男子用服飾品販売店
woodsy	森林の|森林を思わせる
scopolamine	スコポラミン|アルカロイド(Alkaloid)の一種で|虹彩括約筋の弛緩による散瞳|心拍数の上昇などを引き起こす
campanula	ホタルブクロ(つり鐘状の花をつける植物)
meronym	部分
phloem	師部|師管部(植物の維管束を組織する)
moleskin	モグラの毛皮|モールスキン(昔|衣服・帽子を作ったじょうぶで滑らかな綿布)
deferential	敬意を表する|うやうやしい
stomatal	relating to or of the nature of or having a mouth or mouthlike opening|relating to or constituting plant stomata; "stomatal openings"|relating to or constituting plant stomata
packman	棒手振り|糶り売り|担い商い|糶売り|担商い|振売り|旅商い|行商人|競り売り|担屋
chortle	(うれしそうに･満足げに)声高に笑う|笑い
coterie	仲間|連中|同人|社交仲間|サークル
holonym	a word that names the whole of which a given word is a part; "`hat' is a holonym for `brim' and `crown'"|a word that names the whole of which a given word is a part
capstan	キャプスタン(テープレコーダー等の巻上げ装置)|碇を巻き上げる装置
caudate	尾状核|尾状核|尾状核|尾状核
electroporation	電気穿孔法|電気パルスで細胞膜に微小な穴を空け|DNAを細胞内部に送り込むなどに利用
freemason	フリーメーソン(秘密結社)|その会員
magnanimous	寛大な
ceftriaxone	セフトリアキソン
guttural	(gˈʌṭərəl)|のどの|のどから出る|(音声)喉音(k|g|xなど)
aleve	a nonsteroidal anti-inflammatory drug (trademarks Aleve and Anaprox and Aflaxen) that fights pain and inflammation
calcify	〜'を'石灰質にする|石灰化させる|石灰質になる|石灰化する
spacesuit	宇宙服
endodontic	of or relating to or involving or practicing endodontics; "an endodontic specialist"|of or relating to or involving or practicing endodontics
gadgeteer	a person who delights in designing or building or using gadgets
barreled	put in or stored in a barrel; "barreled beer"|put in or stored in a barrel|(of an arrow) tapered toward both ends
uncharacteristic	特質のない
namer	a person who gives a name or names; "the owner is usually the namer of a boat"|a person who gives a name or names
scorcher	焦がすもの(人)|《単数形で》《話》焼けつくように暑い日|《単数形で》《俗》痛烈(しんらつ)なもの
accumulative	蓄積する|蓄財する;ためこみ主義の
faker	ペテン師|詐欺師|(ニセ物を売る)行商人
rhabdomyosarcoma	横紋筋肉腫
breslau	ブロツラフ
heckle	質問攻めにする|妨害する|野次り倒す|詰問する
boondoggle	革の編みひも|手細工品|無用な仕事(をする)
unreality	非現実性
brassiere	ブラジャー
klystron	クライストロン
tubeless	チューブ無しの
hotbox	熱軸箱(機関車などの過熱した軸を受ける箱)|女性の膣
besiege	包囲攻撃する|包囲する|殺到する|悩ませる
ileal	回腸の
haemorrhagic	出血性
benzine	ベンジン(石油から採る揮発油)
corrida	コリーダ|闘牛|角牛
waft	ふわりと運ぶ|浮動する|漂わせる|ひと吹きの風
candelabra	燭台
lymphadenopathy	リンパ節腫脹
monkfish	アンコウ|(=anglerfish)
draughtsman	=draftsman
metaphoric	比喩的な|隠喩的な
hogmanay	New Year's Eve in Scotland
virile	男性的な|男盛りの|雄々しい
washboard	波よけ板|洗濯板|幅木
poignancy	辛辣さ|激しさ痛切さ
shrift	(古)(司祭にする)ざんげ
pachinko	パチンコ
detestable	憎悪すべき|ひどくいやな|いまわしい
adlib	〈楽譜にないもの〉'を'即興的に歌う(演奏する)|〈台本にないせりふ〉'を'即興的にしゃべる|即興的に歌う(演奏する|しゃべる)|《名詞の前にのみ用いて》即興の|アドリブの|アドリブで|即興で|アドリブ|即興的な演奏(演技|せりふ)
rozelle	ローゼル
swayback	(特に馬の)脊柱湾曲
nonnative	not being or composed of aborigines; "the nonnative population of South Africa"|not being or composed of aborigines|of persons born in another area or country than that lived in; "our large nonnative population"|of persons born in another area or country than that lived in|of plants or animals originating in a part of the world other than where they are growing
parishioner	教区民
hoarseness	嗄|擦れ
meritocracy	実力社会
machismo	(スペイン語)男らしさ|マチスモ
redbone	a speedy red or red-and-tan American hound
sclerotic	(組織・血管などが)硬化した|硬化症の
docker	ドック作業員
parkinsonism	パーキンソニズム|パーキンソニスムス|パーキンソン症|振戦麻痺|パーキンソン症候群|パーキンソン病
costing	原価計算
ramipril	an ACE inhibitor (trade name Altace) used to treat high blood pressure or in some patients who have had a heart attack
quadric	二次曲面
ellas	ギリシア|ギリシャ|ギリシャ共和国
debonair	陽気な
omnivore	a person who eats all kinds of foods|an animal that feeds on both animal and vegetable substances
neurobiological	with respect to neurobiology; "explain the phenomenon neurobiologically"|with respect to neurobiology|of or relating to the biological study of the nervous system
retinoid	(生化学)レチノイド(=ビタミンA) 2|網膜(retina)状の
indignantly	憤然として|腹を立てて
bucolic	羊飼いの|牧歌的な|田園生活の|田舎風の|(rural)
pentobarbital	ペントバルビタール
disaffection	(政府などへの)不満|不平|離反
utu	sun god; counterpart of Akkadian Shamash|sun god|counterpart of Akkadian Shamash
flocculation	綿状沈殿
redoubt	(小さな応急の)とりで|要塞
fetishist	呪物崇拝者
unaddressed	not addressed; "an unaddressed envelope"|not addressed
semicircle	半円(形の物)
decouple	disconnect or separate; "uncouple the hounds"|disconnect or separate|regard as unconnected; "you must dissociate these two events!"; "decouple our foreign policy from ideology"|regard as unconnected|eliminate airborne shock waves from (an explosive)|eliminate airborne shock waves from (an explosive) |reduce or eliminate the coupling of (one circuit or part to another)|reduce or eliminate the coupling of (one circuit or part to another) 
blessedness	至福|幸い
grackle	ムクドリの類
tailwind	追い風
apotheosis	(人を)神に祭ること|神格化|神聖視|崇拝|理想|極致|究極の姿
imbroglio	複雑な筋|もつれ|紛糾|ごたごた
absorbency	吸湿性|吸収能|吸収性
gruyere	Swiss cheese with small holes
interdenominational	諸宗派間の|諸宗派共通の
librium	クロルジアゼポキシド
neurogenesis	the development of nerve tissues
tigress	雌トラ
trudge	とぼとぼ歩く|てくてく歩く|重い足取り(で歩く)
unlabelled	ノーブランドの|ラベルのない
prepositional	前置詞の|前置詞を含む
hydroxyzine	ヒドロキシジン
tenormin	アテノロール
intracerebral	脳内
tribology	トライボロジー
subphylum	亜門
mullion	窓の縦仕切り|窓の仕切り|縦仕切り|(反|transom|窓の横仕切り|横棒)
chlorhexidine	クロルヘキシジン
authoritatively	儼として|いかめしく|権威を持って
schipperke	breed of small stocky black dogs originally used as watchdogs on boats in the Netherlands and Belgium
derogate	《『derogate from』+『名』》《文》(権威・名声などを)傷つける|落とす
comber	(綿・羊毛などを)すく人|すき手;すき機|寄せてくる波
muzzleloader	(銃口から装てんする)前込め砲|前装砲
unpleasantness	不快感
collectivist	左翼
jirga	a Pashto term for a decision making assembly of male elders; "most criminal cases are handled by a tribal Jirga rather than by laws or police"|a Pashto term for a decision making assembly of male elders
pickerel	(小さな種類の)カマス
streaker	ストリーカー(裸でキャンパスや大通りを突っ走る人)
postprandial	食後の|正餐(せいさん)後の
sargasso	brown algae with rounded bladders forming dense floating masses in tropical Atlantic waters as in the Sargasso Sea
gyp	詐欺師|だます(cheat)
cleaning	掃除|洗濯|クリーニング|(俗)(ゲームなどの)大敗|惨敗|経済上の大損|丸損
dhow	ダウ船(アラビアの帆船)
townsfolk	市民
abuzz	ざわめき立って
thinness	希薄|細さ|薄弱|貧弱
ramshackle	ぐらぐらする
alkyd	アルキド樹脂
dullness	濁音
reveler	酒盛りする人|飲み騷ぐ人
heliotrope	〈C〉ヘリオトローブ(ムラサキ科の多年草;花は香気が高く香水の原料となる)|〈U〉赤味がかった簿紫色の
tagamet	シメチジン
aquiline	ワシの|ワシのくちばしのような
hatchling	any recently hatched animal (especially birds)
mystify	神秘化する|煙に巻く
uncouth	無骨な|不器用な|野暮な|未知の|洗練されていない
shrivel	縮む|縮んでしわが寄る(wrinkle)|しぼむ|しなびる|をしぼませる|をだめにする
jazzman	ジャズマン|ジャズ音楽家
captaincy	captainの地位(職)
relict	残存生物(過去の環境のなごりである動植物)|《古》未亡人|寡婦(かふ)|なごりの|残存の|遺物の
timolol	チモロール
ramie	〈C〉カラムシ(アジア産の低木で織物用の繊維が採れる)|〈U〉カラムシの繊維
glutaraldehyde	グルタルアルデヒド|有機化合物でアルデヒドの一種|殺菌消毒薬
lycopersicon	tomatoes
turtledove	キジバト
holdback	〈U〉抑制|妨害|〈C〉(馬車のながえに取り付けた)制御用の留め金
photocell	=photoelectric cell
crossly	ふきげんに|むっとして;すねて|逆に|不利に|横に|斜めに
supplicant	嘆願者|哀願者
hadst	=had|haveの二人称単数・過去形
pyroxene	輝石
antipasto	(食事の主品の前に出る)前菜
catechist	教義問答師|問答式教義
bodacious	横風|破廉恥|靦然たる|ずうずうしい|いけ図図しい|僭上|憎々しい|驕傲|不遜|野面皮
anaglyph	moving or still pictures in contrasting colors that appear three-dimensional when superimposed|anything carved in low relief
incumbency	義務があること|義務|聖職禄所有者(incumbent)の役目(任期)
renege	約束を破る
tropopause	圏界面(対流圏と成層圏との境界の大気層)　対流圏界面
curvaceous	(女性が)曲線美の|セックスアピールのある
apprise	に通知する|知らせる|通告する
individualize	に個性を与える
exponentiation	対合|べき乗
lank	ひょろ長い|(毛髪が)だらんと生気なく垂れた
ergot	麦角(ばっかく)病(麦角菌によるライ麦など穀物の病気)|麦角(止血剤・子宮収縮剤用)
zealously	熱心に|熱狂的に
pneumonitis	inflammation of the lungs; caused by a virus or an allergic reaction|inflammation of the lungs|caused by a virus or an allergic reaction
midair	空中(の)
dowager	貴族未亡人|王侯の未亡人|(口)威厳のある年配の婦人
housemaid	家政婦|手伝い|女中
gateau	クリームケーキの一種
bisection	二つに分けること;2等分
workability	可動性;実行可能でありそうなこと;実用性
papain	パパイン
trivalent	(原子価が)3価の
olla	leaf or strip from a leaf of the talipot palm used in India for writing paper
eglise	教会のフランス語|église
sentience	直観|感覚性|知覚力
dioxygenase	ジオキシゲナーゼ|二原子酸素添加酵素
impetigo	飛び火
cuvier	キュビエ
glyburide	グリブリド
legitimise	法律化|合法化|合法化する
cravat	ネクタイ|(首の前で結ぶ)スカーフ
unimpaired	not damaged or diminished in any respect; "his speech remained unimpaired"|not damaged or diminished in any respect
corporatism	control of a state or organization by large interest groups; "individualism is in danger of being swamped by a kind of corporatism"|control of a state or organization by large interest groups
bindweed	ヒルガオの類の植物
resample	リサンプル
shitload	大量のもの
heedless	無頓着な
rancor	恨み|悪意|怨恨
transcultural	extending through all human cultures; "a transcultural ideal of freedom embracing all the peoples of the world"|extending through all human cultures
cere	蝋膜(ろうまく)|ろうびき布で包む
agon	a festivity in ancient Greece at which competitors contended for prizes
providential	神慮の|神意による|神の助けのような|幸運な(lucky)
carload	(〜の)貨車1両分の貨物《+『of』+『名』》
boilermaker	ボイラー製造企業
hollandaise	eggs and butter with lemon juice
daresay	《『daresay+that節』》〜であるとあえて言う|疑いのない|たぶんそうだ(dare say)
liberality	〈U〉寛大;偏見のないこと|〈U〉気前のよさ|《複数形で》《文》気前のよい贈り物|施し
passiflora	type genus of the Passifloraceae
toolshed	木屋
ossification	骨化(した組織)|(感情などの)無感覚化
unthinking	考えのない|軽率な|思考力のない|気がつかない
cresol	クレゾール
impale	突き刺す|刺し貫く
dimorphism	二形性(同種の生物が異形態をもつこと)
mottle	《受動態で》〜‘を'まだらにする|ぶちにする|ぶち|まだら|斑(はんてん)
speechwriter	スピーチライター
xylose	木糖|キシロース
legalisation	合法化
inestimable	測りしれないほど大きい(貴重な)|(非常に貴重で)評価できない
pyridoxal	ビタミンＢ６|ピリドキサール
chlamydial	of or pertaining to the sexually transmitted infection or to the parasite
microsecond	マイクロ秒(1秒の100万分の1)
earlobe	耳たぶ
malinois	fawn-colored short-haired sheepdog
turnstile	回転ドア
inductee	徴募兵
quadrennial	4年ごとの|4年間続く|4年の期間|4年ごとの行事
seismograph	地震計
folktale	伝説物語|民間説話|民話
gutless	意気地(根性)のない
desipramine	デシプラミン
scriptorium	a room in a monastery that is set aside for writing or copying manuscripts
enbrel	エンブレル|エタネルセプト
ignoble	下品な|生まれの卑しい|見さげはてた
otoscope	耳鏡
jeroboam	ジェロボーアム(3リットル入りのワインびん)
doppelganger	二重身
timidly	おくびょうに|びくびく(おどおど)して
greyish	=grayish
imitative	模倣の|真似好きの|擬音的な
concordant	一致した
mazer	a large hardwood drinking bowl
reductionist	of or relating to the theory of reductionism; "reductionist arguments"|of or relating to the theory of reductionism
bibliomania	ビブリオマニア
suffragette	女性の婦人参政権論者
repentant	後悔している
chopstick	箸|はし
edify	を強化する|啓発する|の精神を高揚する|教化する
iconoclastic	聖像破壊の|因襲打破の
redaction	編集|編修|編輯|作文
meanness	つまらなさ|粗悪|貧弱さ|卑しさ|野卑|卑劣|けち|卑劣な言行
arboreal	樹木の|樹木状の|木にすむ|樹上性の
inhalant	吸入剤
unassailable	攻めることのできない|難攻不落の
disharmony	不調和
overstatement	誇張|大げさな話|誇張した説明
conceptualisation	概念化|構想
culex	イエカ属
orthostatic	起立性
mammon	(悪の根源としての)富|財宝|《M-》(富・強欲の擬人的偶像としての)マモン神
discoverable	発見できる|気付くことができる
atrophic	萎縮性
husbandman	農夫
molehill	モグラ塚|何でもない事
whir	ひゅーと飛ぶ|ひゅーという音|びゅ-と飛ぶ|ブンブン音を立てて回る|ブンブンいう音
titmouse	シジュウカラの類の小鳥
revivalist	信仰復興論者
audiocassette	a cassette for audiotape
wheelhouse	(小型旧式船の)操舵(そうだ)室
recency	時間的に近いこと|最近であること
quadriplegic	四肢麻痺の(患者)
kidnapper	誘拐犯
pfennig	ペニッヒ(西ドイツ青銅貨;1|100ドイツマルク)
chauvinist	偏愛主義者|狂信的愛国主義者
facetious	冗談の|滑稽な|ひょうきんな|愉快な
dressmaking	婦人服仕立[業]|洋裁
blithering	ばかげたことを言う
integrase	インテグラーゼ|ウイルスDNAを細胞染色体につなぎ合わせる酵素
knap	打つ|叩く|切る|剪裁|切り放す|剪除|削る|截断|上げ離す|截ち切る|切り裂く|切り取る
penicillium	genus of fungi commonly growing as green or blue molds on decaying food; used in making cheese and as a source of penicillin|genus of fungi commonly growing as green or blue molds on decaying food|used in making cheese and as a source of penicillin
engorge	食い過ぎる|喰過ぎる|貪食|食過ぎる|食べすぎる|喰い過ぎる|暴食|食べ過ぎる
civilly	ていねいに|礼儀正しく
inquisitively	興味ありげに|物珍しげに
unhurt	けがのない|害を受けない
incredulity	容易に信じないこと|疑い深いこと
rebuff	そっけない拒絶|拒絶(する)|ひじ鉄砲(を～に食わせる)|挫折させる
untaxed	(of goods or funds) not taxed; "tax-exempt bonds"; "an untaxed expense account"|(of goods or funds) not taxed
minimus	the fifth digit; the little finger or little toe|the fifth digit|the little finger or little toe
epididymis	精巣上体 (精子を蓄え|精管へ送り出す精巣内の管)
interlayer	中間層
colorblind	色盲
obligee	債権者|権利者|恩を受けた人
briard	old French breed of large strong usually black dogs having a long tail and long wavy and slightly stiff coat
instinctual	instinctive|本能の|本能的な|天性の|直覚的な
exhumation	発掘
shorebird	海辺の鳥(クサシギ・タシギ・チドリなど)
colorize	色つけ|染める|色付け|色取る|絵どる|色取|着色|色付|彩色|染めつける
businesslike	実務的な
attachable	capable of being fastened or added to something else; "a handle attachable by two bolts"|capable of being fastened or added to something else
begrudge	出し渋る
frill	フリルを付ける|フリル
netizen	ネット空間の市民の意|ネット利用者
diacritical	区別に役立つ;発音を区別する
landward	陸の方へ|陸に向かって|(海岸から離れて)陸地寄りにある|陸に面した;陸地の方へ向かう
amusingly	面白おかしく
ostentatious	見せびらかしの|これみよがしの|見栄を張る|けばけばしい
spacial	空間的
weakling	弱虫の|虚弱者|弱虫|弱い
tannic	タンニンの;タンニンから得た
penciled	鉛筆で描かれた|鉛筆で記された|鉛筆で書かれた|鉛筆書きの
midsection	胴中
multicoloured	多彩
merl	ブラックバード
rhodolite	ロードライト
shylock	高利貸し
subdural	硬膜下
snigger	くすくす笑う|忍び笑い
mooch	(俗くそったれ|素人投資家|だまされやすい奴|バーゲン商品をあさる客|くすねる|ずる休みする|ねだる|ぶらつく|知らん顔をする
sacrum	仙骨(腰椎(ようつい)と尾骨の間の骨)
apheresis	(linguistics) omission at the beginning of a word as in `coon' for `raccoon' or `till' for `until'|omission at the beginning of a word as in `coon' for `raccoon' or `till' for `until'|a procedure in which blood is drawn and separated into its components by dialysis; some are retained and the rest are returned to the donor by transfusion|a procedure in which blood is drawn and separated into its components by dialysis|some are retained and the rest are returned to the donor by transfusion
spherically	in a spherical manner; "spherically shaped"|in a spherical manner
underlayment	a pad placed under a carpet
ratepayer	地方税納税者
gnarl	(木の)節(ふし)|こぶ
silverside	トウゴロイワシ(縞模様がある小型の魚)|(主に英国)牛のもも肉の上の部分
nontaxable	(of goods or funds) not subject to taxation; "the funds of nonprofit organizations are nontaxable"; "income exempt from taxation"|(of goods or funds) not subject to taxation
covetousness	an envious eagerness to possess something
headwind	(船･飛行機などの)向い風|逆風
hurler	投手
piebald	(特に馬などが)白黒まだらの|(特に)白黒まだらの馬
unawares	不意に|思いがけなく
scornful	冷笑的な|軽蔑した|横柄な
vitriolic	辛らつな
offscreen	画面外の
newfangled	新奇の|新式の|最新流行の
crosswise	十字に|すねて
coinfection	同時感染
overstay	国内在留期間切れで不法に残る人|長居する|売り時を逃す|売り時を失する
tuneful	旋律の美しい
birefringence	複屈折
interpretable	説明可能
disillusion	幻滅
ablative	奪格|名詞の格の一つで|主に起点･分離(～から)を示す
barbarity	〈U〉野蛮|非道|〈C〉野蛮な行為|残虐行為
abbess	尼僧院長|修道女の長
ipomoea	サツマイモ属
uremic	高窒素血症
mescaline	メスカリン(メスカルより採取した幻覚作用のある薬)
connecter	コネクタ|つなぎ|繋ぎ|プラグ|コネクター
humdrum	単調な|退屈な|平凡な|退屈な話
telomeric	テロメア(telomere)の
solidago	goldenrod
capitulate	降伏する|抵抗をやめる|交渉する|屈服する
commonweal	公共の福利(福祉)
neocortex	新皮質
rentable	that is able or fit be rented
cyanocobalamin	シアノコバラミン|ビタミンＢ１２|コバラミン
hypoplasia	形成不全
autoantigen	自己抗原
fatness	肥満
mincer	ひき肉機
bookbinder	製本屋
macron	長音符(記号)(母音の上につけて長母音を示す)
offstage	舞台裏|舞台横の(で)
paintwork	(自動車などの)塗装された面
danceable	suitable for dancing
presumptively	多分|大方|おおかた|おそらく
censer	(特に教会の儀式のときに用いる鎖のついて)つり香炉
fixedly	しっかりと固定して;動かさないで
feebly	弱々しく
claudication	跛行|gimp
prurient	好色な|いん乱な|わいせつな
swage	型鉄|〜‘を'型鉄で曲げる(型をつくる)
spritz	a quick squirt of some liquid (usually carbonated water)|eject (a liquid) quickly; "spritz water on a surface"|eject (a liquid) quickly|cover (a location) wholly or partially by squirting a liquid onto it; "Spritz the lawn with water"|cover (a location) wholly or partially by squirting a liquid onto it
panopticon	an area where everything is visible|a circular prison with cells distributed around a central surveillance station; proposed by Jeremy Bentham in 1791|a circular prison with cells distributed around a central surveillance station|proposed by Jeremy Bentham in 1791
myositis	inflammation of muscle tissue
nightshift	〈C〉(昼夜交替制の)夜勤[時間]|〈U〉《the ~》《集合的に》(工場などの)夜間労働者
defecation	脱糞|排便
threadbare	(衣服などが)すり切れて糸目の見える|着古した|(人が)みすぼらしい身なりの|陳腐な|言い古された
anglicanism	the faith and doctrine and practice of the Anglican Church
flakey	奇奇怪怪|突飛|奇抜|奇怪千万|異常|狂逸|怪奇|風変わり|珍妙|けったい
pallone	an Italian game similar to tennis
uneconomic	むだづかいをする|浪費の|不経済な
felly	rim (or part of the rim) into which spokes are inserted
pillory	さらし台|さらし台にさらす
microglia	neuroglial tissue of mesodermal origin that can become phagocytic
pitot	ピトー|ピトー
decolonization	脱植民地化
excreta	排出長(汗・尿・便など)
crewel	ししゅう用の毛糸
recordist	(特に映画の)録音係
recommence	cause to start anew; "The enemy recommenced hostilities after a few days of quiet"|cause to start anew|begin again; "we recommenced his reading after a short nap"|begin again
polymyxin	ポリミキシン
militate	不利に作用･影響する
armorer	a worker skilled in making armor or arms; "a sword made by a famous English armorer"|a worker skilled in making armor or arms|an enlisted man responsible for the upkeep of small arms and machine guns etc.|a manufacturer of firearms
overstep	の度を超す|行き過ぎる|踏み超える
interrelation	(〜の間の)相互関係《+『between』+『名』》
traumatise	傷害
conveyer	コンベヤ|運搬人|運搬機|運搬装置|輸送装置|伝達者|譲渡人
piffle	センスのないくだらん話
parolee	仮出所者
echidna	ハリモグラ|ハリモグラ
jabberwocky	nonsensical language (according to Lewis Carroll)
mauritian	a native or inhabitant of Mauritius|of or related to the island or country of Mauritius or its inhabitants; "Mauritanian tropical fish"|of or related to the island or country of Mauritius or its inhabitants
festoon	花づな|花綱(で飾る)
insurability	the quality of being insurable; the conditions under which an insurance company will issue insurance to an applicant (based on standards set by the insurance company)|the quality of being insurable|the conditions under which an insurance company will issue insurance to an applicant (based on standards set by the insurance company)
fatherly	父の|父らしい|慈父のような
microinjection	マイクロインジェクション(微小噴射)
naismith	ジェームズ・ネイスミス
clavicle	鎖骨(collarbone)
quantic	a homogeneous polynomial having at least two variables
reprove	に小言を言う|を叱る|非難する|意見する
moliere	モリエール
caricaturist	[風刺]漫画家
unfeasible	不可能
talcum	=talcum powder|=talc
palatal	《名詞の前にのみ用いて》口蓋(こうがい)の|(子音の発音が)硬口蓋音の|硬口蓋音
adenoid	咽頭扁桃|アデノイド
anatomist	解剖学者
ductility	引き伸ばせること|《文》従順
bugler	らっぱ手|らっぱ吹き
licentiate	(特に大学の発行する)免許状所有者|開業有資格者
permute	〜‘の'順序を変える|(数学で)〈数〉‘を'置換する
inflammable	可燃性の
antonym	反意語|反義語
nougat	ヌガー(木の実がはいった砂糖菓子)
inerrancy	(Christianity) exemption from error; "biblical inerrancy"|exemption from error
sleuthing	検出|探偵|検波
phenelzine	フェネルジン
sheldrake	アイサ
headship	the position of headmaster or headmistress|the position of head
multifactorial	(生命科学)多因子性の
unheeded	注意されない|重大な結果を招く
reviser	校閲者|監修者;校正をする人|再履修者
recuse	忌避する
antiquary	=antiquarian
fictionalize	ノベライズ
proclaimer	(公式の)宣用者|公布者|言明者
mantissa	(対数の)仮数
skittish	(馬などが)ものに驚きやすい|ものおじする|(女)はねっ返りの|おてんばな
nacelle	(飛行機の)機関室|乗務員室
sacrosanct	特に神聖な|至上神聖な|犯すべからざる
revetment	(石やれんがの)擁壁(ようへき)|(特に)護岸舗装
whacky	=wacky
legalism	お役所的形式主義|規則一点張り|法律上の事柄|法律尊重主義|法律問題
negus	ニーガス酒(ワイン・湯・砂糖・香料などを混ぜて作った飲料)
netherworld	下界|地獄
prostration	へばり|意気消沈|衰弱|平伏
underbody	下腹部
overflight	a flight by an aircraft over a particular area (especially over an area in foreign territory)
pyelonephritis	腎盂腎炎
oblation	《しばしば複数形で》《文》(神への)奉納物|供物;(聖体祭儀の)パンとぶどう酒
moonstruck	気のふれた
tawdry	安ぴかの|趣味の悪い
agglomerate	〜'を'固まりにする|固まりになる|固まった|塊状の|固まり|球塊|(溶岩が冷えて固まった)集塊岩
juncus	type genus of the Juncaceae; perennial tufted glabrous marsh plants of temperate regions: rushes|type genus of the Juncaceae|perennial tufted glabrous marsh plants of temperate regions: rushes
mitogenic	分裂促進
turnabout	方向転換|(思想･政策)転向|裏切り|変節
camomile	カミツレ(においの良い白と黄の花のキク科の植物)
choreograph	(バレエの)振付けをする
classicist	古典学者|古典語教育主張者|古典主義者|古典文学者
sarda	サルダ川
intellectualism	知性を働かすこと|知笛追求への専念;知性主義
orchestrator	an arranger who writes for orchestras
solicitous	気づかう
mullein	any of various plants of the genus Verbascum having large usually woolly leaves and terminal spikes of yellow or white or purplish flowers
conveyancer	財産譲渡専門弁護士
cattleya	カトレア
hulking	かさばった
loosestrife	トラノオ|ミソハギ|トラノオ
kasai	a river of southwestern Africa that rises in central Angola and flows east and then north (forming part of the border between Angola and Congo) and continuing northwest through Congo to empty into the Congo River on the border between Congo and Republic of the Congo
wheatfield	麦畑
coneflower	any of various plants of the genus Rudbeckia cultivated for their large usually yellow daisies with prominent central cones|a wildflower of the genus Ratibida|any of various perennials of the eastern United States having thick rough leaves and long-stalked showy flowers with drooping rays and a conelike center
chitchat	雑談|世間話|世間話をする
loblolly	濃いかゆ
pincushion	針差し|針山
photoperiod	photoperiod照光時間|日長|光周期
marineland	a commercial aquarium featuring trained dolphins
melter	a worker who melts substances (metal or wax etc.)
snapdragon	金魚草
strychnine	ストリキニーネ(有毒の結晶で中枢神経の興奮剤)
unappreciated	not likely to be rewarded; "grading papers is a thankless task"|not likely to be rewarded|having value that is not acknowledged
waybill	運送目録|貨物運送状;乗客名簿
reveille	起床らっぱ･太鼓
shtick	お決まりのギャグ|特技|特殊な才能|特別の興味
gamete	(生物)配偶子|生殖体(高等動物の卵と精子の総称)
unplayable	(クリケットで)球がうまく飛んで打ち返されない:(ゴルフボールの位置が)打球不可能な位置の|(競技場が)競技[総行]に不適当な|(破損や録音状態が不良で)レコードが満足にかけられない|(曲が難しすぎて)演奏できない
splashy	はねを上げる(上げやすい)|斑点(はんてん)(しみ)だらけの|《おもに米》評判の|はでな|目立つ
derringer	デリンジャー式ピストル(短い銃身で口径が大きい)
mesmerise	磁化
subcortical	皮質下
writhe	もがく|悶え苦しむ|のたうち回る|ねじ曲がる
perineum	(女性陰部の)会陰(えいん)
soymilk	豆乳
pittance	わずかな手当(収入)|少量|少数
snatcher	ひったくり
salacious	みだらな|わいせつな
sapient	賢い
dichloromethane	ジクロロメタン
sinfulness	姦邪|罪悪|よこしま|罪|悪行|罪深いこと|罪咎|悪事|罪科|罪過
recapitulation	要点の繰り返し|要約
hydrophobicity	疎水性
oglala	a member of the Siouan people who constituted a division of the Teton Sioux and who formerly inhabited the Black Hills of western South Dakota|a Siouan language spoken by the Oglala
creaky	きしる|軋み音を立てる
titbit	=tidbit（うまい物の）ひと口; おもしろいニュース）
tati	ジャック・タチ
chassidic	of or relating to the Jewish Hasidim or its members or their beliefs and practices
convalescence	病気の回復|回復期
lithic	石（質）の・(膀胱(ぼうこう)などにできた)結石の
hijacking	ハイジャック
jihadi	of or relating to a jihad
snowsuit	スノースーツ
unceasing	絶え間ない|連続した
disdainful	軽蔑的な|尊大な
martinet	(規則|命令に絶対服従の)厳格な人(軍人)
comity	礼譲|礼節|the comity of nations|国際礼譲(各国が他国の法律･制度を尊重する親交関係にあること)
amortise	償却する
carrell	small individual study area in a library
dinge	discoloration due to dirtiness|make a dent or impression in; "dinge a soft hat"|make a dent or impression in|make dingy
dryly	乾燥して|冷淡に
ellipsoidal	having the nature or shape of an ellipsoid
ingratitude	忘恩の|恩知らずの|不義理の
pathophysiological	病態生理学的な
sportscaster	スポーツキャスター
amnesiac	記憶喪失者|健忘症患者|記憶喪失症の
paean	勝利(感謝)の歌|賛歌
largesse	過分の祝儀|贈り物|祝儀|気前のいい援助
lorikeet	any of various small lories
tumescent	腫れた
mycelium	菌糸体
bleary	ぼやけた
splenectomy	脾臓摘出
pediment	ペディメント|古代建築の三角形の切妻壁(gable)
poppet	(かわいがっている)子供(動物);《呼びかけ》かわいい子ちゃん
restive	いらいらした|手に負えない|反抗的な
hackneyed	陳腐な|使い古した|言い古された|ありきたりの
flagellum	(バクテリアなどの)鞭毛(べんもう)|むち
farad	ファラッド(静電気容量の実用単位)
handbasket	バスケット|提篭|提げ篭|手籠|籠|手かご|手篭
naivete	素朴|単純
rambunctious	手に負えない|乱暴な|気ままな|やんちゃな|騒々しい|無軌道な|無法な|どたばたした|むちゃな
circuitous	遠回りの|遠回しの|回りくどい
dystrophin	ジストロフィン|細胞質タンパク質で|コスタメアと呼ばれるタンパク質複合体の一部|細胞膜を越えて筋繊維の細胞骨格とその周囲を接続する
seedbed	苗床;温床
pinger	a pulse generator used for echo sounding in sonar
choreographic	of or concerned with choreography
unmotivated	消極的
clamber	骨折ってよじ登る|よじ登る|よじ登ること
scallion	ニラネギ|ワケギ|若玉葱|ラッキョウ
reserpine	レセルピン
saccharine	サッカリン(砂糖)の(ような)|(態度･言葉･声)いやに甘ったるい
borscht	ボルシチ|牛肉をビーツ･タマネギ･にんじん･キャベツなどの野菜で煮込みサワークリームを添えて食するロシアの煮込み料理
holograph	自筆の|自筆の書類(文書)
roominess	間数の多いこと|広いこと
pastrami	パストラミ|香辛料で調味した肉の燻製食品
fundraise	資金集め
musicologist	音楽学の専門家
otho	オト
lactase	any of a group of enzymes (trade name Lactaid) that hydrolyze lactose to glucose and galactose
ocotillo	desert shrub of southwestern United States and Mexico having slender naked spiny branches that after the rainy season put forth foliage and clusters of red flowers
turning	回転|旋回|転向|曲がり角|構成|形成
exoskeleton	外骨格
freeboard	乾舷(水面と船の上甲板間の距離)|喫水標(水中に沈んでいる船体の最上部)
trenchant	痛烈な
parturition	分娩(ぶんべん)|出産
conjunctiva	結膜
tench	freshwater dace-like game fish of Europe and western Asia noted for ability to survive outside water
cascara	カスカラ(米国太平洋岸産のとげのある低木)|その樹皮から採れる下剤
somite	体節(somite)|脊索動物全般に胚発生時に現れる分節構造
osteopath	整骨医
examinee	被験者|受験者
tiler	a worker who lays tile
aversive	(人間の心理が)不快な(苦しい)ことを避けようとする
carjack	take someone's car from him by force, usually with the intention of stealing it; "My car was carjacked last night!"|take someone's car from him by force, usually with the intention of stealing it
furan	フラン
corker	《俗》驚くべき人(物|事)|《英話》(議論などで)とどめの一言|決め手
girlhood	少女であること|少女時代|《集合的に》少女たち
coville	desert shrub of southwestern United States and New Mexico having persistent resinous aromatic foliage and small yellow flowers
annunciator	《米》呼び出し表示器(ブザーが鳴ってどの部屋が呼んでいるかを示す;ホテルなどで用いる)
norther	強い北風
corer	(リンゴの)しん抜き器
lodgment	bringing a charge or accusation against someone|the state or quality of being lodged or fixed even temporarily; "the lodgment of the balloon in the tree"|the state or quality of being lodged or fixed even temporarily
brass	真ちゅう|真鍮(色･製品)(の)|黄銅|ずうずうしさ|お偉方|大物
clumsiness	無器用|ぶかっこう
ascertainable	確かめられる
witless	知恵(思慮)のない|無分別な|愚かな
dweeb	つまらない人|変人|嫌な奴|うすのろ|ばか|ネクラ|マジメ学生|ガリ勉
thiazide	チアジド|心臓|肝臓|腎臓病による高血圧や浮腫を治療するために使われる利尿剤
carioca	a native or inhabitant of Rio de Janeiro|music composed for dancing the carioca|a lively ballroom dance that resembles the samba
carolus	チャールズ|シャルルマーニュ
windup	終結|仕上げ|しめくくり
nevus	母斑
crus	下腿
tranylcypromine	トラニルシプロミン
entrenchment	ざんごう掘り;〈C〉ざんごう
ichthyology	魚類学
woodhull	ウッドハル
pallor	青白さ|蒼白
exculpatory	言い訳の|弁解的な|無罪を証明する
unwholesome	健康によくない|不健全な|不健康な|病的な
triviality	些細な事
copra	コプラ(ココヤシの胚乳を乾燥したもの)
hindlimb	後肢
trophoblast	栄養膜
urokinase	(医)ウロキナーゼ|血栓溶解剤ほか|最初ヒトの尿から単離されて利用された
disciplinarian	厳格な(人)
necklet	小さな首飾り|毛のえり巻き
phosphine	ホスフィン|リン化水素
polyadenylation	ポリアデニル化|RNAにポリA鎖(poly-A tail)を付加すること|遺伝子発現過程の一部であり|ポリA鎖はmRNAの安定性に関わる
nontechnical	not characteristic of or skilled in applied arts and sciences; "nontechnical aspects of the job"; "nontechnical training"; "an untechnical reader"; "in clear effective nontechnical language"|not characteristic of or skilled in applied arts and sciences
sarsaparilla	〈C〉サルサ[パリラ](中国米に産するつる植物)|〈C〉サルサ根(薬用・シロップの香料に用いる)|〈U〉〈V〉サルサ[パリラ](サルサ根の香料人り清涼飲料)
disjunct	progressing melodically by intervals larger than a major second|having deep constrictions separating head, thorax, and abdomen, as in insects|marked by separation of or from usually contiguous elements; "little isolated worlds, as abruptly disjunct and unexpected as a palm-shaded well in the Sahara"- Scientific Monthly|marked by separation of or from usually contiguous elements|used of distributions, as of statistical or natural populations; "disjunct distribution of king crabs"|used of distributions, as of statistical or natural populations
bobwhite	コリンウズラ(北米産のウズラの一種)
clastic	(地質が)砕屑(さいせつ)性の
pallidum	淡蒼球
brawny	筋骨たくましい
gonad	性腺(せん)|生殖腺
barberry	メギ(赤くて細長く酸味のある実をつける低木)
scandium	スカンジウム(希有金属元素;化学記号は『Sc』)
embolden	励ます|大胆にする
historicity	史的確実性|歴史的実事性|史的典拠
flyweight	(ボクシング・レスリングの)フライ級の選手(112ポンド(約50.8キログラム)以下)
shinny	=shin
ventolin	アルブテロール
ilium	腸骨|腸骨
livy	ティトゥス・リウィウス
incorruptible	買収されない|腐らない;不朽の|不滅の
crataegus	クラテグス
puritanism	清教(主義)
blazon	〜'を'公表する|公告する《+『forth』(『out』|『abroad』)+『名』》|〜'を'鮮やかな色彩で飾る|〈紋章〉'を'盾(たい)に描く|〜'を'紋章で飾る|紋章
bogeyman	悪鬼|恐ろしいもの|子取り鬼|悩みの種|怖いもの
optimistically	楽観して|楽天的に
snobby	俗物の|尊大な|横柄な|偉そうな|つんとした|きざな
assiduously	熱心に
cognizable	認識できる|裁判所の管轄内の
ashlar	切り石(四角に切った建材用の石)|切り石積み(仕上げ)
enamelware	エナメル容器|ほうろう鉄器
shellshock	爆弾性ショック(戦争の衝撃による自制力・記憶力・視覚などの喪失症)
piquant	ぴりっとする
painterly	絵画的な
tularemia	野兎病
torturous	残酷な|拷問の
grump	文句を言う|不機嫌|文句ばかり言う人|こぼし屋
hexapoda	昆虫類
sebum	皮脂
fantasyland	ファンタジーランド
unreservedly	遠慮なく
eclecticism	折衷主義
squeaker	any artifact that makes a squeaking sound when used; "those sneakers are squeakers"; "which hinge is the squeaker?"|any artifact that makes a squeaking sound when used|something achieved (or escaped) by a narrow margin
inseparably	分けられないで|離れられずに
aspheric	非球面
interchangeability	the quality of being capable of exchange or interchange
sauterne	semisweet golden-colored table or dessert wine from around Bordeaux in France; similar wine from California|semisweet golden-colored table or dessert wine from around Bordeaux in France|similar wine from California
canonization	列聖|列聖式
unsinkable	incapable of being sunk; "they thought the Titanic was unsinkable"|incapable of being sunk
irenaeus	エイレナイオス
reprobate	に反対する|非難する
uncivilized	野蛮|蛮野
insensible	《補語にのみ用いて》(痛みなどに)無感覚の《+『to+名』》|意識を失った|人事不省の|《補語にのみ用いて》(〜に)無感動な|無関心な《+『to+名』》|《補語にのみ用いて》(〜に)気づかない《+『of+名』》|気がづかないほどの
cartage	荷車(馬車)による運搬[料金]
impeachable	弾劾すべき
seasick	船酔いした
evensong	(英国国教会の)夕べの祈り|晩祷(ばんとう)
fenestration	窓割り(建物の窓や外壁開口部の設計・配置)
carbuncle	癰(よう)|疔(ちょう)(悪性の吹き出物)|ざくろ石;《古》紅色の宝石(紅玉など)
dephosphorylation	脱リン酸化
derivable	capable of being derived
abkhazian	a member of the Circassian people who live to the east of the Black Sea|a Circassian language spoken by the Abkhaz|of or relating to Abkazia or its people or their language
yodel	ヨーデル|歌う(ヨーデル調で)
shapley	シャプレー
ketoprofen	ケトプロフェン
clomipramine	クロミプラミン|抗うつ薬として用いられる有機化合物の一種
trigram	a word that is written with three letters in an alphabetic writing system
celerity	(行動の)迅速(じんそく)|敏速
oast	a kiln for drying hops
catsup	ケチャップ|ケチャップ色
guffaw	(下品な)ばか笑い|突然の高笑い(大笑い)
scrotal	relating to or having or lying within a scrotum; "scrotal mammals"; "scrotal testes"|relating to or having or lying within a scrotum
easternmost	最も東方(東部)の|極東の
interspecies	種間
reorganise	再結成|再編成|シェイクアップ
soupy	スープのような|ドロドロした|どんよりした|霧の濃い|酒に酔って|感傷的な
aerate	空気を含ませる|浄化のために空気にさらす|血液に酸素を供給する
probationer	見習い生|試験中の人
syncopate	(音楽で)〜‘に'切分音をおく|〈語中の音〉‘を'消失させて音節を減らす(例えば overをo'erとするなど)
heterotrophic	従属栄養性
bawl	わめく|叫び|大声でわめく|しかる|ワーン|泣き声
siskin	マヒワ
eclair	(仏)エクレア(細長いシュークリームにチョコレートをかけた洋菓子)
solicitude	気遣い|心配事|憂慮|配慮
lighting	明暗|照明|点火|点灯|採光|照明装置|ステージライト
guv	おやじ|親方|だんな
pawnbroker	質屋
escargot	エスカルゴ|食用カタツムリ
economize	倹約する
reverently	うやうやしく
hostelry	旅館
hominy	ひき割りトウモロコシ|外皮をとったトウモロコシ
crawlspace	人間がはって通れるぐらいの空間
lacustrine	of or relating to or living near lakes
agglutinin	凝集素(赤血球などの凝集反応を起こす抗体)
phototherapy	光線療法
convertibility	the quality of being exchangeable (especially the ability to convert a currency into gold or other currencies without restriction)
barmaid	バーのホステス|女性バーテンダー
limpet	(貝)カサガイ|しつこくまといつく人
quadrate	角形|角形
hypertonic	(of living tissue) in a state of abnormally high tension; "hypertonic muscle tissue"|(of living tissue) in a state of abnormally high tension|(of a solution) having a higher osmotic pressure than a comparison solution
seeder	播種機|播種機|播種機
unpowered	not having or using power; "an autogiro is supported in flight by unpowered rotating wings"|not having or using power
recognizance	誓約|誓約保証金|誓約所
preeminence	抜群|卓越
sketcher	スケッチする人|略図(見取図)を書く人
mindlessly	野暮
gizzard	(鳥の)砂のう|《話》胃腸
mifepristone	ミフェプリストーン
unconditioned	無条件の|絶対の|(心理学で)生来の|本来の
louvered	supplied with louvers for ventilation; "a louvered door"|supplied with louvers for ventilation
footsie	(幼児語)あんよ|足|(テーブルの下などで)足を触れ合わせたりしていちゃつくこと|こっそり仲よくすること
quasiparticle	準粒子
mommie	ママ(幼児語)
motorcar	《おもに英》《米》『自動車』《米》automobile)
schtick	注意を引くためのお決まりのしぐさ|おはこ|ギャグ
whiney	気難しい|気難かしい|気むずかしい
amphibia	the class of vertebrates that live on land but breed in water; frogs; toads; newts; salamanders; caecilians|the class of vertebrates that live on land but breed in water|frogs|toads|newts|salamanders|caecilians
intercalate	〜‘を'間に入れる|挿入する|〈うるうの日・月〉‘を'暦に入れる
abele	ギンドロ
calumny	中傷|誹謗
perversely	意地になって
chromic	クロムの|クロム(特に3価のクロム)を含む
desecrate	冒とくする|神聖を汚す
transfigure	〜‘の'姿(形)を変える|‘を'変貌させる|〜‘を'神々しくする|代化する|理想化する
excretory	排出器官|排出の|排泄の
felonious	重罪の
quizzical	いぶかしげな
transcriptome	トランスクリプトーム(transcriptome)|細胞中に存在する全てのmRNAないし一次転写産物(transcripts)の総体を指す
maxilla	顎骨|(特に)上顎骨
empiricist	a philosopher who subscribes to empiricism
diarrheal	下痢性
pyx	(カトリック教の)聖体容器|(またpyx chest)貨幣検査箱
spittle	つば (cough and spittle咳とつば)
circumspect	注意深い|用心深い|慎重な|用意周到な
demerit	短所
shouldst	=should