demerit	短所
shouldst	=should
unlit	not set afire or burning; "the table was bare, the candles unlighted"; "held an unlit cigarette"|not set afire or burning|without illumination; "came up the lightless stairs"; "the unilluminated side of Mars"; "through dark unlighted (or unlit) streets"|without illumination
plaice	カレイ・ヒラメの類
roundness	丸さ|完合さ
catechetical	of or relating to or involving catechesis
punchbowl	フルーツポンチ用大皿
grosz	100 groszy equal 1 zloty in Poland
pulpwood	パルプ材(特に松・モミなど)
acrimonious	しんらつな|辛辣な|痛烈な|毒々しい|刺々しい
subminiature	超小型カメラ|超小型カメラの|(電子装置の部品などが)超小型の
intercessor	斡旋者|口合い|架け橋|口利き|懸け橋|架橋|仲立ち人|口合|仲立人|パイプ役
britches	informal term for breeches
gestural	身振りの
tyke	のら犬|下劣な奴|雑犬|子供|(俗)ガキ
adrenocortical	副腎皮質性
purposive	きっぱりした|決然とした|決断力のある|目的にかなった|目的のある
nonalcoholic	非アルコール性
neurochemical	神経化学物質
stigmatize	に汚名をきせる|汚名を着せる|烙印を押す|非難する
matins	(また『mattins』)《しばしばM-》(英国国教会の)朝の祈祷(きとう);(カトリック教会の)夜半(夜明 け)の祈り|《しばしば単数形で》《詩》朝の鳥の歌
cooperator	(共通の目的を持った)協力者|協同者
boastfully	in a boastful manner; "he talked big all evening"|in a boastful manner
maladaptive	showing faulty adaptation
sidetrack	〈人|人の話など〉‘を'わき道にそらす|〈列車〉‘を'側線に入れる|わき道|(鉄道の)側線|待避線
aborigine	原住民;《通例複数形で》土着の動物(植物)
democratize	民主化する
abhorrence	嫌悪の情
bravura	(音楽･劇で)大胆で華麗な(演奏(演技|演出))
fathead	まぬけ
enuresis	遺尿(いにょう)症|尿失禁|寝小便
contemporaneously	during the same period of time; "contemporaneously, or possibly a little later, there developed a great Sumerian civilisation"|during the same period of time
wryly	顔をゆがめて|顔をしかめて
androgenic	アンドロゲンの
cytokeratin	サイトケラチン|上皮性細胞の細胞骨格を成す蛋白群の総称
staphylococci	ブドウ球菌|ブドウ状球菌
blackish	やや黒い|黒みがかった
apraxia	inability to make purposeful movements
ahimsa	a Buddhist and Hindu and especially Jainist doctrine holding that all forms of life are sacred and urging the avoidance of violence
graffito	(特に|壁・便所などの)落書き
aphorism	警句|格言|アフォリズム|金言
hemagglutinin	赤血球凝集素
barque	(=bark)|帆船の一種
doggone	忌まわしい|いまいましい|嫌な|ばかげた|呪うべき|呪う
pragmatically	実用的に|実用主義的に
plasterer	左官|石膏(せっこう)細工人
bottomland	川沿いの低地
lonicera	woodbine
carryout	(食堂で)お持ち帰り料理|(料理が)お持ち帰り用の
carothers	カロザーズ
houseman	雑役夫|下働き|下男
smiler	しゃっ面|面
pitiless	無慈悲な|情け容赦ない
doxepin	a tricyclic antidepressant (trade names Adapin and Sinequan) with numerous side effects (dry mouth and sedation and gastrointestinal disturbances)
portly	肥満した
taskmaster	職工長|親方
netmail	Eメール|メール|Eメイル|E-メール|メイル|E-メイル
senora	〈C〉〜夫人|奥様(英語の Mrs.に相茶)|〈C〉既婚婦人|淑女
beauteous	(気候･景色など)うるわしい
scag	点鼻薬
deathwatch	臨終の見取り|(またdeath watch beetle)チャタテムシ(カブト虫の一種)
veld	(南アフリカの)草原(地帯)|ヴェルド(人名)
oligosaccharide	オリゴ糖
flatworm	扁形動物
thiocyanate	チオシアン酸塩
circlet	小さな円|飾り環(女性が頭・腕・首につける)
concavity	〈U〉凹状|くぼんだ状態|〈C〉凹面
estimable	計算できる|価値のある|尊敬すべき
ascertainment	確認
impudent	ずうずうしい|厚かましい|恥知らずの|生意気な
keelboat	river boat with a shallow draught and a keel but no sails; used to carry freight; moved by rowing or punting or towing|river boat with a shallow draught and a keel but no sails|used to carry freight|moved by rowing or punting or towing
archdiocesan	of or relating to an archdiocese
xlii	being two more than forty
philomath	a lover of learning
armless	having no arms; "the armless Venus de Milo"|having no arms
bettor	賭けをする人
matzah	マツァ|マッツァー|マッツォ
similitude	〈U〉類似|相似;〈C〉(〜と)似た姿《+『of』+『名』》|〈C〉(たとえ話・直喩で用いられる)たとえ|比較
heroically	雄々しく
pekoe	《しばしばP-》ペコー(スリランカ・インド・ジャワ産の高級紅茶)
reformatory	少年院
kayaker	カヤッカー|カヤックに乗る人
surreptitious	不正の|秘密の
petulant	不きげんな|短気な|怒りっぽい
paraclete	聖霊(the Holy Spirit)
glucoside	グルコシド
underhanded	公明でない|陰に隠れた
biometry	生物統計学
lit	火がつく|火をつける
stepsister	腹違いの姉妹|父親違いの姉妹
subsume	(規則･範疇)などに)包摂(包含)する
muzzy	鮮明でない|(病気やアルコールのために)頭がすっきりいない|ぼんやりした
containerize	package in a container; "The cargo was containerized for safe and efficient shipping"|package in a container
folksy	庶民的な
nonchalant	無頓着な|無関心な|冷淡な|平然とした|冷静な
disloyalty	不忠
laconic	簡潔な
typify	の典型である|類型化する|代表する
buteo	broad-winged soaring hawks
underpart	(物の)下部|下側;(動物の)腹部
askance	斜めに|横目に|横目で
pirouette	つま先旋回(する)
grifter	賭博師|(サーカス･縁日などで)見世物や賭事の店を出す人|詐欺師|ぺてん師|浮浪者
baronial	男爵(領)の|男爵にふさわしい
ovis	sheep
huckster	呼び売り商人|行商人|押しの強いセールスマン|金目当てに働く人
denouement	(劇などの)大円団|終局|解決|やま|こみいった事件の結末
obliquity	間接|間接|いんちきさ
consonance	〈U〉〈C〉(二つの音の)調和;協和音|〈U〉(趣味・意味などの)一致|調和|〈U〉(音の)共鳴
cadenza	カデンツァ(楽曲の中で|独奏(唱)者が伴奏を離れて独自に演奏する華やで技巧的な部分)
endear	慕わせる|いとしく思わせる
satiric	風刺の
redstart	ジョウビタキ(赤い尾をもつヨーロッパ産の小鳥)|アメリカムシクイ(赤橙色の斑点のあるアメリカ産の小鳥)
sanctimonious	信心ぶった
wurst	ソーセージ
kesey	キージー
topspin	トップスピン(回転しながら進む球の回転運動)
constructionist	(法律などの)解釈者
bumpkin	バンプキン|(いなか出の)ぶこつ者
disfunction	機能障害|機能不全
depute	〈人〉‘を'代理者(代表者)にする;(〜するように)〈人〉‘を'代表にする《+『名』+『to』 do》|(代理者に)〈権限・任務など〉‘を'委任する《+『名』+『to』+『名』》
ghostwriter	代作者|ゴーストライター
foolscap	〈U〉(洋紙の)フールスキャップ判|大判|=fool's cap
cellulosic	a plastic made from cellulose (or a derivative of cellulose)
inulin	イヌリン
kinetochore	動原体|セントロメア
fibrinolysis	a normal ongoing process that dissolves fibrin and results in the removal of small blood clots; "drugs causing fibrinolysis have been utilized therapeutically"|a normal ongoing process that dissolves fibrin and results in the removal of small blood clots
rightward	右の方の|右方へ向った|右の方へ(に)|右手に
unmeasured	法外な
lambchop	ラムチョップ
coplanar	共平面
deflationary	通貨収縮の|デフレの
ghillie	a shoe without a tongue and with decorative lacing up the instep
washing	洗うこと|洗濯|洗濯物|洗浄液|めっき|水仕事
lumpectomy	腫瘍摘出手術|乳腺腫瘤摘出
pally	(〜と)親しい|仲の良い《+『with』+『名』》
weightlessness	無重力
radiocommunication	ラディオ|ラジオ
cultus	崇拝
tellurium	テルル|非金属元素|元素記号Te|太陽電池や各種電子部品の材料|ビスマスとの合金は熱電変換素子|先端工業に欠かせぬレアメタルの一種|日本でも産出する
semitrailer	セミトレーラー(前部をトラクターと接続するトレーラー) = semi-trailer
cantankerous	意地の悪い|けんか好きの|意地悪の|つむじ曲がりの|けんか腰の
pinyon	=pinon
lovesick	恋いわずらいの|恋いに悩んだ
cannister	缶
galvanise	息巻く|息巻く|息巻く
unsportsmanlike	後ろぎたない|穢らしい|汚い|後穢い|穢い|穢ならしい|後ろ穢い|ダーティ|不正|穢ない
granddad	祖父
connote	暗示する|内包する|意味する
moralistic	教訓的な
whitlow	ひょうそ(指の先端などの化膿性炎症)
outstandingly	目立って
majorette	=drum majorette
sensitisation	感作|感光|感光
repp	a fabric with prominent rounded crosswise ribs
hematopoiesis	造血
photolithography	a planographic printing process using plates made from a photographic image
enmesh	(網などに)〜‘を'かける|(争い・困った事態などに)〈人〉‘を'巻き込む|陥れる《+『名』+『in』+『名』》
uncritically	無批判
mishmash	ごたまぜ|寄せ集め
ketoacidosis	ケトアシドーシス
functionalism	機能主義
healthily	健康で|健全で
bunting	旗布|(慶祝などのための)細長い旗|吹き流し|まん幕|(主に米)(乳児用の)おくるみ|ホオジロ類の小鳥
goddam	つまらない|くだらない|取るに足りない|くそっ|いまいましい
gelatinous	ゼリーの|ゼラチン(質)の|ゲル状の|粘着性の|ゼラチン状になる(become gelatinous)
centimetre	糎|センチメートル|cm|センチメータ|サンチ|珊
ironmongery	〈U〉金物類|鉄器類(hardware)|〈C〉金物屋|金物商
heterochromatin	ヘテロクロマチン(染色体内のDNA蛋白複合体のうち|異質染色質と呼ばれる部分)
gentlemanly	紳士的な|紳士にふさわしい;礼儀正しい
daimon	魔もの|鬼神|デーモン|魔王|亡者|悪鬼|波旬|悪霊|デヴィル|天魔波旬
uptick	(株価などの)上昇　上向き
underbrush	やぶ|小低木|木の下ばえ
histochemistry	組織化学
asthenic	lacking strength or vigor|having a slender physique
centripetal	中心に向かう|求心性の|求心力による
jockstrap	(男子運動選手用)サポーター|運動選手|どさ回りの生活をする
arcuate	弓形の|アーチ状の
anaphora	照応|照応
taxus	yews
flatfish	ヒラメ|カレイなどの魚
nelfinavir	a protease inhibitor (trade name Viracept) used in treating HIV usually in combination with other drugs
unintelligent	理解力(知性)に欠ける|愚かな
adit	a nearly horizontal passage from the surface into a mine
prizewinner	受賞者|賞金獲得者;受賞作品
depolarize	減極させる|脱分極させる
cark	取り乱させる|動揺させる|心配させる|揺さぶる
cowrie	タカラガイ|コヤスガイ
alnico	アルニコ磁石
sapir	サピル
granddaddy	おじいちゃん|父母の父親
wastewater	廃水
coffer	貴重品箱|金庫|財源|金庫に納める|塞き止める
rarefy	(空気･ガスなどを)希薄にする(なる)|純化する|浄化する
vestment	衣服
diaeresis	(音節の)分切;分音|分音符号(naïveなど)
deprecate	〜‘に'不賛成の意を表す|‘を'非難する|‘を'軽べつする
slovenija	a mountainous republic in central Europe; formerly part of the Habsburg monarchy and Yugoslavia; achieved independence in 1991|a mountainous republic in central Europe|formerly part of the Habsburg monarchy and Yugoslavia|achieved independence in 1991
wielder	武器(道具)として使える物
explosively	suddenly and rapidly; "the population in Central America is growing explosively"|suddenly and rapidly
chivalrous	騎士の|騎士制度の|騎士道の|騎士道時代の|騎士道的な|義侠的な|女性に親切な|寛大な|丁重な|勇気があって礼儀正しい
transonic	(また transsonic)音速に近い|音速前後の
gendarmerie	国家憲兵
bishopric	bishopの職;〈C〉bishopの管轄(かんかつ)区(diocese)
obstinacy	頑固|強情|病の難治
landsman	陸上生活者;陸上勤務者
bootstrapped	＜bootstrap|ブートストラップ(ソフトの名)製の
jetsam	(緊急時に投棄された)投げ荷|捨て荷
contrastive	対比的|対照的|対照的
coloring	着色剤|色合い
sherbert	氷菓子
theatrically	芝居じみて|わざとらしく|誇張して
sinusoid	正弦曲線
wroth	怒って|激怒して
phooey	戯言|ナンセンス|面白くもない|そんなばかな! ヒェーッ|くそくらえ
calan	ベラパミル
phagocytic	capable of functioning as a phagocyte
gabardine	ギャバジン(羊毛と綿のあや織り)
contraindication	禁忌
bailee	the agent to whom property involved in a bailment is delivered
mineralogist	鉱物学者
salesmanship	販売手腕
anodic	of or at or relating to an anode
unguided	not subject to guidance or control after launching; "unguided missiles"|not subject to guidance or control after launching
welshman	カンブリア紀
combinable	able to or tending to combine
filariasis	フィラリア症
ribes	スグリ属
unrighteous	not righteous; "an unrighteous man"; "an unrighteous law"|not righteous
updraft	上昇気流|上向き通風
torpor	無感覚|麻痺|冬眠|活動停止
logy	グロッギー|グロッキー
watermill	水車;(水車式)製粉場
passerby	通行人
misanthrope	人間嫌い
scapula	肩甲骨
paternoster	主の祈り
subarctic	of or relating to latitudes just south of the Arctic Circle
minestrone	ミネストローネ(肉・野菜・パスタなどを入れて煮たスープ)
declension	(名詞・代名詞・形容詞の性|数|格による)語形変化|一連の語形変化
disunity	(仲たがいによる)不統一|不一致|不和
touchline	(ラグビー・サッカーで)タッチライン
pukka	absolutely first class and genuine; "pukka sahib"; "pukka quarters with a swarm of servants"|absolutely first class and genuine
birthrate	出生率
cummerbund	カマーバンド(タキシードの下に着用する幅広の腰帯)
repast	(文語)食事|a dainty(華奢な|上品な) repast美食|馳走|饗応
obeisance	敬礼
decommission	退役させる|閉じる
atomistic	divided into separate and often disparate elements
gemfibrozil	ゲムフィブロジル
occultist	a believer in occultism; someone versed in the occult arts|a believer in occultism|someone versed in the occult arts
majestically	荘厳に|堂々と|雄大に
caul	大網
shapeless	無形の|ぶかっこうな
contrite	悔恨の|罪を深く悔いている
reflexively	反射的に
nutsedge	a widely distributed perennial sedge having small edible nutlike tubers
beachhead	足がかり|橋頭堡
pfft	(物が消えるさまを表し)パッ|フッ|(失敗を表し)ポシャッ
abstractly	in abstract terms
daguerreotype	(昔の)銀板写真
lipophilic	親油性
conjunctival	of or relating to the conjunctiva
nonsignificant	attributable to chance
ojibwa	チペワ川|チペワ川
samosa	サモサ
stylebook	(服飾)スタイルブック
clomiphene	クロミフェン
yokel	田舎者|いなかっぺ
badman	(特に西部開拓初期の)無法者|ならず者
claustrophobia	閉所恐怖症|密室恐怖症
projectionist	テレビ技師|映写技師
huarache	a sandal with flat heels and an upper of woven leather straps
isoflurane	イソフルラン
impresario	座元|興業主
audiometry	the measurement of hearing|measuring sensitivity of hearing
moke	（英俗）ろば(donkey)
ergometer	動力計
thromboembolic	血栓塞栓性の
righteously	正しく|公正に
cryptographically	in a cryptographic manner
tactician	策士|戦術家
shush	(感)しっ|静かに
propitious	恵まれた|幸運な|(格式語)都合の良い|運の良い
sexiness	セクシーなこと|性的魅力のあること
domesticity	家事|家庭への愛着|家庭生活|家庭的なこと
brominate	ブロム化|ブロム化
inveterate	(病気･習慣)慢性の|常習的な|(感情)根深い|執念深い
mainstreamed	(of the handicapped) placed in regular school classes
infliximab	インフリキシマブ|レミケード
soja	大豆
apomorphine	アポモルヒネ
peacefulness	平和|心の平和|落ち着き|清適|安らぎ|精神の平静|安静|安心|安息|安らかさ|心安
isomerization	異性化
restructuring	構造改革|リストラ
scupper	(船腹にある)甲板排水口
hyperhidrosis	多汗症
climatologist	someone who is expert in climatology
absently	うっかりして|ぼんやりと
prorate	〈出費など〉‘を'比例配分する|割り当てる
urease	ウレアーゼ
yeller	スクリーマー
meperidine	メペリジン
fritillary	貝母|ヒョウモンチョウ|貝母
incorrigible	改められない|矯正できない|救いがたい|度しがたい|手に負えない
confit	a piece of meat (especially a duck) cooked slowly in its own fat
coagulant	凝固剤
haematological	血液学的
passant	in walking position with right foreleg raised
sodalite	a vitreous mineral consisting of sodium aluminum silicate and sodium chloride in crystalline form; occurs in igneous rocks|a vitreous mineral consisting of sodium aluminum silicate and sodium chloride in crystalline form|occurs in igneous rocks
municipally	by municipality; "municipally funded"|by municipality
bulimic	a person suffering from bulimia|suffering from bulimia
circularly	円か
shaheed	シャヒード
footfall	足音|足取り
tollbooth	有料道路料金徴収所
reproof	〈U〉しかること|非難|〈C〉叱責(しっせき)(非難)の言葉
secularization	俗化
louden	become louder; "The room loudened considerably"|become louder|cause to become loud
treasonous	treasonable
choosy	好みのうるさい|気むずかしい
diverticulosis	presence of multiple diverticula in the walls of the colon
hobnail	(靴の底に打つ頭の大きい)びょうくぎ
unicellular	単細胞の
conspiratorial	陰謀の|陰謀好きな|共謀の
marmoset	キヌザル
credulous	だまされやすい|軽々しく信じやすい
puzzlement	当惑
fivefold	5倍の|5重の|5倍に|5重に
nucleosynthesis	宇宙の元素合成
beery	ビールの|ビール好きの|ビール臭い
embalmer	(死体の)防腐処置人
slosh	うろつきまわる|はね飛ばす|(水などを)ぼちゃぼちゃする
steerable	capable of being steered or directed
rotter	ろくでなし
drat	ちぇっ!|ちくしょう!|いまいましい!|呪う
hereupon	ここにおいて;その直後に
beneficence	善行|慈善|親切|〈C〉施し物|寄付
sailplane	セイルプレーン(上昇気流で飛ぶ軽いグライダー)
towpath	引き船道(陸から船を引っ張るための川や運河沿い道)
impregnable	堅固な|動じない|難攻不落の
lamplighter	(街灯の)点灯夫;点灯用具
etymological	語源の
remonstrance	抗議|いさめ
penmanship	習字|書道|書法|筆跡
individuation	個別化|個体化|持ち味|性格|個性|人格|個人性
forelimb	(四足動物の)前脚|前肢
creon	クレオン
interferometer	干渉計
adenoviral	アデノウイルスの
ketosis	ケトン血症
wurzburg	ウュルツブルク
serenely	晴朗に|穏やかに|平静に
treponema	トレポネーマ
dreidel	各面にヘブライ文字が記されている四角いこま|ユダヤの祭礼 Hanukkah に dreidel を用いてする子供のゲーム
unrealistically	非現実的に
dysphoria	不快
immunogenic	免疫原性の
tobramycin	トブラマイシン
immunocytochemical	免疫細胞化学的な
impermanence	はかなさ|一時性|永久でないこと|非永久性|無常
overwrought	緊張しすぎた|興奮しきった|働きすぎた|過労の|ひどく興奮して|凝りすぎて
vivacity	活発さ|陽気
incontrovertible	論争の余地のない|明白な
forenoon	午前
cudgel	棍棒(こんぼう)
tefillin	(Judaism) either of two small leather cases containing texts from the Hebrew Scriptures (known collectively as tefillin); traditionally worn (on the forehead and the left arm) by Jewish men during morning prayer|either of two small leather cases containing texts from the Hebrew Scriptures (known collectively as tefillin)|traditionally worn (on the forehead and the left arm) by Jewish men during morning prayer
catechin	カテキン
drumstick	太鼓(ドラム)のばち|《話》(料理した)鶏(七面鳥など)の足
incisor	(ɪnsάɪzɚ)|門歯|切歯
certitude	確信
overexpose	〈フィルムなど〉‘を'露出過度にする|(太陽・寒さなどに)〜‘を'さらしすぎる
senility	(sɪníləṭi)老齢|老衰|おいぼれ|もうろく
kafir	an offensive and insulting term for any Black African|a member of the Kafir people in northeastern Afghanistan
approvingly	賛成して
unidentifiable	impossible to identify
antiemetic	a drug that prevents or alleviates nausea and vomiting
dissed	＜diss|ダメ出しされる|酷評される
vinblastine	ビンブラスチン
cytidine	デオキシシチジン|シチジン
artless	自然のままの|ありのままの|素朴な
salmonellosis	サルモネラ症
inaccessibility	the quality of not being available when needed
pongo	type genus of the family Pongidae: orangutans
condescend	卑下する|愛想よくする|恩にきせる
longueur	(文学作品などの)長たらしく退屈な箇所|だれ場
flightless	(鳥が)飛べない
tympanic	resembling a drum|associated with the eardrum
teakettle	やかん|茶がま
wigeon	ヒドリガモ
trimer	三量体
survivalist	someone who tries to insure their personal survival or the survival of their group or nation
pudgy	ずんぐりした
leafhopper	ヨコバイ(植物の液汁を吸う害虫)
fluoridate	(虫歯を防ぐために)〈飲料水〉‘に'フッ化物を入れる
eightfold	8倍の|8重の|8倍に|8重に
trichomoniasis	トリコモナス症
woodshed	まき小屋
kith	[今は成句のみに用いて] 友人|隣人|同胞|知己; 親戚 (kindred)
scaup	diving ducks of North America having a bluish-grey bill
tallgrass	any of various grasses that are tall and that flourish with abundant moisture
noblesse	高貴の身分|貴族階級
tranquilizer	鎮静剤|(薬)トランキライザー|精神安定剤
kaleidoscopic	(景色･色)万華鏡の(ような)|(効果･印象)変幻自在の
monarchist	君主制主義者
satiety	飽き飽きすること
absinth	アブサン
firetrap	火災非常口のない建物;燃えやすい建物
tolerably	がまんできるほどに;かなり;まあまあ
consanguinity	血族|血縁
breathlessness	息切れ
convulsion	ひきつけ|けいれん(cramp)|動乱|激動
glyceryl	グリセリル
behaviorism	行動主義
ixia	イキシア
chichi	いやにきらびやかな|ハイカラな|当世風の
microenvironment	微環境
dimwit	ばか|うすのろ
demarcate	一線を画する|境界を画定する|区別する|分離する
whiptail	any of numerous very agile and alert New World lizards
progressivism	進歩主義|革新主義
eutectic	共晶
cobalamin	シアノコバラミン|ビタミンＢ１２|コバラミン
editorship	編集者の地位(職)
peduncle	花柄|(クラゲ・エビなどの)柄
chloramine	クロラミン
rapturous	狂喜した|熱狂させる|熱狂的な|有頂天の
unobtrusively	控え目に|人目につかず|そっと
navaho	ナバホー|ナバホ|ナバホー|ナバホ
redbud	small shrubby tree of eastern North America similar to the Judas tree having usually pink flowers; found in damp sheltered underwood|small shrubby tree of eastern North America similar to the Judas tree having usually pink flowers|found in damp sheltered underwood
natch	当たり前の
underachiever	a student who does not perform as well as expected or as well as the IQ indicates
flybridge	モンキーブリッジ
vitrification	ガラス化
catalpa	キササゲ類の植物(北米・アジア産)
tempestuous	大あらしの
foxhole	1･2人用塹壕(=dugout)
quatrain	(詩を構成する)四行連[句];四行詩
gravedigger	墓掘り人
signora	(イタリア語)《S-》〜様(さん|夫人|奥様)(英語のMrs.|Madamに相当)|(特にイタリアの)貴婦人
pericardium	心膜|心嚢
gallina	small Asiatic wild bird; believed to be ancestral to domestic fowl|small Asiatic wild bird|believed to be ancestral to domestic fowl
knacker	廃馬屠殺(とさつ)業者|廃船(廃屋)解体業者
stabile	安定した|静止した|変動しない; 血清成分など安定な
laboriously	＜laborious|苦労して|ほねをおって
inmost	=innermost
pyloric	relating to or near the pylorus
kinglet	小国の王|キクイタダキ属の小鳥
wording	言葉で言い表す|言い回し
birdfeeder	an outdoor device that supplies food for wild birds
trigon	トライアングル|３角形|三角|三角形|3角|三角琴|三角琴
fascicle	分冊
cannot	can not
sere	枯れた|しなびた
lordy	なんてこった
demonology	鬼神学(論)|悪魔研究|悪霊学
rhomb	菱形|斜方形
contestable	capable of being contested
sleepwalker	夢遊病者
inordinately	異常に
popularization	大衆化|大衆化|俗化|普及
carica	type genus of the Caricaceae; tropical American trees: papayas|type genus of the Caricaceae|tropical American trees: papayas
pollux	ポルクス
nitpicker	細かいことにこだわる人|あら探しする人
newsboy	新聞売り子|新聞配達少年
nasturtium	キンレンカ(黄や赤の花をつける園芸植物)
shamus	探偵|私立探偵
flagyl	メトロニダゾール
vivaciously	with vivacity; "he describes his adventures vivaciously"|with vivacity
syrupy	シロップの;シロップのような|(音楽などが)甘ったるい
punic	the Phoenician dialect of ancient Carthage|of or relating to or characteristic of ancient Carthage or its people or their language; "the Punic Wars"; "Carthaginian peace"|of or relating to or characteristic of ancient Carthage or its people or their language|tending to betray; especially having a treacherous character as attributed to the Carthaginians by the Romans; "Punic faith"; "the perfidious Judas"; "the fiercest and most treacherous of foes"; "treacherous intrigues"|tending to betray|especially having a treacherous character as attributed to the Carthaginians by the Romans
lucre	利益|もうけ|金銭
compliancy	=compliance
precipitously	急激に
compulsively	強迫的
ilion	腸骨
vintner	ブドウ酒醸造業者|ブドウ酒商人
cronk	警笛
clausewitz	クラウゼビッツ
animist	アニミズム(精霊説)論者
oystercatcher	ミヤコドリ(カキなどを食べる水鳥)
gristle	(食用肉の)軟骨|すじ|強靱な弾性組織(tough elastic tissue)
shipwright	船江工|造船工|船修理工
abor	little known Kamarupan languages
jiminy	ひゃあ|あれっ
devoir	〈U〉本分|つとめ|《複数形で》敬意の表現|あいさつ
ferny	シダの|シダの茂った
bluestem	tall grass with smooth bluish leaf sheaths grown for hay in the United States
senecio	enormous and diverse cosmopolitan genus of trees and shrubs and vines and herbs including many weeds
reactance	リアクタンス(電気の感応抵抗)
astern	(海事用語で)船尾に(へ);後方へ
stoutly	敢然と|頑強に
floaty	tending to float on a liquid or rise in air or gas; "buoyant balloons"; "buoyant balsawood boats"; "a floaty scarf"|tending to float on a liquid or rise in air or gas
shirr	〈布〉‘に'飾りひだをつける|〈卵〉‘を'浅皿に入れ天火などで焼く
vestigial	痕跡の|退化した|名残りの
glassed	どんより
facilitative	促通性
quantize	クォンタイズ|クォンタイズ|量子化
cufflink	カフスボタン|カフスリンク
pennyroyal	ハッカ類の植物
collarbone	鎖骨|(clavicle)
prazosin	プラゾシン
unequally	不平等に|不等|不均等
gesso	gypsum or plaster of Paris spread on a surface to make it suitable for painting or gilding (or a surface so prepared)
profligate	放蕩の
dumpy	ずんぐりした
repackage	再パッケージ化
interactional	相互作用的
highbrow	知的な|知識人|教養人
emancipate	(〜から)〜‘を'解放する|自由にする《+『from』+『名』(do『ing』)》
sculpin	any of numerous spiny large-headed usually scaleless scorpaenoid fishes with broad mouths
syllabic	音節の(に関する);音節から成る|音節主音の(母音の助けを借りずに音節を形成する子音)|音節主音(母音と音節主音の子音)
bobtail	切り尾;切り尾の馬(犬)|切り尾の|尾を切った
opposer	敵人|敵|対敵|反対者|敵手|敵対者|対手|対者
newspeak	deliberately ambiguous and contradictory language use to mislead and manipulate the public; "the welfare state brought its own newspeak"|deliberately ambiguous and contradictory language use to mislead and manipulate the public
overestimation	過大評価
gimbal	an appliance that allows an object (such as a ship's compass) to remain horizontal even as its support tips
beady	ビーズのような
apperception	統覚
slapshot	a fast shot made with a short powerful swing of the hockey stick
associational	連合性
tuareg	ツアレグ|ツアレグ
catatonic	緊張
revery	=reverie
superbug	a strain of bacteria that is resistant to all antibiotics|a strain of pest accidentally imported into Florida from the Middle East then spread to California where it is a very serious pest feeding on almost all vegetable crops and poinsettias
hauteur	傲慢|横柄|尊大
unerring	誤りのない|的をはずれない|確実な
unreached	だめ
isopropanol	イソプロパノール|イソプロピルアルコール
whiner	哀れっぽい声を出す人(犬)|すすり泣く人;ぐちをこぼす人
slippy	《英話》すばやい|すばしこい|抜け目のない|滑りやすい|つるつるする
mauler	a fighter who batters the opponent; "Jack Dempsey was called a mauler"|a fighter who batters the opponent
antiepileptic	抗痙攣剤
rustbelt	ラストベルト
craton	大陸塊(地殻で比較的堅く安定した部分)
sheepshead	まぬけ|羊の頭
arng	a civilian reserve component of the United States Army comprised of guardsmen who serve during overseas peacekeeping missions and during local emergencies
opv	セービンワクチン
unshakable	揺り動かすことのできない|揺るぎない|確固とした(firm)
etcher	エッチングする人|食刻銅版工
denizen	(ある場所の)住人|生息するもの|外国人居住者|外来語|外来動植物
nonexistence	〈U〉実在しないこと;〈C〉実在しない物
elegiac	哀歌調の|哀調に満ちた|エレジー風の
teratoma	a tumor consisting of a mixture of tissues not normally found at that site
bivouac	野営地|ビバーク
ornery	意地の悪い|おこりっぽい|強情な|下劣な
hammy	affectedly dramatic; overacted|affectedly dramatic|overacted
carvedilol	beta blocker that can reduce the progression of heart failure in individuals whose disease is not advanced
anaesthetist	=anesthetist
goofball	間抜け
cinematheque	シネマテーク
gainfully	in a gainful way; "are you gainfully employed now?"|in a gainful way
doggedly	頑固に|強情に
gonorrhoea	淋病
lockman	a worker in charge of a lock (on a canal)
brioche	ブリオッシュ(小麦粉・卵・イースト・バターなどで作る軽くて甘い菓子パン)
leatherwood	shrub or small tree of southeastern United States to West Indies and Brazil; grown for the slender racemes of white flowers and orange and crimson foliage|shrub or small tree of southeastern United States to West Indies and Brazil|grown for the slender racemes of white flowers and orange and crimson foliage|deciduous shrub of eastern North America having tough flexible branches and pliable bark and small yellow flowers
episiotomy	会陰切開
ladyship	貴婦人の身分(品位)
nestling	雛|鳥の子|ひな鳥|ひなどり|雛鳥
problematical	複雑|捕らえ所のない|苦しい|ハード|捉え所の無い|捕らえ所の無い|困難|捉え所のない|難解|手ごわい
kreisler	クライスラー
lexicographic	辞書編集の
escapee	脱獄者|脱獄囚|脱走者|逃避者|逃亡者|亡命者
defenceless	無防備|無防備|無防備
colorant	顔料|染料
stratify	層(状)にする|階層ごとに分ける|階層化する
rhyolite	流紋岩(二酸化ケイ素を多く含むきめの細かい火山岩)
commiserate	同情する|気の毒に思う|あわれむ|哀悼の意を示す
wapiti	(北米産の)オオシカ
gerund	(文法)動名詞
fleshly	肉体の(bodily)|肉欲の(carnal)
nonionic	非イオンの|非イオン性の|イオン化していない
shimmery	ちらちら光る|かすかに光る
courgette	ズッキーニ|小さいセイヨウカボチャ
preen	身づくろいする|くちばしで羽を整える
didanosine	ジダノシン|ジデオキシイノシン
mishna	ミシュナー
stative	( used of verbs (e.g. `be' or `own') and most participial adjectives) expressing existence or a state rather than an action|(used of verbs (e.g. `be' or `own') and most participial adjectives) expressing existence or a state rather than an action
druze	ドゥルーズ派
multitask	マルチタスク|複数処理の
illegitimacy	非合法|不合理|違法
misspell	綴り違いをする|のつづりを誤る
misstep	つまずき
chippy	フィッシュアンドチップスの店|chipmunk(シマリス)の愛称|chipping sparrow(小スズメ)の愛称|大工|あばずれ女
homeostatic	恒常的な
cloze	based on or being a test of reading skill using the cloze procedure
myotis	largest and most widely distributed genus of bats
ccrc	an agency in the Department of Defense that is a national center for research on all aspects of injury control and casualty care
basolateral	基底外側の
envoi	跋
endogenously	(生命科学)内生的に
reapportionment	再配分|定数是正
gabbro	斑糲(はんれい)岩(粒状の火成岩の一種)
softback	ペーパーバック
keloid	ケロイド
aluminize	cover with aluminum
agreeably	快く
overreaction	過剰反応
perennially	長年にわたって
consistory	(キリスト教各派の)教会会議;(カトリックの)枢機卿会議|宗教会議場
careen	傾く|傾ける|修理する|車を左右に揺らして走る
nonmetal	非金属
hookworm	鉤(こう)虫(腸に寄生する線虫)
antitussive	any medicine used to suppress or relieve coughing
masturbator	a person who practices masturbation
blackthorn	リンボク(欧州・アジア産でバラ科の木;ステッキの材料)|《米》サンザシ属(hawthorn)
centrosome	中心体
pursuer	追跡者|遂行者|追っ手|追求者|従事者
hyperinflation	ハイパーインフレ
wrapping	包む|包装用材料|包装紙
isochronous	equal in duration or interval; "the oscillations were isochronal"|equal in duration or interval
itemise	箇条書き|項に分かつ|枚挙|箇条書き|挙げる|羅列|書き連ねる|書連ねる|書きつらねる|数える|個条書き|列記
sodomite	男色家;獣姦(じゅうかん)者
orris	ニオイアヤメ(根茎に芳香のあるアヤメ)
phencyclidine	フェンサイクリジン|フェンシクリジン
circularity	円形|真円度|環状|循環性|(議論･話し合いなどの)堂々めぐり
plebeian	(特に古代ローマの)平民の|《軽べつして》庶民の|(古代ローマの)平民|《軽べつして》庶民
hyaline	a glassy translucent substance that occurs in hyaline cartilage or in certain skin conditions|resembling glass in transparency or translucency; "the morning is as clear as diamond or as hyaline"-Sacheverell Sitwell|resembling glass in transparency or translucency
chatelaine	女城主|城主の妻|《まれ》帯飾り鎖(かぎなどを下げるために婦人用のベルトにつける)
duende	悪魔|幽霊|妖精|(不可思議な)魅力|魔力|霊感
kabbalistic	秘密
abolishment	撤廃|廃止
seel	sew up the eyelids of hawks and falcons
compere	(ラジオ・テレビなどの)司会者
bedridden	寝たきりの
chancellery	chancellorの地位(事務局)|大使館(領事館)事務局
reticulation	〈U〉網目|網状|〈C〉《しばしば複数形で》網細工
lexicography	辞書編集
attar	バラ油|花の精|花のエキス
socialistic	社会主義(者)の|社会主義的な
narrowness	(幅が)狭いこと|(範囲などが)限られていること
noncompliant	不適合|不適合
stitchery	針仕事|裁縫
bruit	《うわさなど》'を'言いふらす
cardiorespiratory	心肺の
undervalue	過小評価する|価値を減少させる|軽視する
blackfish	ゴンドウクジラ|ゴンドウクジラ属
brushwood	=brush
arrogantly	傲慢に|尊大に
snakebite	ヘビにかまれた傷
pronation	回内
cruiserweight	ライトヘビー級
frond	葉状体|(シダ･海そうの)葉
rankine	ランキン
nationalisation	共産化|ナショナリゼーション|国有化
cenotaph	記念碑
manticore	マンティコア
phenylketonuria	a genetic disorder of metabolism; lack of the enzyme needed to turn phenylalanine into tyrosine results in an accumulation of phenylalanine in the body fluids which causes various degrees of mental deficiency|a genetic disorder of metabolism|lack of the enzyme needed to turn phenylalanine into tyrosine results in an accumulation of phenylalanine in the body fluids which causes various degrees of mental deficiency
geophysicist	地球物理学者
plectrum	(ギター・マンドリンなどをひくための)つめ|ピック
peripatetic	歩き回る|渡り歩く|巡回の
tribalism	部族組織
malarkey	でたらめ話|作り話|ほら話|ナンセンス
chromaticity	色度(光の色を数量的に表したもの)
expectantly	待ち受けて|期待を持って
tetrad	テトラド|4つぞろい|数字の4|(植)四分子(減数分裂で母胚種から生じた4個の娘細胞)|(化学)4価の元素(原子|基|イオン)|(分布地図の)2キロ平方区域
fibber	嘘吐き|嘘つき
mayfly	蜉蝣(カゲロウ)
tantalus	(Greek mythology) a wicked king and son of Zeus; condemned in Hades to stand in water that receded when he tried to drink and beneath fruit that receded when he reached for it|a wicked king and son of Zeus|condemned in Hades to stand in water that receded when he tried to drink and beneath fruit that receded when he reached for it
bratwurst	a small pork sausage
presbyopia	[老人性]遠視|老眼
rapacious	強欲な|(貪欲で)飽くことを知らぬ|(鳥など)生き物を捕食する|肉食の
adze	(材木をけずる)手おの
endorser	裏書人|裏書人
polygamous	一夫多妻の|一妻多夫の|(植物が)雑性花の
steepness	険しさ
arsenate	ヒ酸塩
organizationally	with regard to organization; "organizationally, the conference was a disaster!"|with regard to organization
puritanical	清教徒の|(軽蔑的に)いやに厳格な|清教徒のような|厳格な
capacious	広々とした|容量の大きい|包容力のある|大きい
stevedore	沖仲士|沖仲仕
ojibway	チペワ川|チペワ川
tambour	(砂しゅう用の布地を張る2個の)わく|太鼓|(家具の)蛇腹とびら
smarmy	おべんちゃらを言う|うんざりする
tinbergen	ティンベルヘン|ティンベルヘン
memorably	印象的な
hypoglycaemia	低血糖症
turdus	type genus of the Turdidae
hayride	干し草を積んだ馬車に乗って出かけるピクニック
taipan	タイパン
acclimate	(人･ものを風土･環境などに)慣らす|順応させる
appurtenant	付属の|従属する;(〜に)付属した《+『to』+『名』》
urethritis	尿道炎
devoutly	信心深く|心から
transmigration	転生|輪廻(死後霊魂は他の肉体に移って巡って行くという説)
fritter	(時間など)をつぶす|浪費する
townscape	都会風景[画];都市造景[案]
dysmenorrhea	月経困難症
revenant	幽鬼|幽鬼
instil	滴下
fuzziness	不明瞭
boastful	高慢な|自慢たらたら
monocot	単子葉植物
isoprene	イソプレン(主として合成ゴム製造用の揮発性液体)
bilious	気むずかしい|胆汁の|胆汁症の|胆汁質の|怒りっぽい|非常に不愉快な
rhinovirus	ライノウイルス|多くの上気道(や上咽頭感染の)原因となるピコルナウイルスグループの一種
zeroth	preceding even the first
pluton	バソリス|底盤|深成岩
copal	コーパル
despondency	落胆|意気消沈
fiefdom	封土|領地|知行
disheveled	(髪が)乱れた(もじゃもじゃした)|(服装が)だらしない
unseasonably	時候(季節)はずれに;時(場所)をわきまえず
satiny	しゅすのような;(しゅすのように)つやつやした|なめらかな
arpeggio	アルペジオ(同一和音に属する各音を連続急速に演奏すること)
pernod	(registered trademark) a liqueur flavored with anise|a liqueur flavored with anise
mollusc	軟体動物|貝|貝類
abyssal	深淵(えん)の;深海の
misbehaviour	汚行|非|犯罪行為|罪|悪行|非行|不埓|悪事|不埒|醜行
racketeer	(大勢で)脅迫する|脅迫|不正に金もうけをする人|ペテン師|ごろつき
demilitarize	非武装化|非軍事化する
vandalize	(芸術品･公共物など)を(故意に)破壊する
shopfront	店頭|店先
kitschy	浅薄な作品|駄作|大げさに誠意なく|感情的な
homesickness	ホームシック
directivity	指向性
covetous	むやみに欲しがる|強欲な
panfish	any of numerous small food fishes; especially those caught with hook and line and not available on the market|any of numerous small food fishes|especially those caught with hook and line and not available on the market
pentatonic	ペンタトニック
cataloguer	a librarian who classifies publication according to a categorial system
instillation	the introduction of a liquid (by pouring or injection) drop by drop
innately	自体
pimento	アマトウガラシ|ピーマン|カラシ
clunk	(金属)ガチャン(ガーン)という音|強打|一撃
ovalbumin	白身|卵白
vocalization	ボイス|音声|発声|音吐|声音|声|発話|発声
vilify	(人を)けなす|そしる|中傷する
translucency	=translucence
jalopy	(口)おんぼろ自動車|おんぼろ車
imperialistic	帝国主義の|帝国主義的な
hypotensive	a person who has abnormally low blood pressure|having abnormally low blood pressure
kivu	a lake in the mountains of central Africa between Congo and Rwanda
prickle	とげ|針
loiter	ぶらぶら時を過ごす|ぶらぶらする|道草を食う
handgrip	把っ手|手持部分|掴み|手|取っ手|取所|柄|握り|把手|ハンドル
jacobin	a member of the radical movement that instituted the Reign of Terror during the French Revolution
interdependency	互助|相互依存|持ちつ持たれつ
doofus	とんま|間抜け|へんてこな
madding	狂気の|狂乱の
anneal	(鋼･ガラスなどを)焼き戻す|なます|(精神を)鍛える
homodimer	ホモダイマー|ホモ2量体(生化学)
transcutaneous	経皮|経皮的
charlatan	大ぼら吹き|山師|にせ医者
whiteout	ホワイトアウト|修正液|ホワイトアウト|ホワイトアウト
sectorial	relating to or resembling a sector; "a sectorial box"|relating to or resembling a sector
permanganate	過マンガン酸塩
nitpick	細かいあら捜しをする|重箱の隅をつつく
coreopsis	any of numerous plants of the genus Coreopsis having a profusion of showy usually yellow daisylike flowers over long periods; North and South America|any of numerous plants of the genus Coreopsis having a profusion of showy usually yellow daisylike flowers over long periods|North and South America
nardil	フェネルジン
surtout	(フロックコート型の)男子用外とう;婦人用フード付きマント　シュルトウ　部分的に他の紋章と重なる
rotarian	a member of a Rotary Club
eurydice	エウリュディケ
glycoside	グリコシド|配糖体
fraxinus	ash
bullhorn	ハンドマイク|携帯拡声器(= loud-hailer)|(軍艦の)拡声器
oversimplification	簡略化しすぎること|過度の単純化
mummify	〜‘を'ミイラにする|ミイラになる
tonsillectomy	扁桃腺摘除術
extrude	(チューブから)〈歯磨きなど〉‘を'押し出す《+『名』+『from』+『名』》|〈プラスチック・金属など〉‘を'型から押し出して成形する
handmaiden	補助(するもの)
boutonniere	ブートニエール(上着のえりの折返しのボタンホールにさす花または小さな花束)
holey	多孔性
oldy	=oldie
horsehair	馬の毛|馬巣織(ばすおり)
anthropic	relating to mankind or the period of mankind's existence
norethindrone	ノルエチンドロン
whirligig	回転するおもちゃ|回転木馬|回転運動|変転|ミズスマシ
indifferently	無頓着に|冷淡に|良くも悪くもなく
panicky	恐慌の|びくびくした
retinue	従者|随行員
homeopath	a practitioner of homeopathy
roomful	部屋いっぱい|満座の人々
guff	(俗)ばか話|くだらない事
flyleaf	フライリーフ|見返し(本の巻頭・巻末の白紙)
subclavian	鎖骨下
nipa	ニッパヤシ
crisply	きびきびと|さわやかに|パリッとして|パリパリして
thole	かい座ビン(ボートのへりにさし込んであるオール受け)　船の櫓べそ　かい受け軸　瓶　栓
gumption	積極性|進取の気性|勇気|ガッツ|世智|世才
oversimplify	あまりにも簡単に扱う|単純にとらえ過ぎる|単純化し過ぎる
manicotti	large pasta tubes stuffed with chopped meat or mild cheese and baked in tomato sauce
boundedness	有限
rile	苛立たせる|怒らせる= irritate
impertinent	無礼な|でしゃばった|生意気な|不適切な|無関係の
intransigence	妥協しないこと|非協力(的態度)
eyestrain	目の疲れ
caroler	a singer of carols
hydralazine	ヒドララジン
lockstep	決まり切ったやり方|融通の利かないやり方
gasconade	自慢話|自慢|吹き散らす|広言|大威張|呼号|吹き捲くる|吹捲る|大言|壮語|慢じる|自慢
mentalism	唯心論
stellate	星状に配列した|放射状の|星形の
physiognomy	人相学|人相(学)|地形|外形
lanthanide	ランタニド|希土類元素|ランタノイド
barbiturate	バルビツル酸塩(鎮痛剤)
vervain	ベルベーヌ|バーベナ|美女桜
quartic	an algebraic equation of the fourth degree
misshapen	ぶかっこうな|できそこないの
scrubby	雑木の茂った
liveable	=livable
dreamworld	ドリームランド
spartina	grass of freshwater swamps and salt marshes of Europe, Africa, America, and South Atlantic islands
unpolished	野暮
aioli	garlic mayonnaise
slacken	ゆるむ|減じる|をゆるめる|を減ずる|不活発になる|弱まる
steadiness	着実|堅実;安定;根気
ceaselessly	絶え間なく
diapason	〈U〉(音声・楽器の)全音域|〈C〉ダイアペーソン(パイプオルガンの基本音栓(せん))
reinterpret	interpret from a different viewpoint
dispossession	収用|追放|店立て|追い立て|法的追放|店立
drumhead	〈U〉太鼓の皮|〈C〉鼓膜(こまく)
glume	small dry membranous bract found in inflorescences of Gramineae and Cyperaceae
shoeless	裸足の|素足の
succor	を援助する|救助|支援　(サッカーはsuccer)
halfback	中衛|ハーフバック
seducer	誘惑者;女たらし
viremia	ウイルス血症
ague	マラリア熱|おこり|寒け|悪寒
haggadah	Talmudic literature that does not deal with law but is still part of Jewish tradition
curettage	人工妊娠中絶|掻爬(そうは)[術]
sodden	(sάdn)|びしょぬれの|生焼けの|ぼんやりした|をびしょぬれにする
unavailing	効果のない|むだな
ramus	(器官)枝|(鳥)羽枝(うし)|脊椎動物の下顎枝|Ramus(人名)
acromegaly	先端巨大症
towhee	トウヒチョウ(北米産のホオジロ科の小鳥)
masker	マスカ
irreverence	不敬|不敬な言動|不遜|不評
unseeded	種がまかれていない(区域)|(種無しはseedless)|シードされてない
leftward	左側の|左に向かう
cryptosporidiosis	クリプトスポリジウム症|家畜やネズミなどの腸管寄生原虫が糞口経路で伝播する|最も一般的な水系感染症の1つ|腸が障害を受け下痢症状となる
statesmanship	政治家魂|政治家の資質|政治的手腕
toxicant	毒物
frizzy	ちぢれた
unsolvable	not easily solved; "an apparantly insolvable problem"; "public finance...had long presented problems unsolvable or at least unsolved"- C.L.Jones|not easily solved
runaround	(the runaround)言い逃れ|run around(好ましくない人物と)つき合う|浮気する
opposable	capable of being placed opposite to something; "the thumb is opposable to the forefinger"|capable of being placed opposite to something
acclimatization	=acclimation
abaya	アバーヤ
newel	(らせん階段の軸になる)親柱;(階段の手すりの)親柱
irksome	退屈な
exocrine	外分泌腺の|外分泌液の
semiarid	somewhat arid; "a semiarid region with little annual rainfall"|somewhat arid
esoterica	奥義秘伝
chemoprevention	化学的予防
frontiersman	(米国の)辺境の住民|辺境開拓者
biennially	every two years; "this festival takes places biennially"|every two years
roentgen	レントゲン|レントゲン
billingsgate	野卑な言葉|悪態
seronegative	血清反応陰性の
uncounted	数えてない|多数の|無数の(innumerable)
schoolroom	教室
varus	内反
lilt	軽快に動く|調子よく歌う
politick	政治運動(活動)をする
terrasse	provide (a house) with a terrace; "We terrassed the country house"|provide (a house) with a terrace
intractability	the trait of being hard to influence or control
shogi	将棋|棋
camion	a large truck designed to carry heavy loads; usually without sides|a large truck designed to carry heavy loads|usually without sides|a low heavy horse cart without sides; used for haulage|a low heavy horse cart without sides|used for haulage
growler	うなる人(動物)
policymaker	政策担当者
lipoma	脂肪腫
sensorineural	感音性
cruciform	十字形の|十字架状の
warpath	(アメリカインディアンの)征途|出陣の道
herbivorous	(動物が)草食の
clinger	まとわり付く人
irreversibility	the quality of being irreversible (once done it cannot be changed)
semiprecious	準宝石の
stupefy	ぼう然とさせる|昏睡させる|麻痺させる|仰天する
mimeograph	謄写版|複写器|(謄写版による)写し|〜‘を'謄写する(duplicate)
secant	(三角法で)セカント|正割・(幾何で)割線・（数学）切る・(線または面が)交わる|交差する
sociodemographic	社会人口学的
rutabaga	(植)カブハボタン|その根(食用)
budgerigar	セキセイインコ(オーストラリア原産のインコ)
kingbird	タイランチョウ(北米産;極楽鳥の一種)
altimeter	高度計
quiescence	静止|無活動
dispirit	がっかりさせる|落胆させる
doxazosin	ドキサゾシン|アドレナリンの作用を抑えることにより作用する高血圧治療薬
poseur	(仏語)気どり屋
widowhood	未亡人の状態(である間)
inosine	イノシン
swarthy	(皮膚が)黒ずんだ|浅黒い
chrysotile	温石綿
palimpsest	パリンプセスト(の)|もとの字句を消した上に字句を記した(羊皮紙)|裏面にも文字を刻記した(黄銅記念標)|(表側から見える)多層構造
workingman	働く人|労働者|労務者|職人|工員
chlordiazepoxide	クロルジアゼポキシド
conceptualise	思い描く|想描く|想い描く|思いえがく|思描く|構想
poetically	詩的に
sparkler	線香花火
potentilla	chiefly perennial northern hemisphere herbs and shrubs: cinquefoil
virological	ウイルス学的な
durance	(特に長期間の)投獄
riposte	当意即妙の答え|(フェンシングの)突き返し
photosphere	光球(太陽や星の表面の白熱光を放つ薄い層)
secretin	セクレチン
windrow	(乾かすために並べた)干し草(穀物の束)の列|列に並べる|(風に吹き寄せられた)枯葉(ごみ)の堆積|塊|山|畝
stepladder	(持ち運びのできる)段ばしご|脚立(きゃたつ)
sociolinguistic	of or relating to sociolinguistics
lysol	a clear oily brown solution of cresols in soap; used as an antiseptic and disinfectant|a clear oily brown solution of cresols in soap|used as an antiseptic and disinfectant
touchback	(アメリカンフットボール・ラグビー・サッカーで)タッチバック
extraversion	外向性
perilously	危険なほどに
imaginal	成虫の|心的イメージの
electrotherapy	電気療法
linchpin	急所|車の輪止めピンの意から|(荷車などの)輪止めくさび(ピン)|(扇の)要
channelization	疎通
zither	〈C〉チター(多数の弦を指にはめたつめではじいて演奏する平たい弦楽器)
obviousness	明白さ
polarimeter	旋光計
mentalist	=mind reader
deerhound	very large and tall rough-coated dog bred for hunting deer; known as the royal dog of Scotland|very large and tall rough-coated dog bred for hunting deer|known as the royal dog of Scotland
belem	ベレン
dogmatism	ドグマティズム|教条主義|独断主義|独断的態度|独断論
maneuverable	capable of maneuvering or changing position; "a highly maneuverable ship"|capable of maneuvering or changing position
misapply	〜‘の'適用を誤る|‘を'乱用する
reciprocally	相互|お互いに|逆|反比例して
inheritable	capable of being inherited; "inheritable traits such as eye color"; "an inheritable title"|capable of being inherited
authorial	of or by or typical of an author; "authorial comments"; "auctorial flights of imagination"|of or by or typical of an author
spaciousness	spatial largeness and extensiveness (especially inside a building); "the capaciousness of Santa's bag astounded the child"; "roominess in this size car is always a compromise"; "his new office lacked the spaciousness that he had become accustomed to"|spatial largeness and extensiveness (especially inside a building)
egghead	知識人|インテリ|(卑)ハゲ
condyle	か|骨頭(骨端の丸い隆起で関節の形成に役立つ)
topnotch	飛び切り上等の|第一級(一流)の
omnivorous	雑食性の
smugly	いやに気取って|うぬぼれて
ziegfeld	ジーグフェルド
intraventricular	脳室内
sennett	セネット
alkane	アルカン|パラフィン
puffiness	ふくれ上がっていること|息切れ
beefcake	男性の肉体美[写真]
quat	カート|チャット|カット
pentazocine	ペンタゾシン
asphaltic	containing asphalt; "asphaltic residues"|containing asphalt
semolina	セモリーナ(マカロニ・プディングの原料となる粗い小麦粉)
finiteness	有限
contentedly	満足げに
perfumer	パフューマー
festuca	a genus of tufted perennial grasses of the family Gramineae
incognita	謎の女|素性の不確かな女|(女性の)素性が不確かな
daylong	終日|一日中
penitence	後悔
peeper	のぞき見する人;せんさく好き|《複数形で》《俗》目
spallation	(physics) a nuclear reaction in which a bombarded nucleus breaks up into many particles; "some astronomers believe that the solar system was formed by spallation when the sun was a very young star"|a nuclear reaction in which a bombarded nucleus breaks up into many particles
concordat	協定;(教皇と国王・政府間の)政教条約
crowfoot	キンポウゲ(葉の形がカラスの足に似ている)
tactfully	如才なく|うまく
trilingual	三か国語を用いる(話す);三か国語で書かれた
manis	type genus of the Manidae
tromp	殴る|ぶちのめす|完敗させる|打つ
biotype	生物型
mascarpone	マスカルポーネ
handwash	wash or launder by hand instead of with a machine; "This delicate sweater must be handwashed"|wash or launder by hand instead of with a machine
eelgrass	藻塩草|石菖藻
motet	(聖書の文句に曲をつけた)経文歌|聖歌
scup	タイ
edgewise	刃を先に向けて|へりに沿って
plunger	プランジャー|飛び込む人|潜水者|突入者
outfox	〜‘の'裏をかく|〜‘を'出し扱く
pegboard	(ゲームなどに用いる)くぎ差し板|(くぎなどを差し込む穴のある)構図版
normotensive	正常圧
danton	ダントン
elkhound	エルクハウンド(ノルウェー産りシカ狩り用猟犬)
antipersonnel	(爆弾が敵の装備などを破壊するより)兵員を殺傷する|対人の
pneumoconiosis	肺塵(じん)症(塵やほこりを吸いこんで起こる肺の病気)
autocrine	オートクリン|自己分泌
rhumba	ルンバ|ルンバ|ルンバ|ルンバ
twosome	二人でする舞踏|二人の|2人組|二人でする(試合)
bamboozle	〜'を'だます|あざむく|煙に巻く;〜'を'だまして(〜)させる(させない)《+『名』+『into』(『out of』)+『名』(do『ing』)》
bubblejet	バブルジェットプリンター|バブルジェットプリンタ
marathoner	someone who participates in long-distance races (especially in marathons)
lagniappe	(買い物の際の)おまけ
cheerio	さよなら(goodbye)|乾杯
expressible	capable of being expressed; "an expressible emotion"|capable of being expressed
helping	助けの|助ける
pompom	ポンポン(帽子などの飾りにするリボン・玉ふさ)
rectitude	正直|清廉|(判断･方法などの)正確さ|正しさ
resolvable	解決できる
orthophosphate	リン酸塩|無機リン酸塩|オルトリン酸塩|燐酸塩
gnomon	指針
sociopathic	of or relating to a sociopathic personality disorder
abductor	誘かい者
jailbreak	脱獄
jadeite	ひすい輝石|硬玉
circumscribe	囲む|回りに境界線を引く|制限する|に限界を画する
inundate	水浸しにする|氾濫させる|充満させる
meconium	胎便
theropod	any of numerous carnivorous dinosaurs of the Triassic to Cretaceous with short forelimbs that walked or ran on strong hind legs
uncleanness	不潔[さ]
substitutability	exchangeability by virtue of being replaceable
foldout	(雑誌などの)折り込み写真
ritzy	きざな|贅沢な|とてもハイカラな|デラックスな|高級な|豪華な|豪勢な|豪奢な|俗物の|優雅な
jingo	好戦的愛国主義者
pollinator	花粉媒介者
deportment	《米》(特に若い女性の人中での)態度|ふるまい(behavior)|《英》(特に若い女性の)立ち姿|歩く姿
quotidian	日々の|ありふれた|平凡な
myoclonus	a clonic spasm of a muscle or muscle group
freeholder	土地・不動産自由保有権者
invidious	しゃくにさわる|不愉快な|ねたましい