abortus	流産児
cager	バスケットボール選手
outtake	技術上のミスなどの理由でフィルムやテープから削られた部分|引用(文)|抜粋
transience	一時的であること|はかなさ
setoff	structure where a wall or building narrows abruptly
seraphic	天使のような;気高く神神(こうごう)しい
malevolence	(məlévələns)悪意|敵意
aeronautic	航空の|飛行の|飛行船操縦者の
alcalde	(スペイン・米国南西部で)司法権を持つ市長
methodologically	方法論的
judicature	〈U〉司法[権]|裁判[権]|《集合的に》裁判官
antsy	じっとしていられない|そわそわした|不安な|(性的に)むらむらしている
premed	医科大学予科(生)|医進
lymphoproliferative	リンパ増殖
committeeman	(委員会の)委員
shoeshine	みがいた靴の艶|靴を磨くこと|靴磨き(人)
dystopian	of or pertaining to or resembling a dystopia|as bad as can be; characterized by human misery; "AIDS is one of the dystopian harbingers of the global villages"- Susan Sontag|as bad as can be|characterized by human misery
libation	献酒|神酒|(おどけて)祝い酒|飲酒
miasma	(沼沢地などから発生)毒気|瘴気(しょうき)|悪影響を与える雰囲気
plasmin	プラスミン|タンパク質分解酵素(プロテアーゼ)の一種|フィブリンやフィブリノーゲンを分解して血栓を分解する
blackball	〈人が組織の一員になること〉‘に'反対投票する|〈人〉'を'排斥する|村八分にする|反対投票[古代ギリシアで黒い球で反対の意を表したことから]
sipper	a drinker who sips
astronautical	of or belonging to astronauts or the science of astronautics
angiosperm	被子植物|顕花植物|(種子植物のうち|胚珠が子房に包まれ受精後結実するもの|反:gymnosperm)
nonchalantly	無頓着に|冷淡に|無関心に
trespasser	[家宅]侵入者;違犯者
tamarin	small South American marmoset with silky fur and long nonprehensile tail
timelessness	未来永劫|終古|永久|久遠|万古|万世|生生世世|常世|終天|長久
trammel	馬かせ(馬に側対歩を教えるときに使う足かせ)|《複数形で》(自由を)拘束するもの|束縛|障害|〜の自由を拘束する|‘を'束縛する
irresponsibly	無責任に
salade	a light medieval helmet with a slit for vision
chorea	舞踏病(顔面筋および四肢のけいれんを起こす神経系の病気)
oligomer	モノマー(単量体)が少数結合した重合体がオリゴマー(oligomer)|ダイマー(dimer|二量体)|トライマー(trimer|三量体)|テトラマー(tetramer|四量体)等|多数の重合体はポリマー(polymer)
defensiveness	守勢
conciliator	someone who tries to bring peace
qat	カート|チャット|カット
broadax	鉞
millivolt	ミリボルト(1ボルトの1000分の1)
newsbreak	a short news announcement concerning some on-going news story
phyllo	tissue thin sheets of pastry used especially in Greek dishes
kazak	カザーフ|カザーフ|カザフスタン|カザーフ
ketorolac	nonsteroidal anti-inflammatory (trade name Torodal) that is given only orally
sprog	a new military recruit|a child
kaftan	=caftan
phosphorylate	リン酸化する
gruel	罰する|かゆ
transgressive	慣習に逆らう
acetylate	アセチル化|アセチル化
decriminalization	非犯罪化
treed	追い詰められた
muggy	むし暑い
grievously	悲痛
atomization	微粒化
loofah	(体を洗う)ヘチマ|ヘチマの海綿状繊維|ヘチマ布巾
seersucker	シアサッカー(しまのある縮れた薄織りリンネル･紳士用スーツ生地)
knowable	近づきやすい|理解できる
narrowboat	a long boat that carries freight and is narrow enough to be used in canals
noncommissioned	下士官の|将校辞令を受けていない
rescale	establish on a new scale
cytarabine	シタラビン|抗がん剤の一種|商品名キロサイド(Cylocide)|核酸の誘導体である
hesitancy	尻込み|ためらい|ちゅうちょ
ixl	being nine more than thirty
interposition	介在|介入|干渉|仲裁|挿入物
calling	職業|転職|点呼|召集
amphibole	角閃(かくせん)石(カルシウム・マグネシウムを含む石)
distrustful	信用しない
lodestar	(航海などの)道しるべの星;(特に)北極星|指導原理
hooky	ずる休み
randomisation	無作為化|ランダム化
nightjar	ヨタカ(鳥の名)
heartthrob	鼓動|(俗)熱情|恋人
bouse	haul with a tackle
inefficiently	非効率的
incredulously	疑い深く|簡単には信じないで
obsequious	こびへつらう
regrow	再成長
dissolute	自堕落な|放埓な|放蕩な|放蕩の自堕落な
reck	〜‘を'気にかける|こだわる|(〜を)気にかける《+『of』+『名』》
whorehouse	売春宿|女郎屋
agonise	cause to agonize|suffer agony or anguish
underprice	sell at artificially low prices
procaine	パロカイン(局所麻酔な用いる薬品)
lamplight	灯火
mistrustful	疑い深い
schnitzel	シュニッツェル(ドイツ料理で子牛肉のカツレツ)
cutworm	ネキリムシ(根切り虫)(植物の根を食い切る害虫の総称)
hereon	ここにおいて|この直後に|このすぐ後で
semiannually	半年毎に
coevolution	共進化
hellebore	perennial herbs of the lily family having thick toxic rhizomes|any plant of the Eurasian genus Helleborus
locater	a person who fixes the boundaries of land claims
unprincipled	無節操
backspin	バックスピン(ビリヤード・卓球などで球に逆家転をつけること)
popliteal	膝窩
electrocardiographic	of or relating to an electrocardiograph
uncompetitive	不競合的
envelopment	包むこと|包囲
pacification	なだめること|和解すること|平和|講和;講和条約
nitrogenous	窒素性
destructiveness	破壊性
sackcloth	(ズックなどの)袋地|(昔|服喪または悔悟のしるしとして着た)粗麻服
pathologically	病理学的に|病的に|異常に
sensitizer	増感剤
enrapture	〈人〉‘を'有頂天にする|うっとりさせる
nearsightedness	近眼|近視
entrap	〜‘を'わなにかける|〈人〉‘を'計略にかける;〈人〉‘を'欺いて(〜)させる《+『名』〈人〉+『into』+『名』(do『ing』)》
graben	(地質で)地溝
cyma	(architecture) a molding for a cornice; in profile it is shaped like an S (partly concave and partly convex)|a molding for a cornice|in profile it is shaped like an S (partly concave and partly convex)
overcapacity	設備過剰|生産能力過剰
gelding	せん馬|去勢馬|騸馬
resuspension	再懸濁
disfavor	気に入らないこと|きらう|疎外
boeuf	ビーフ|牛肉|牛
mudslide	土砂崩れ
fidgety	落ち着かない|せかせか(そわそわ)している|(細かいことにうるさく)気難しい
barroom	酒場
thrombophlebitis	血栓静脈炎
chukka	(polo) one of six divisions into which a polo match is divided|one of six divisions into which a polo match is divided|a shoe that comes up to the ankle and is laced through two or three pairs of eyelets; often made of suede|a shoe that comes up to the ankle and is laced through two or three pairs of eyelets|often made of suede
sundress	サンドレス
bacitracin	バシトラシン
intriguingly	興味深いことに
vitrify	〜‘を'ガラス[状]にする|ガラス[状]になる
soundman	a technician in charge of amplifying sound or producing sound effects (as for a TV or radio broadcast)
sophistry	詭弁(を弄すること)
cosmetically	for cosmetic purposes to improve appearance; "it is used cosmetically by many women"|for cosmetic purposes to improve appearance
viscometer	粘度計
quoin	(建物の外壁の)かど;(そのかどを造る)すみ石|くさび石|くさび;くさび型の物
parttime	involving less than the standard or customary time for an activity; "part-time employees"; "a part-time job"|involving less than the standard or customary time for an activity
singalong	informal group singing of popular songs
durbar	(インド土侯・旧インド総督の)公式会見|謁見
brazenly	厚かましく
catechol	カテコール|フェノール類の有機化合物|ウルシオール(漆の主成分)|カテキンなどのポリフェノールほか多くの生体物質の骨格に含まれる
earwax	耳あか|耳くそ
unhurried	優々たる|優優たる
shriveled	(used especially of vegetation) having lost all moisture; "dried-up grass"; "the desert was edged with sere vegetation"; "shriveled leaves on the unwatered seedlings"; "withered vines"|(used especially of vegetation) having lost all moisture
fractious	怒りっぽい|気むずかしい|手に負えない|面倒を起こす
conformable	一致した|適合した;(慣例・規範などに)準拠した《+『to』+『名』》|従順な;(〜に)よく従う《+『to』+『名』》
toothy	歯を見せる
cheesecloth	チーズを作るときに用いる目のあらい綿布
uselessly	徒らに|むだに|徒に
hemline	裾の線 (hemはヘリ)
gallantly	優しく|勇敢に|雄々しく|慇懃に
prejudgment	a judgment reached before the evidence is available
earthman	地球人
ulama	ウラマー
ectoderm	外胚葉
bended	曲がった
confidante	confidant(親友)の女性形
habitus	体質|背格好|身なり|筋骨|からだ付き|体つき|スタイル|柄|体格|体形|造り
watchband	腕時計のバンド
megabuck	100万ドル|巨額な資金力
scarey	おっかない|怖い|恐い|悍ましげ
poignantly	感動的
depopulation	過疎
untiring	疲れない|疲れを知らない|たゆまない|不屈の
eosin	エオシン
mechanize	機械化|単調化|機械化
bwr	沸騰水型原子炉
unionize	労働組合を組織する|労働組合に加入する|を合体させる|統一する
numberless	(比較変化なし)《おもに文》無数の|数えきれない|番号のない
intemperance	不節制;暴飲[暴食]
submergence	水中に沈めること|水没|浸水
fuller	円型溝づけ器|丸溝|縮充工|洗い張り屋|に丸溝をつける
pennines	ペンニン山脈
expansionist	of or involving or guided by expansionism
definiteness	the quality of being predictable with great confidence
numeration	数えること|計算|数え方|計算法
sulfa	スルホンアミド|サルファ剤
forgivable	許してよい
peevish	気難しい|怒りっぽい|不平を言う
greaser	(機械に)油を差す人|《俗》《軽べつして》ラテンアメリカ人|(特に)メキシコ人
splashdown	(宇宙船の)着水
facing	上塗り|向く
multiform	多くの形態を持っている;多様な
unmapped	(of unknown regions) not yet surveyed or investigated; "uncharted seas"|(of unknown regions) not yet surveyed or investigated
scrounge	くすねる|行商する
resh	the 20th letter of the Hebrew alphabet
lacklustre	lacking brilliance or vitality; "a dull lackluster life"; "a lusterless performance"|lacking brilliance or vitality|lacking luster or shine; "staring with lackluster eyes"; "lusterless hair"|lacking luster or shine
sampling	サンプリング抽出
locknut	ゆるみ止めナット
leaker	a surreptitious informant; "the president wanted to know who the leakers were"|a surreptitious informant
nonfood	食料品以外の商品
flattop	=crew-cut|《まれ》航空母艦
indelibly	消えないように|永久に
aphelion	遠日点(月・遊星が太陽から最も離れる点)
expositor	説明者|解説者
stakeout	張り込み
ashy	灰の(ような)|灰まみれの|灰色の|蒼白な
handhold	手づかみ|手がかり
goner	死者|死に体|落ちぶれた人|見込みのない人
weaving	製織
submersion	=submergence
overpressure	a transient air pressure greater than the surrounding atmospheric pressure; "the overpressure of the blast kills by lethal concussion"|a transient air pressure greater than the surrounding atmospheric pressure
rosehip	ローズヒップ
traumatology	災害外科
uninvolved	not involved; "being uninvolved he remained objective"|not involved
picaresque	悪漢を題材とした
naturalize	市民権を与える|帰化させる|ナチュラライズ
gourmand	大食家|美食家|食道楽|食通
slavish	独創性のない|卑屈な|卑劣な|奴隷の|奴隷のような|すっかり模倣する
awestruck	打たれた
felicitous	適切な|ぴったりの|うまい|表現の巧みな|幸運な
caravel	キャラベル(15-16世紀の軽快な帆船)
quicky	応急処置
carboy	カーボイ|大きなガラス製の酒入れ|箱入り大型ガラスビン
necromancy	交霊による占い|いかがわしい魔術
plaudit	拍手かっさい|賞賛|拍手|喝采
benefice	(牧仕|特にvicar|rectorの)聖職禄;受禄職者の地位
pemphigus	a skin disease characterized by large thin-walled blisters (bullae) arising from normal skin or mucous membrane
cxl	being ten more than one hundred thirty
demander	a person who makes demands
mentha	薄荷
conspecific	an organism belonging to the same species as another organism|belonging to the same species; "cultivated cabbage and wild cabbage are conspecific"|belonging to the same species
winterize	prepare for winter; "winterize cars"; "winterize your houses"|prepare for winter
underachievement	poorer than expected performance (poorer than might have been predicted from intelligence tests)
trilobite	三葉虫(甲殻類に属する最古の化石動物)
geosynchronous	of or having an orbit with a fixed period of 24 hours (although the position in the orbit may not be fixed with respect to the earth)
stigmatization	the act of stigmatizing
marginalia	《複数形》(本の)欄外の注|傍注
cuniculus	pacas
terahertz	テラヘルツ
grading	スケーリング
jackdaw	=daw
monovalent	containing only one kind of antibody|having a valence of 1
uncrowded	having or allowing sufficient room; "an uncrowded train"; "an uncrowded view"|having or allowing sufficient room
revitalisation	返り咲き|復活|甦り|復興|リバイバル|再現|中興|再燃|再興|返咲き
snood	(女性が後ろの髪を束ねる)ヘアネット;ヘアネット式の帽子
hardboiled	(卵など)堅ゆでの|(人が)非情な|冷酷な;(物の見方などが)現実的な|ちゃっかりした;(文学の作風が)非情派の|ハードボイル派の
billow	大きく波うつ|大波|大きなうねり|もくもく|煙が上がる様子
cleft	裂け目|分裂|cleaveの過去･過去分詞|裂けた|割った
helianthus	向日葵|ヒマワリ|日回り
osseous	骨の|骨に似た
honorific	敬語
underhand	(野球などで)下手投げの|秘密の|ずるい|下手投げで|こそこそとずるく|陰険に
idolatrous	偶像崇拝の|偶像崇拝的|心酔する
translatable	翻訳可能な|言い換えられる
angioedema	血管性浮腫
tradespeople	小売商人
polytheism	多神教;多神論・反対語の「一神教」は「monotheism」
ethnological	民族学[上]の
reveller	a celebrant who shares in a noisy party; "the clubs attract revelers as young as thirteen"|a celebrant who shares in a noisy party
hippocratic	of or relating to Hippocrates or the school of medicine that took his name
harasser	a persistent tormentor|a persistent attacker; "the harassers were not members of the regular army"|a persistent attacker
hexose	六炭糖
quitclaim	(不動産などの)権利放棄|〈財産・権利などの要求〉‘を'放棄する
hemagglutination	赤血球凝集
lgv	infectious disease caused by a species of chlamydia bacterium; transmitted by sexual contact; characterized by genital lesions and swelling of lymph nodes in the groin|infectious disease caused by a species of chlamydia bacterium|transmitted by sexual contact|characterized by genital lesions and swelling of lymph nodes in the groin
stovepipe	ストーブの煙突
kuomintang	国民党
potbelly	太鼓腹
flavonoid	フラボノイド
poultice	湿布|パップ
bombast	大言壮語|豪語|誇張
catbird	ネコマネドリ(北米産のツグミの一種)
hassock	(お祈りのときに使う)ひざ布団|草むら(tussock)
deregulate	規制を解除する
impulsively	衝動的に
giggly	クスクス笑う
gamekeeper	(密猟防止・鳥獣保護・飼育などのための)猟場管理人
cannibalize	(車･機械)分解･解体する|(人の)肉を食う|共食いする
milch	乳を出す
intraspecific	種内
katydid	キリギリス科の昆虫の一種(米国産)
nonfunctional	機能しない
hawksbill	タイマイ
tortoiseshell	〈U〉べっ甲|〈C〉ヒオドシチョウ(タテハチョウの類の一つ)|〈C〉三毛ネコ
madrasa	マドラサ
pedicle	=pedicel
diamine	ジアミン
temerity	向こう見ず|無鉄砲
collusive	なれ合いの|共謀の
ricer	ライサー(ゆでたジャガイモなどをつぶす台所用具)
oropharyngeal	口咽頭
adventitious	偶然の
zeaxanthin	ゼアキサンチン
horehound	ニガハッカ(ヨーロッパ原産のシソ科の多年草;苦い薬用の液が出る)|ハッカで風味をつけた薬(砂糖菓子)
fleecy	羊毛でできた;羊毛でおおわれた|羊毛のような
abaca	アバカ|マニラ麻|マニラアサ|アバカ
busbar	バス
pyrography	the act of producing drawings on wood or leather by using heated tools or a fine flame
territoriality	縄張り行動
koinonia	Christian fellowship or communion with God or with fellow Christians; said in particular of the early Christian community|Christian fellowship or communion with God or with fellow Christians|said in particular of the early Christian community
bigamy	二重結婚|重婚
impoverish	貧弱にする|貧乏にする|を貧しくする|低下させる
thorazine	クロルプロマジン|ソラジン|クロールプロマジン
unanswerable	答えられない|反論できない|責任のない
holism	全体論(全体はその構成部分の総和よりも価値があるという哲学理論)
jerker	someone who gives a strong sudden pull
hizbollah	イスラムジハード
carrageenan	カラギーナン
turbot	ヒラメの一種(ヨーロッパ産);〈U〉その肉
descender	ディセンダ|ディセンダ|ディセンダ
seaborne	海上[輸送]の
summons	召喚する|呼び出し|出頭命令|召喚
untainted	新鮮
broglie	French nuclear physicist who generalized the wave-particle duality by proposing that particles of matter exhibit wavelike properties (1892-1987)
metazoan	後生動物(Metazoa)の|後生動物は|動物分類学で動物扱いだった単細胞生物の原生動物に対し|多細胞の動物をまとめた呼び名として使用された
desiccate	〜‘を'からからに乾燥させる
forevermore	常に|絶えず
dayspring	有り明け方|有明け方|夜明け|彼誰|明けがた|有明|日出|払暁|白白明け|暁天
tsarist	of or relating to or characteristic of a czar
ananas	パイナップル
miserly	けちな|欲深い
radiosonde	ラジオゾンデ(気球からの電波で上空の気象を知らせる装置)
troth	忠実|誠実|真実
contemptuously	見下げるように|軽蔑して
tahini	a thick Middle Eastern paste made from ground sesame seeds
teakwood	チーク
aspinwall	コロン
decomposable	capable of being partitioned
mercaptoethanol	メルカプトエタノール|劇物取締法による毒物|引火性で炎や酸化剤などに接触すると発火する|還元剤として働く
mangler	艶出し
ideologue	イデオロギーの信奉者|空論家|夢想家
impugn	非難する|論難する|異議を唱える|反駁する|疑いを差し挟む
antipodean	(にとって)対蹠地の|(と)正反対の(to)
catchall	種々雑多なもの(がらくた)をなんでも含む(収める)もの|広範囲の
blase	歓楽に飽きた|無関心な|世慣れた
islamophobia	prejudice against Muslims; "Muslim intellectuals are afraid of growing Islamophobia in the West"|prejudice against Muslims
lyse	(生命科学)細胞溶解する
dissenter	反対者|国教反対者|非国教徒(Nonconformist)
pornographer	ポルノ製作者
napu	chevrotain somewhat larger than the kanchil; found in India and Malaya|chevrotain somewhat larger than the kanchil|found in India and Malaya
metallurgist	冶金学者|冶金技術者
twitchy	引きつった
tangentially	接線方向に
auric	of or relating to or containing or derived from gold
illuminant	イルミナント|発光体
malocclusion	不正咬合(こうごう)(歯がうまくかみ合わないこと)
imperishable	不滅の|不朽の
illuminance	照度
insolation	日光にさらすこと|日光浴|日謝病
fixate	固定する|定着する|凝視する|固定させる|定着させる
famish	〜‘を'飢えさせる|飢える
separateness	別々になっていること|分離
antisemitic	relating to or characterized by anti-Semitism; hating Jews|relating to or characterized by anti-Semitism|hating Jews
godwit	large wading bird that resembles a curlew; has a long slightly upturned bill|large wading bird that resembles a curlew|has a long slightly upturned bill
deponent	(法廷における)宣誓証人
leister	a spear with three or more prongs; used for spearing fish (especially salmon)|a spear with three or more prongs|used for spearing fish (especially salmon)
burka	ブルカ
ulna	(人の腕|動物の前肢の)尺骨
generalizability	一般化可能性
feet	足(foot)の複数形
polyelectrolyte	高分子電解質|多価電解質
blackhead	上部が黒いにきび(吹出物)
haganah	ハガナ
bipedal	二足動物
expropriate	(特に|公共の用にあてるため|個人・企業から)〈私有財産〉‘を'没収する|〈人〉‘から'(財産を)没収する《+『名』〈人〉+『from』+『名』》
extendible	capable of being lengthened
nimby	ニンビー
civet	ジャコウねこ(civet cat)から採る香料
streptokinase	ストレプトキナーゼ
tollgate	通行料金徴収所
breadboard	回路部品板(実験用の電子回路の集り)|パン切り板|パンこね板
transept	翼廊|(十字形教会堂の)左右に直角に張り出す部分|トランセプト
bioluminescence	生物発光
geomorphological	pertaining to geological structure; "geomorphological features of the Black Hills"; "morphological features of granite"; "structural effects of folding and faulting of the earth's surface"|pertaining to geological structure
dispensable	無くてもすむ
sambar	a deer of southern Asia with antlers that have three tines
plink	(銃などで練習･遊びとしてを)撃つ|(楽器などを)ポロン･ペンと弾く|(チリン･リンなど)軽く響く音を断続的に立てる
anthroposophy	a system of beliefs and practices based on the philosophy of Rudolf Steiner; it claims to integrate the practical and psychological in child-centered education|a system of beliefs and practices based on the philosophy of Rudolf Steiner|it claims to integrate the practical and psychological in child-centered education
abstruse	難解な|難しい|深遠な
embryonal	胎生の|胚性の|胚
shakeout	急反落|暴落
stripling	青年|若者
recusal	(law) the disqualification of a judge or jury by reason of prejudice or conflict of interest; a judge can be recused by objections of either party or judges can disqualify themselves|the disqualification of a judge or jury by reason of prejudice or conflict of interest|a judge can be recused by objections of either party or judges can disqualify themselves
alnus	alders
haldol	ハロペリドール
televangelist	テレビ伝道師
naif	すれてない|ナイーヴ|うぶ|純樸|淳樸|醇朴|ナイーブ|淳朴|醇樸
succour	=succor
telekinesis	念動[作用](外力を加えず念力で物を動かす)
haemodynamic	血行動態
forsythia	レンギョウ|早春に黄色い花を鈴なりに付ける低木
protean	Proteusプロテウス(ギリシア神話|変幻自在の海神|)の(ような)|変幻自在な|多方面の
carpel	(花の)心皮(生長して果皮となり|そこに実がなる)
stoat	貂|テン|イタチ(夏に毛が褐色)
spirt	=spurt
convector	a space heater that transfers heat to the surrounding air by convection
bulrush	《米》フトイ|《英》ガマ(水辺・沼にはえる植物)
naturalisation	ナチュラリゼーション|帰化|帰化
quango	a quasi nongovernmental organization; an organization that is financed by the government yet acts independently of the government|a quasi nongovernmental organization|an organization that is financed by the government yet acts independently of the government
contiguity	広がり|接近|接触|隣接|隣接性|連続
cattleman	牛飼い|牧場主
alphabetize	〜'を'アルファベット順に並べる|〜'を'アルファベットで表す
grounder	簡単に解決できる殺人事件|(野球)ゴロ(= ground ball)
strew	をばらまく
trachoma	トラコーマ|トラホーム(眼の伝染病)
verdure	(草木の)新緑|緑の草木
exclusiveness	排他[性]|独占
misapplication	誤用|乱用
bosun	=boatswain
spinney	雑木林|木立
tetragonal	正方晶
wretchedness	窮状|悲惨さ|惨めさ|悲酸さ|塗炭|困窮|惨状
etiological	因果関係の(ある)|病因の|因果関係学の
steadfastness	不動さ
cytologic	細胞学的
idealization	美化|理想化
dwarfism	小人症
areca	any of several tall tropical palms native to southeastern Asia having egg-shaped nuts
mummification	ミイラ化
passbook	銀行通帳(bankbook)
murk	真暗やみ|暗黒
didactics	教え|教育|指導|垂教|エデュケーション|エジュケーション|教示|教諭|指南|教授
hullo	やあ
butterfat	牛乳の脂肪
firkin	(バター・ラードなどを入れる)小型の桶(おけ)|ファーキン(英国の容量単位|1|4barrelに相当)
xliii	being three more than forty
fatso	太っちょ|でぶ
chlorate	塩素酸塩
coxswain	(競漕用ボートの)舵(だ)手|かじ取り|艇長
depilation	the condition of being void of hair|the act of removing hair (as from an animal skin)
spat	ささいなけんか|いさかいをする|spit(つばや悪口を吐く)の過去分詞
misquote	誤って引用する
garcinia	evergreen trees and shrubs: mangosteens
protestor	抗議者
baleful	有害な|不吉な|悲惨な|元気のない|悪意に満ちた
volitional	意志の|意志に関する|意志に基づく
agouti	アグーチ
relaxin	リラキシン
fantabulous	目覚ましい|妙々たる|上々|輝かしい|目ざましい|精良|素適|素晴しい|素晴らしい|優等
clawhammer	a hammer with a cleft at one end for pulling nails
professionalization	the social process whereby people come to engage in an activity for pay or as a means of livelihood; "the professionalization of American sports"; "the professionalization of warfare"|the social process whereby people come to engage in an activity for pay or as a means of livelihood
jerkin	(16‐17世紀ごろ男子が用いた)袖無しの上着
foist	(偽物など)を人につかませる|押しつける|そっと挿入する|偽って～の作だとする
theodolite	経緯儀(鉛直角・水平角を測定するのに使う器械)
hydroxyproline	ヒドロキシプロリン
alar	翼のある;翼の形をした
tilth	the state of aggregation of soil and its condition for supporting plant growth
mechanise	機械化|単調化|機械化
workfare	勤労福祉制度
glottal	(のどにある)声門の
plena	plenumの複数形
pachyderm	(pˈækɪd`ɚːm)厚皮動物(カバ･ゾウ･サイなど)|鈍感な人
dichloride	二塩化
irrationally	非合理的に
cadaveric	of or relating to a cadaver or corpse; "we had long anticipated his cadaverous end"|of or relating to a cadaver or corpse
fearlessness	勇気
parus	type genus of the family Paridae
slake	満足させる|を和らげる|を満たす|を晴らす|を消す
unalterable	変えられない|不変の
jetport	ジェット機用空港
sandblast	砂吹き(噴砂機でガラスや金属を切磨すること)
maximisation	最大化
higher	より高い
inexpressible	言い表せない
effectivity	有効性
mercuric	(特に)第二水銀の(を含んだ)
inrush	突入|侵入，来襲・流入，殺到 〔of〕
decalogue	十戒
purslane	スベリヒユ(サラダなどに入れて食べる雑草)
baleen	ホエールボーン
glaringly	in a glaring manner; "it was glaringly obvious"|in a glaring manner
lobular	of or relating to or resembling a lobule
wantonly	きまぐれに|きままに|浮気に
kasbah	カスバ
anxiolytic	抗不安薬|抗不安薬
hydrolysate	a product of hydrolysis
transuranic	having an atomic number greater than 92
squeezer	圧搾器|(レモンなどの)絞り器|搾取者
samovar	サモワール(おもにロシアで用いられているお茶用の湯沸かし器)
indoctrinate	に教え込む|吹き込む
nonmonotonic	not monotonic
beheading	断頭
peripherally	末梢性
footstep	足音
rase	解体|打毀し|打毀|打ち壊す|打壊し|取りくずす|打ち壊し|ばらす|破壊|取壊す
acrimony	(言葉･気質など)辛辣さ|とげとげしさ|厳しさ
hyponatremia	低ナトリウム血症
bristly	剛毛の
lockjaw	=tetanus
deaden	弱める|鈍らせる|消す
conciliate	〈人〉'を'なだめる|懐柔する;〈人〉‘の'好意を得る
soever	《who|what|whereなどと連結して》どんな〜でも|たとえどのように〜とも|《否定語を強調して》全然[〜でない]
dinnertime	夕食時
tracing	さかのぼる|透写|追跡|捜索|複写
ruefully	残念そう
unfavorably	悪し様に
slothful	不精な
oculomotor	動眼神経
hallucinogen	幻覚剤
agriculturist	中耕機|カルチベーター|耕作者
tomfoolery	ばかなまね
ruthlessness	無慈悲
gnash	歯ぎしり(する)
bigeye	red fishes of American coastal tropical waters having very large eyes and rough scales
aken	アーヘン|エクスラシヤペル
unglued	取り乱した;狂気の
pompadour	ポンパドゥール(男性のオールバック|または女性の前髪をなで上げて後ろで束ねた髪型)
reassuringly	安心させるように|はげみになるように
pisum	エンドウマメ|別名グリンピース|サヤエンドウ
delf	an excavation; usually a quarry or mine|an excavation|usually a quarry or mine
bunche	United States diplomat and United Nations official (1904-1971)
preclusion	防止|妨害
anthelmintic	虫下し|虫くだし|虫下|駆虫剤|駆虫薬|寄生虫様
grownup	『成長した』|成人した|『おとならしい』|おとなに適した|『おとな』
lungen	リュウガン|竜眼
engram	エングラム(経験によって生ずる神経系細胞内の構造別化)|(記憶の)痕跡|印象
snaffle	(馬の)はみ|小勒(しょうろく)
miscible	混和できる
estrone	エストロン
tessera	a small square tile of stone or glass used in making mosaics
vulpes	foxes
uncultured	(of persons) lacking art or knowledge
coif	頭布(ずきん)(騎士がかぶとの下に修道女がベールの下につける)|=coiffure
parachutist	落下傘で降りる人|落下傘兵
calorific	熱の|熱を生じる
fief	(封建時代の)領土|封土
estrous	発情期の
osteoblast	骨芽細胞
electroshock	電気ショック療法
shakeup	(事業・政治上の)大異動|大刷新
stopgap	当座しのぎ|穴ふさぎ|間に合わせの
phosphorescent	リン光性の;青光りする
inchoate	始まったばかりの|初期の|不完全な|未完成の|組織化されていない|形の定まらない
surtax	所得税|付加税
polymerisation	重合
unashamedly	のめのめ|臆面も無く|臆面もなく|ぬけぬけ
anechoic	(録音室・スタジオなどが)反響のない|無響の
waterbird	水鳥
barramundi	a species of large perch noted for its sporting and eating qualities; lives in marine, estuary, and freshwater habitats|a species of large perch noted for its sporting and eating qualities|lives in marine, estuary, and freshwater habitats
foundling	拾い子|捨て子
sparling	common smelt of Europe|the common smelt of Europe
illiberal	心の狭い|狭量の|物惜しみする|けちな
lento	(音楽が)おそい|ゆっくりした|ゆっくりと[演奏して]
voyeuristic	(vwὰːjɚ(ː)rístɪk)覗き見の|覗き見趣味の
stationer	文房具商
albinism	先天性白色症|白子
onlooker	傍観者|観客|見物人
firebrick	耐火れんが
deathless	不死の|不滅の(immortal)
garbanzo	=chickpea
tarsal	足首の|足根骨
debase	の品性を落とす|の品質を低下させる
isentropic	with unchanging entropy; at constant entropy|with unchanging entropy|at constant entropy
coactivator	コアクチベーター(共に活性化する要素)
reabsorption	再吸収
dragger	網船|トロール船|網船
deice	〈飛行機・自動車・冷蔵庫など〉‘の'結氷(結霜)を取り去る|結氷(結霜)を防ぐ
gastroenterologist	a physician who specializes in diseases of the gastrointestinal tract
treadle	(ミシンなどの)踏み子|ペダル|踏み子(ペダル)を踏む
iis	アイアイエス
hearthside	炉ばた
scummy	浮きかすの多い|下等な
feminise	女性化|女性化
sightedness	目視|お目|御目
chiaroscuro	(イタリア語)キアロスクーロ|白と黒のスケッチ (light and dark)
gimmicky	見てくればかりの|からくりで人目を引く
propulsive	推進力のある|推進する
ensnare	(人･動物を)わなに掛ける|誘惑する
bellicose	好戦的な|敵意に満ちた|けんか早い|けんか好きな
hypogonadism	性腺機能低下症
undergird	〜‘に'しっかりした基礎を与える|‘を'強化する
commissariat	糧|粮|兵糧|食糧|糧食|兵粮
nonsectarian	特定の宗派に属さない|無宗派の
redraft	a draft for the amount of a dishonored draft plus the costs and charges of drafting again
vernonia	any of various plants of the genus Vernonia of tropical and warm regions of especially North America that take their name from their loose heads of purple to rose flowers that quickly take on a rusty hue
vinifera	ブドウ
hydrophone	水中聴音器;(医学用の)通水聴診器
megalomaniac	誇大妄想狂
jabiru	セイタカコウ
mediastinum	縦隔
tipple	(恒常的に)酒を飲む|アルコール飲料
abscissa	横座標
freckle	そばかす
allergist	アレルギー性疾患専門医
tansy	〈C〉コモギギク[属](小さな黄色い花の房をつける)|〈U〉(薬用・食用の)ヨモギギクの汁
perceptually	知覚的
paintable	lending itself to being painted; "a highly paintable landscape"; "made of sturdy eminently paintable wood"|lending itself to being painted
harmlessly	in a harmless manner; "this is a harmlessly childish game"|in a harmless manner
congruency	=congruence
nonwhite	非白人
flab	ぶよぶよ|ぜい肉
paroxysm	発作(sudden attack)|けいれん(spasm)|ひきつけ(fit)
ouzo	ウーゾ|ブランデーにアニス(地中海産のセリ)の香りをつけたギリシアの無色のリキュール
rhenium	レニウム
liveliness	元気のあること;陽気|鮮やかさ
godson	洗礼で教父母が名づけた息子|Cf|godchild(〃幼児)
downfield	低磁場|低磁場
toddle	よちよち歩く|赤ちゃんの歩く様子|toddlerヨチヨチ歩きの赤ちゃん
adjectival	形容詞的語句|形容詞の･を作る
feckless	無効な|無能な|役に立たない
crystallisation	結晶化
tuberose	チューベローズ
stereophonic	ステレオの|立体音響(効果)の
hoedown	(スクエアダンスを中心にした)地域ぐるみのダンスパーティー
musial	ムジアル
circumnavigate	周航する
niggle	めんどうな
unglazed	not furnished with glass; "windows were unglazed to admit as much light and air as possible"|not furnished with glass|not having a shiny coating; "unglazed paper"|not having a shiny coating
artificer	技術者|(船の機関室の)技術兵
funicular	ケーブルカー|鋼索鉄道|ロープによる|ロープの|索状の|珠柄の|吊り重り作用の
diverticulum	憩室
solidus	ソリドゥス(ローマ帝国の金貨)|(日付・分数などの)斜線(oblique)
hysteroscopy	ヒステロスコピー
medulloblastoma	髄芽腫
clapboard	かちんこ|羽目板|に下見板を張る
barite	硫酸バリウム|重晶石
amaranthus	large widely distributed genus of chiefly coarse annual herbs
manat	the basic unit of money in Turkmenistan|the basic unit of money in Azerbaijan
cyanosis	チアノーゼ|青色症
flameproof	耐炎性|耐火性
muncher	a chewer who makes a munching noise
individualization	個別化|個体化
famotidine	ファモチジン
stirring	感動的な|活発な|多忙な
strindberg	ストリンドベリ
inconel	インコネル
copepod	ケンミジンコ
gluconeogenesis	糖新生(とうしんせい|gluconeogenesis)|飢餓状態に陥った動物が|乳酸|プロピオン酸|グリセロールなどの糖質以外の物質からグルコースを生産する経路
alewife	北米産のニシンに似た食用魚
leiomyoma	平滑筋腫
unquenchable	impossible to quench; "unquenchable thirst"|impossible to quench
stepmom	継母
indolence	怠惰|なまけ
calliper	端度器
comedienne	喜劇女優|女性コメディアン
profundity	深遠
clon	クローン
dewdrop	露のしずく|露の玉
fetoprotein	フェトプロテイン
turgid	腫れ上がった|大げさな
exigency	緊急性|危急|緊急事態|急場|急迫(した事情)|切迫
conjuration	呪文を唱えること|イリュージョン|奇術|幻術|手品|イルージョン|魔術|トリック|マジック
clubhead	クラブヘッド
muchly	大いに
catchword	欄外見出し語|スローガン
vivarium	生態動物園(動物が自然に近い状態で飼育されている)
interlinear	(本の)行間にある|行間に書き入れた
unenviable	あまりうらやましくない|あまり欲しくない
archaeopteryx	始祖鳥
obscenely	エロ
grevillea	any shrub or tree of the genus Grevillea
antinuclear	原子力開発に反対の|反原子力主義
unpackaged	not packaged or put into packets; "unpackaged nuts"|not packaged or put into packets
unfeeling	無感覚の|無情な|冷酷な(cruel)
microscopical	顕微
patroller	someone on patrol duty; an individual or a member of a group that patrols an area|someone on patrol duty|an individual or a member of a group that patrols an area
catatonia	緊張[型分裂]病(筋肉硬直や精神混迷を伴う)
enunciate	発音する|明確に系統立てて説く|宣言する|公表する
evaluable	評価が可能な
precipitator	沈殿剤
flapjack	ホットケーキ|クッキー|揚げパン
chekov	チェーホフ
vilna	ビルナ|ビリニュス
hydromorphone	ヒドロモルフォン
revolutionist	革命家;革命論者
suppleness	しなやかさ|たわやかさ
irascible	怒りっぽい|かんしゃく持ちの|短気な|怒った|(人･性質など)おこりっぽい
jackknife	(また『clasp knife』)ジャックナイフ(刃のたためる大型のポケットナイフ)|えび型飛込み|ジャックナイフダイブ|(トラクター・トレーラーなどが)まん中でVの字に折れ曲がる
blare	鳴り響く|耳障りな響き
denude	〜‘を'裸にする;(物を)〈人・物〉‘から'はぎ取る《+『名』+『of』+『名』》
misreport	《しばしば受動態で》〜‘を'虚報を伝える|‘を'誤って報告する
downslope	下り坂
roadwork	ロードワーク(長距離ランニングによる体力作り)
seminarian	神学校の学生|神学生|(神学校出身の)聖職者
stele	(文字や模様を彫刻した考古学上の)石柱|石碑
jowl	顎(特に下顎)
dreck	安物
gulden	=guilder
incorporeal	体のない|無形の|霊的な
cholelithiasis	胆石症
gherkin	(酢づけにする)小キュウリ
dapsone	ダプソン
crape	クレープ|クレープの喪章|ちりめん|縮らせる|crape myrtle百日紅(サルスベリ)
mouldy	=moldy
floc	a small loosely aggregated mass of flocculent material suspended in or precipitated from a liquid
fisc	a state treasury or exchequer or a royal treasury; originally the public treasury of Rome or the emperor's private purse|a state treasury or exchequer or a royal treasury|originally the public treasury of Rome or the emperor's private purse
unashamed	臆面もない
dismantlement	解体|分解
hydroplane	水上滑走艇|水上飛行機(seaplane)
perpendicularly	垂直|垂直
downwardly	下向き|下方へ|下に|下へ
geniculate	膝状体
teatime	(午後の)お茶の時間
stainer	a worker who stains (wood or fabric)
woodenware	木製台所用品(木ざら・木さじなど)
pushover	くみしやすい相手|カモ
packable	capable of being packed
breathy	気息音の交じる|息遣いが聞こえる
benighted	(旅人)行き暮れた|未開の|文化の遅れた|闇に包まれた
hysteric	=hysterical|《複数形で》ヒステリーの発作|〈C〉ヒステリー患者
clast	(geology) a constituent fragment of a clastic rock|a constituent fragment of a clastic rock
khat	カート|チャット|カット
exultation	(〜での)大きな喜び《+『at』+『名』》(〜に対する)勝ち誇った気持ち《+『over』+『名』》
selfsame	全く同一の
glaucous	《文》淡い青緑色の|(ぶどうなど)白い粉の吹いた|白色を帯びた
soberly	真面目に|冷静に|酔わないで
pulverize	(議論などを)粉砕する|粉にする|粉々に砕く|液体を霧状にする
launderette	洗濯屋
subsidisation	下付金|交附|下げ渡し|供与|附与|施与|下渡し|恵賜|交付金|付与
knobby	でこぼこの|こぶだらけの
curmudgeonly	気難しい|荒々しい|不機嫌
schmaltz	過度の感傷主義|感傷性
fetid	強い悪臭を放つ|臭い
singleness	単独;独身|専念|専心
kaput	やられて|だめになって|ぶちこわされて
tailspin	きりもみ降下(落下)|(経済的)混乱|狼狽|動揺
blackface	黒綿羊(くろめんよう)|黒人に扮した役者|肉太活字(の)
packrat	モリネズミ(北米産;小さく光る物を巣に集める習性がある)
indefiniteness	不確定|不定
windsock	(風向表示用の)吹き流し(空港などに設置される筒状の布製風見)
yearning	切望している|あこがれる|あこがれ|同情
hydric	having or characterized by excessive moisture; "a hydric habitat"|having or characterized by excessive moisture
dphil	a British doctorate
remise	譲与|譲与|譲与
unquiet	平静でない|落着きのない|不安な
herbage	草|(特に)牧草|(草の)葉と茎
fluorosis	a pathological condition resulting from an excessive intake of fluorine (usually from drinking water)
twaddle	無駄口
burnish	磨く
running	走ること|走力|経営|管理|運転|走る|現行の|広まっている|(植物が)つる性の
chanterelle	アンズタケ(黄色の食用キノコ)
unutterable	言いようのない|言語に絶する|発音できない
cero	large edible mackerel of temperate United States coastal Atlantic waters|large mackerel with long pointed snout; important food and game fish of the eastern Atlantic coast southward to Brazil|large mackerel with long pointed snout|important food and game fish of the eastern Atlantic coast southward to Brazil
proserpine	goddess of the underworld; counterpart of Greek Persephone|goddess of the underworld|counterpart of Greek Persephone
diarrhoeal	下痢性
iodize	ヨード化|ヨード化
beefeater	ロンドン塔の守衛|英国王の護衛兵(yeoman of the [English royal] guard)|牛肉を食べる人
inelegant	優美でない
shoehorn	靴べら|詰め込む|押し込む|(何かにフィットするように)合わせる
facially	with respect to the face
veep	(vice presidentの頭の文字から)副大統領
poppycock	ばかげた話|たわごと
nebular	星雲の;星雲状の
colorimeter	比色計
taciturn	口数が少ない
enumerable	枚挙可能な
translocase	トランスロカーゼ(酵素)|転位酵素
haemodialysis	人工透析|血液透析
eutrophic	(湖が)富栄養の|(動植物の)栄養物が豊かな
laterality	左右差
superpose	(〜の上に)〜‘を'重ねて置く《+名+on(upon)+名》|(幾何で)〈図形〉‘を'重ね合わせる
allemande	アルマンドソース|アルマンド
betrothal	婚約
nippy	(幼児語)おしゃぶり(=pacifier)|すばしこい|厳しい
trimaran	三胴船
spliff	合わせ目|付け根|継ぎ目|継目|ジョイント
boorish	百姓風の|野卑な|無骨な|無粋な
crampon	つかみ金(氷・材木・石などの重い物をつかむ)|《複数形で》(また『climbing irons』)アイゼン|鉄かんじき
glaciology	氷河学
millpond	(水車用)貯水池|水車池
gullibility	だまされやすいこと
vasotec	エナラプリル
aeromedical	of or relating to aviation medicine
barmy	愚かな|少し気が変な(《米》balmy)
unclog	〜‘から'障害を除く|‘の'じゃまをなくす
aorist	a verb tense in some languages (classical Greek and Sanskrit) expressing action (especially past action) without indicating its completion or continuation
microtiter	マイクロタイター
butyric	relating to or producing butyric acid
oestradiol	エストラジオール
pressurize	加圧|加圧|加圧
ignoramus	無学な人
meningeal	relating to the meninges
melancholia	憂うつ病|憂鬱病
adz	手斧
molder	腐る|崩壊する(away)|朽ち衰える|型を作る人
pilothouse	(船の)操舵(そうだ)室
ramification	事態の波及|なりゆき
skitter	水面すれすれに飛ぶ|速やかに進む|流し釣りをする
incarcerate	幽閉する|監禁する|閉じ込める
maalox	an antacid
chenopodium	goosefoot; pigweed|goosefoot|pigweed
unrepresentative	not exemplifying a class; "I soon tumbled to the fact that my weekends were atypical"; "behavior quite unrepresentative (or atypical) of the profession"|not exemplifying a class
keratinocyte	ケラチノサイト|角質細胞|ケラチン生成細胞|角化細胞|ケラチン細胞
gynaecologist	婦人科医
mordant	辛らつな|皮肉な|刺すように鋭い|ヒリヒリする|色止め料|粘着剤|腐食剤で処理する
pinniped	アシカ亜目
computerize	コンピュータ化する
torturer	苦しめる人|拷問にかける人|拷問者
correlational	相関的
somnolence	傾眠(始終眠気を催す状態)
irreparably	in an irreparable manner or to an irreparable degree
fauntleroy	小公子
diagonalization	対角化
caplin	カラフトシシャモ
diatomic	(1分子中に)2原子の(を含む)
pharmacologist	薬理学者|薬物学者
romansh	ロマンシュ語
kittiwake	ミツユビカモメ(長い翼を持つ鳥)
vitalize	give life to; "The eggs are vitalized"|give life to|make more lively or vigorous; "The treatment at the spa vitalized the old man"|make more lively or vigorous
oddness	風変わり
dormouse	ヤマネ(リスに似たネズミで冬眠する)
smidgen	ほんの少し|ごくわずか(の量)|ごく少量|みじん|非常に小さなもの|非常に小柄な人
bunion	腱膜瘤(足の親指の内側にできるはれ物)
snobbish	俗物の
haymaker	干し草を作る人(機械)|《米話》強烈な一撃
anodyne	鎮痛薬
cultic	熱狂的な|狂信的な
intension	(精神の)緊張|努力|強度|激しさ|猛烈さ
geometer	フユシャク
wholemeal	全麦
merchantable	販売用の|売り物になる
dearie	deary|かわいい人|(ねえ)あなた|darling|dear
terrorise	恐怖で圧倒する|脅しつける|脅し付ける
nonlethal	not capable of causing death
comeuppance	当然の罰(報い)
unfailingly	without fail
disbar	〜‘の'弁護士の資格をはく奪する
centralise	集注|結集|結集する|集中
geum	ダイコンソウ属
wive	〜‘を'めとる|妻帯する
birdwatch	watch and study birds in their natural habitat
finny	漁の|魚がたくさんいる|ひれのような|ひれのある
fenland	渥地|沢|沼沢|沼|湫|沼池|湿地草原|湿原|沼地|沼沢地
hyperopia	遠視
xliv	being four more than forty
jazzercise	ジャザサイズ(ダンスのフィットネスプログラム)
ndebele	ヌデベレ
caff	informal British term for a cafe
ultramodern	超近代的な
conjectural	憶測上の
rumination	反芻|沈思|黙考
castanea	chestnuts; chinkapins|chestnuts|chinkapins
auscultation	聴診
burqa	ブルカ
cymbidium	シュンラン属|シンビジウム
hydrosphere	(地球の)水圏|(大気中の)水気
mho	シーメンス|モー|ジーメンス
raconteur	話しじょうず
ulmus	type genus of family Ulmaceae; deciduous trees having simple serrate leaves; widely distributed in temperate regions|type genus of family Ulmaceae|deciduous trees having simple serrate leaves|widely distributed in temperate regions
stopcock	コックのせん(turncock)
misogynist	女嫌いの人
spiff	きちんとした(気の利いた)ものにする|めかす(up)
pieta	ピエロ(キリストの遺体をひざにだいて嘆く聖母マリアの絵や像)
familiarisation	the experience of becoming familiar with something
idler	怠け者|なまけ者|役立たず
quintuple	5倍の|5重の;5部(5人)からなる|5倍|5倍の量(数)|5倍になる|〜‘を'5倍にする
shrubby	of or relating to or resembling a shrub
repetitively	in a repetitive manner; "this type of border display is used repetitively in advertising"|in a repetitive manner
castigate	厳しく罰する|きびしく非難する|添削する
compulsorily	強制的に|義務的に
packhorse	(荷物を運搬する)駄馬(だば)
drosera	毛氈苔
effusive	感情むき出しの
centaurea	knapweed; star thistle|knapweed|star thistle
sapsucker	シルスイキツツキ(くちばしで穴をあけ樹液を吸うキツツキ)
dutiable	(輸入品などが)関税を課せられる|有税の
cubical	=cubic1
supernumerary	規定数以上の|定員外の|(せりふのない)端役(人)
photosensitivity	放射線感受性|感光性
them	彼らを|彼女らを|それらを
tortfeasor	a party who has committed a tort
loden	ローデン(オーバーコートなどに用いる厚い防水布地)
biaxial	having two axes; "biaxial crystals"|having two axes
duplicitous	二枚舌の|不誠実な|いかさまの
lorre	ローレ
flintlock	(昔の銃の)火打ち石式発火装置|火打ち石銃
cissy	=sissy
catacomb	地下墓地
nyala	ニヤラ
atonal	(音楽)無調の|調子のない
ploidy	倍数性
teleplay	テレビドラマ
audiometer	聴力測定器
anteriorly	前方に
unpredictably	気まぐれに|意表を突いて
diachronic	史的|歴史的
cefotaxime	セフォタキシム
spendthrift	金使いの荒い人|金使いの荒い
dagan	god of agriculture and earth; counterpart of Phoenician Dagon|god of agriculture and earth|counterpart of Phoenician Dagon
dateless	終りのない|年代の分からない
standee	(劇場・汽車・バスなどで席がなく)立っている人
handwork	手製|手細工
pedicel	小花柄|小花梗(こう)(大きい花柄から分れて一つの花をつけている小さい花柄)|(昆虫や海洋生物の)柄|肉茎
poach	密猟する|他人の土地などに侵入する|(人の考えなどを)不正手段で盗む|(卵を)割って熱湯の中でゆでる|(魚などを)ゆでる
proscenium	プロセニアム|前舞台|幕の前部|前景
emotionless	unmoved by feeling; "he kept his emotionless objectivity and faith in the cause he served"; "this passionless girl was like an icicle in the sunshine"-Margaret Deland|unmoved by feeling
lashing	笞刑|鞭打ち|むち打ち
cephalosporin	セファロスポリン
muckraker	醜聞をあさる人|不正追及･摘発者
armyworm	ヨトウムシ(夜盗蛾の幼虫;農作物害虫)
polarize	対立する|二極間に分かれる|極性をもつ
cantabile	(演奏の指示で)カンタービレ|歌うような調子の(で)|カンタービレの曲
mollify	和らげる|軽減する
saami	ラップ|さあ美|左雨|ラップ|さあ美|左雨
thyroglobulin	サイログロブリン|チログロブリン
tablespoonful	(〜の)大さじ1杯[分](小さじ3杯分)《+of+名》
gasworks	ガス工場|ガス製造所
selflessly	無私
piroxicam	ピロキシカム
academical	=academic|《複数形で》大学の式服
valueless	価値のない|つまらない
imperceptibly	気付かれないほどに|いつのまにか
born	生まれつきの
phentolamine	フェントラミン
adobo	a dish of marinated vegetables and meat or fish; served with rice|a dish of marinated vegetables and meat or fish|served with rice
whish	ピュー(スー)という音|ピュー(スー)と鳴る(動く)
spirochete	スピロヘータ|らせん状の形態をしたグラム陰性の真正細菌の一グループ|(Spiro=らせん状の)
brilliancy	=brilliance
monoclinic	単斜
tike	tyke
terbinafine	テルビナフィン|ラミシール
traitorous	反逆的|裏切りの
sandlot	(一般の人が楽しむ)スポーツ用の砂地|スポーツの|アマチュアスポーツの
tetralogy	四徴 (病気の特徴を示す4種類の徴候)|四幕|オペラ|小説などの四幕構成
candour	単刀直入|直情|真率|虚心担懐|直|赤裸|剥き出し
mattock	根掘りぐわ(一種のつるはし)
unitard	レオタード
kerchief	ネッカチーフ(neckerchief)|ハンカチ(handkerchief)
matriculate	(試験の結果によって)〈人〉‘に'大学の入学を許す|(大学に)入学資格を得るための試験を受ける《+『at』(『in』)+『名』》
scorekeeper	(競技などの)公式記録員|スコアラー
carbonara	カルボナーラ
greenhorn	経験のない|初心者|だまされやすい人
highlife	《しばしばthe~》上流社会の生活|西アフリカの強烈なリズムの踊り
roadbed	(鉄道の)路盤;(道路の)路床
remunerative	引き合う|益になる
intricacy	複雑
pendulous	ぶら下がっている
moneymaking	金がもうかる|金もうけのできる|金もうけ
mourner	哀悼者|会葬者|ざんげ者
gastrectomy	胃切除術
inconsiderable	重要でない|取るに足りない|ささいな
bricklaying	れんが積み[の仕事]
statice	スターチス
sallow	(皮膚などが)黄ばんだ|血色の悪い|土色になる|(植物)サルヤナギ
polygamist	一夫多妻者|一妻多夫者
polytetrafluoroethylene	ポリテトラフルオロエチレン
ungreased	not lubricated
thiosulfate	チオ硫酸塩|チオ硫酸塩は自然に存在する化学物質で|「チオ」は硫酸イオンの酸素原子が硫黄原子で置換された「S₂O₃²⁻」 を含む塩を示す
sharecropper	小作人
ostentation	見せびらかし|見栄
tetrahymena	テトラヒメナ|水中に生息する繊毛虫で多数の繊毛で運動する|細胞核のうち大核には染色体の末端が多数あり|テロメア研究のモデルに用いられる
linguini	リングイーネ
stodgy	つまらない|重苦しい|不消化の
bookend	ブックエンド|本立て
shipowner	船主
affiant	宣誓人
wrathful	激怒した
vasoconstrictor	血管収縮薬
mefloquine	メフロキン(抗マラリア剤|内服する)
ascidian	minute sedentary marine invertebrate having a saclike body with siphons through which water enters and leaves
diddly	ジャック
clarinetist	a musician who plays the clarinet
oncidium	オンシジューム
glockenspiel	鉄琴|グロッケンシュピール
ghat	ガート|インド|ガンジス川下流のバラナシ市の川へ下る階段状の地形|沐浴する聖なる場所
intensional	used of the set of attributes that distinguish the referents of a given word
congregant	a member of a congregation (especially that of a church or synagogue)
cobia	large dark-striped tropical food and game fish related to remoras; found worldwide in coastal to open waters|large dark-striped tropical food and game fish related to remoras|found worldwide in coastal to open waters
isothiocyanate	イソチオシアネート
murre	ウミガラス
stickleback	トゲウオ(ひれにとげのある魚)
cockerel	(特に生後1年以内の)若いおんどり
pothead	マリファナ常用者
lopressor	メトプロロール
friendless	友のない
proboscis	(ゾウなどの)鼻|(昆虫などの)吻(ふん)|(口)(人間の)大きい鼻
wholehearted	心を込めた|心からの
bedsit	a furnished sitting room with sleeping accommodations (and some plumbing)
fitful	発作的な|変わりやすい
unstressed	(音声が)アクセントのない;強調されない
genii	genius|genieの複数形
unquestioning	疑わない;無条件の
aquatint	〈U〉アクアチント(食刻板画法の一種)|〈C〉アクアチント版画
desultory	気まぐれな|とりとめのない|散慢な|とびとびの|脱線的な
abstractor	one who makes abstracts or summarizes information
pitifully	哀れなほどに|くだらないほど
menacingly	in a menacing manner; "the voice at the other end of the line dropped menacingly"|in a menacing manner
ambiguously	茫然たる
withe	(柳などの)細枝(まきなどを束ねる材料)
seasickness	船酔い
disincline	嫌気をおこさせる
codicil	遺言書の補足条項;(一般に)補足
sonatina	ソナチネ
cefuroxime	セフロキシム
puerile	たわいもない|子供の(らしい)
pharmacopeia	定式|薬局方
editorially	社説で|編集者として
ambulation	walking about; "the hospital encouraged early ambulation"|walking about
improver	人道主義者|添|添加物|プラス|付けたし|付たり|増加|添え物|添えもの|添加|付加
worthlessness	甲斐無さ|味噌っかす|無価値|無用|味噌っ滓|味噌滓|詰まらなさ|みそっ滓|味噌かす|つまらなさ
vermicelli	バーミセリ(スパゲッティーに似たもっと細いめん類)
lubricator	滑らかにする人(もの);潤滑装置|注油器
equalise	同点にする|同点になる|匹敵|平均|対抗
westernize	make western in character; "The country was Westernized after it opened up"|make western in character
necrology	(一定期間内の)死亡者名簿;死亡告示
overconfidence	過信|確信
asclepias	genus of chiefly North American perennial herbs: silkweed; milkweed|genus of chiefly North American perennial herbs: silkweed|milkweed
stockyard	(市場などの)家畜置き場
tripos	(英国Cambridge大学の)卒業試験　（Cambridge大学で学位B.A.の）優等試験、優等試験合格者名簿
misspend	使い方を誤る
bagasse	バガス
palaver	おしゃべり|むだ話
balalaika	バラライカ(ギターに似た3弦のロシアの楽器)
ductless	not having a duct; "ductless glands"|not having a duct
antiaircraft	対空の|防空の
payslip	a slip of paper included with your pay that records how much money you have earned and how much tax or insurance etc. has been taken out
drydock	乾ドック
unvarnished	塗装してない|生地のままの
jotter	書き留める人|メモする人|小さな手帳
baldrick	a wide (ornamented) belt worn over the right shoulder to support a sword or bugle by the left hip
ziti	ジーティ
nonsuch	模範|手本|高徳の人|理想像|鏡鑑|理想|聖人|比類のない人|鑑|亀鑑
personify	を擬人化する|体現する|擬人化する|具体化する
clingy	粘着性の|くっついて離れない
blusher	頬紅|頬べに|チークルージュ|ルージュ|頬紅|紅
sidearm	横手投げの|横手投げで
piddle	(口語)(子供|動物が)おしっこをする|ダラダラ時を過ごす|食べ物をいやいや食べる
dysphoric	不幸せ|憂い|不幸|悲しい|不仕合わせ|不仕合せ