plotz	(俗)驚く|カッとなる|頭に血が上る|驚いて卒倒する
plunderer	略奪者
freeload	(飲食物などを)人にたかる
abecedarian	初心者|初学者
skywriting	(飛行機が空中に煙で描く)空中文字;〈U〉空中広告
parting	分かれの|別離|別れ(の)|分離(する)|分割
racialist	=racist
comfortless	慰安のない|わびしい|慰められない|悲しみを抱いたままの
argillaceous	粘土の|粘土質の
wordiness	口数の多いこと
bleakly	荒涼として|冷たく|暗く|わびしく
incautious	不注意な|軽率な;無謀な
luxuriance	繁茂|豊富
barnstormer	地方を遊説する人|どさ回り|旅役者
impanel	=empanel
hornbook	読み方自習帳|入門書
strophe	(自由詩の)節|連|(古代ギリシア悲劇で)舞踊隊が右手から左手に移動するときに歌う合唱歌
exclave	飛び領土(他国の領土に取り囲まれ|本土から離れている領土)
creditably	みごとに
impressiveness	印象的であること|感銘深さ
equivocate	言葉を濁す|あいまいな言葉を使う
presumable	仮定(推定)できる|ありそうな(probable)
overindulge	〈人〉‘を'甘やかし過ぎる|〜‘に'耽溺(たんでき)する|わがままにし過ぎる
coonskin	〈U〉アライグマの毛皮|〈C〉アライグマの毛皮製品
breezily	そよ風が吹いて|さわやかに
sculptress	女流彫刻家
superabundance	(物・愛情などの)過多|過剰《+『of』+『名』》
showery	にわか雨の多い
implacably	なだめがたく|執念ぶかく|容赦せずに
telophase	telophase (細胞分裂)終期|分裂終期
commensurable	=commensurate|同一規準で比べられる;(〜と)同じ規準の《+『with』(『to』)+『名』》
planetology	惑星学
unceremonious	不作法な|ぶしつけな|儀式(形式)ばらない
sidewise	=sideways
gymnosperm	裸子植物
compeer	(階級・能力などが)同等な人|仲間|同僚
gammer	老婆
creepily	はい回って|のろのろと|ぞくぞくして|身震いして
cowhand	=cowboy
fumigate	(殺虫・殺菌のために)〜‘を'いぶす|いぶしい消毒する
titleholder	選手権保持者(チーム)
prig	堅苦しい人
commutable	交換できる|取り替えられる
passably	まずまず;かなりよく
vituperation	厳しく避難すること|ののしり
lummox	無器用者|のろま|でくのぼう
littermate	同腹子|同腹きょうだい
lineament	顔だち|人相|特徴
whitewall	(自動車で)側面の白いタイヤ
allopathy	逆症療法(治療中の症状とは異なる症状を起こす薬剤を用いる治療法)
bodiless	体のない;無形の|実体のない
topflight	抜群に優れた|第一級(一流)の・最高の
hiccough	=hiccup
suspensive	未決定の;不確かな|不安な|中止する|停止の
isinglass	にべ(魚の浮き袋から取ったゼリー)|雲母(うんも)
decidual	脱落膜|(decidual cell脱落膜細胞)
bailable	保釈を許される
septuagenarian	70歳[代]の人|70歳[代]の
uncouple	〈連結したもの〉‘を'離す
promptitude	敏速|機敏
banquette	バンケット|乗客席|棚|壁際の長椅子|歩道
pronounceable	発音できる|断言できる
roentgenology	『X』線学|レントゲン学
jinni	=genie
sideslip	(車・スキーなどが)横すべりする|横すべり|横転
tiddlywinks	《単数扱い》小円盤の縁を他の円盤で押しはじいて飛ばせ|カップの中に入れるゲーム
distressful	(精神的・肉体的に)苦しみを引き起こす;苦しそうな
clanger	へま|ぽか|大失策
mimus	マネシツグミ (鳥の名 =mockingbird)
monocotyledon	単子葉植物
pennyweight	ペニーウェート(英国の貴金属の重量単位;24グレイン|1|20オンス(約1.42gr.)《略》『dwt.』)
disputant	論争者|討論者
colocalize	共存する
prestidigitation	手品|奇術
plutocrat	金権政治家|富豪
foremast	前檣(ぜんしょう)
irruption	(突然の)侵入|突入
chilblain	しもやけ|凍傷(frostbite)
felicitate	(〜で)〈人〉‘を'祝う《+『名』+『on』(『upon)』+『名』》
stupefaction	感覚(知覚)を麻痺させること|正気を失った状態|仰天|ぼう然自失
lazybones	怠け者|無精者
mudpuppy	サンショウウオ(北米産)
catkin	尾状花(カワヤナギ・カバノキなどの花)
dewclaw	狼(おおかみ)つめ(犬の足の上指)|(鹿・豚などの)にせけづめ
recitalist	独演家|独奏家|独唱家|暗唱者|朗読者
extempore	準備なしの|即席の|準備なしで|即興に
viscid	(液体が)ねばねばする|粘着性の
bidding	入札|せり|値ざし
penname	ペンネーム|筆名|雅号
pessary	ペッサリー(避妊用子宮せん);腟(ちつ)挿入座薬
hardpan	硬い地盤|岩床
abaft	船尾に(へ)|〜より船尾に
simpleminded	お人よしの|だまされやすい|愚かな;精神薄弱の
miniprep	ミニプレップ|プラスミド(plasmid)のDNAを細胞から分離させること
skivvy	〈女性が〉家庭内の雑事をする
habituate	(〜に)〈人〉‘を'慣らす《+『名』+『to』+『名』(do『ing』)》
capitulum	小頭(長い骨や触角などの先端のふくらんだ部分)
bilabial	両唇(しん)音([b]|[m]|[p]など両唇で発音されるもの)|両唇で発音される
accelerando	(音楽の指示で)しだいに速く(速い)
pestilential	悪疫(腺ペスト)の;悪疫をもたらす|有害な;破壊的な|《話》やっかいな|うるさい
concision	簡潔
disbeliever	(言葉や人を)信用しない人;信仰しない人
emblazon	(紋章などで)〜‘を'飾る|〜‘を'ほめそやす
circumlocution	まわりくどさ|婉曲な言い方|言い抜け|遠回し
queenly	『女王の』;『女王のような』;女王にふさわしい
superficies	表面|外面;外観|体裁
preppie	プレッピー|私立学校の生徒|私立学校の生徒風の|金持ちそうな
coequal	(地位・能力・権力などが)同等の人|同等の|同格の;(〜と)同等の《+『with』+『名』》
suzerain	(封建時代の)領主|宗主国(他国の外交に対して支配権を持つが|内政は許す)
ideogram	表意文字
connive	黙視する|共謀する|黙認する
exegete	(特に)聖書解釈学者
unchaste	身持ちの悪い|不貞な|ふしだらな
exculpate	無罪にする|の無罪を証明する|の無実の罪を晴らす
broadways	横に|横向きに
indispensability	欠くことのできないこと|必要不可欠
confounder	交絡因子|(統計モデルの中の従属変数と独立変数の両方に相関する外部変数)
juiciness	汁の多いこと|水分の多いこと
pliability	(物の)柔軟さ|(性質・性格の)柔軟さ|柔順
schoolchild	学童
blastoff	(ロケット・ミサイルなどの)打ち上げ(lift-off)
entablature	(ギリシア・ローマ建築の)エンタブラチュア(柱頭の上に載っている水平部分)
adjure	《文》〈人〉‘に'厳命する|請願する;(〜するよう)〈人〉‘に'厳命する《+『名』+『to』 do》
videlicet	すなわち({略}viz.)
insouciant	のんきな|むとんじゃくな
obstreperous	騒々しい;手に負えない
potshot	手当たり次第の射撃
espalier	果樹だな(格子)(果樹などをからませる)
hereditament	(法律で)相続(世襲)財産(特に不動産)
counterfeiter	にせ金造り;偽作者
unlikelihood	ありそうもないこと|見込みのないこと
navvy	土木労働者|土方|土工
counterstained	対比染色
houseful	(〜の)家いっぱい[の量|数]《+『of』+『名』》
pennywort	イワレンゲの一種;小さな丸い葉をもった植物
phrasing	言葉遣い
tossup	〈C〉《単数形で》(表裏どちらかが出るか)硬貨をほうり上げること|〈U〉《しばしばa ~》《話》五分五分の見込み
tutelary	(人・物の)保護者(後見人)の地位いある|保護(後見)の
hindmost	いちばん後ろの|最後部の
drycleaner	(また『dry cleaner's』)ドライクリーニング屋(店)|ドライクリーニング屋の職人|ドライクリーニング用剤(ベンジンなど)
monkish	修道僧の|坊さんくさい|修道院じみた
turbaned	ターバンを巻いた
romanticist	(文学・絵画・音楽などの)ロマン主義者
joggle	〜‘を'軽くゆすぶる|揺れる|軽い揺れ(揺さぶり)|振動
bedroll	(戸外用の)携帯用寝具|寝袋
prorogue	〈議会〉‘を'停会にする
zaftig	(米俗)(女性が)ふくよかな体をした|性的魅力のある
aquavit	=akvavit
watering	散水|潅水|撒水
discontentment	=discontent
telephonist	電話技師;電話交換手
pyrexia	発熱;熱病
shamble	よろよろ歩く|よろめき
idiotically	ばかげたことに|愚かにも
electroporated	エレクトロポレーション(電気穿孔)された|－の
lawbreaking	法律を破ること|法律違反の
antipoverty	貧困救済(絶滅)を目指す
ambulate	歩き(動き)まわる
flageolet	フラジョレット(小型の縦笛式木管楽器)
picnicker	ピクニックする人|行楽者
misfile	〈書類など〉‘を'誤ってとじる
xebec	3本マストの小型帆船(昔|地中海で海賊が使用した)
heartiness	元気よさ|熱心
carryon	(手荷物が)機内に持ち込める|機内持込み手荷物
gyrfalcon	シロハヤブサ(北極圏に住む大タカ)
backdate	(〜にまで)〜‘の'日付をさかのぼる《+『名』+『to』+『名』》
sulkily	ふくれて|すねて
philanderer	恋愛遊戯にふける男|女たらし
ceriodaphnia	ミジンコの種類
interferer	干渉者|妨害者
recoilless	はね返りのない
impecunious	無一文の(penniless)|貧乏な
vaudevillian	寄席芸人|形演劇俳優|寄席演芸の
perspicacious	(人が)鋭い観察力(判断力)のある|理解力のある;(判断などが)先見の明のある|明敏な
geminate	〜‘を'二重にする|対(つい)にする|二重になる|対になる
snaky	蛇の;蛇のような;うねうねした|蛇の多い|蛇がよく出る|ずるい|陰険な|邪悪な
knothole	節穴(ふしあな)
bathos	(béɪθɑs)|急落法|漸降法(荘重な調子を急にこっけいに落とすもの)|ふまじめな|わざとらしい感傷
confessedly	自白によると|本人の認めるように
cabdriver	タクシー運転手
undermentioned	下記の|後述の
beechnut	ブナの実(食用油・調味料などをとる)
seism	地震
bootlick	‘に'おべっかを使う|追従(ついしょう)する|おべっかを使う|追従する
retroflex	そり返った|反転音の(舌先を上にそらせ発音する)
controvert	〜‘に'反論する|論ばくする
eyetooth	犬歯|糸切り歯
mainmast	(帆船の)大檣(しょう)|メーンマスト
disquisition	(長いまたは長ったらしい)論文|論考
preganglionic	神経節前の
tartly	厳しく|辛らつに
loganberry	ローガンベリー(木いちごの一種)
mossback	頭の古い人|こちこちの保守派
tenebrous	(また tenebrious)|暗い|陰気な
recrudescence	(病気･犯罪などの)再発|ぶり返し|再燃
greasepaint	ドーラン|(俳優の用いる)化粧用塗油
grunion	イワシ科の食用魚
cofferdam	防水せき
unexceptionable	非の打ちどころがない|申し分のない
knobbly	=knobby
offish	よそよそしい
babyish	赤ん坊じみた
bucketful	バケツ1杯(の〜)《+『of』+『名』》
arteriole	小動脈
inhumanly	不人情に|冷酷に
respire	呼吸する
crosspiece	横材|横木|桟(さん)
fuddle	(ウイスキーなどで)〈人|人の意識〉‘を'もうろうとさせる|意識がもうろうとすること|思考の混乱
dentifrice	歯みがき粉|練り歯みがき(toothpaste)
stentorian	大声の
fortifier	築城家|強化する人(物);強化剤
deliveryman	(客の購入品・注文品の)配達員
foible	弱点|短所|欠点
reasonability	道理にかなっていること|正当性|妥当性
airmobile	(ヘリコプターを装備した)空挺部隊の
pitchman	大道商人
quadripartite	4部から成る|四者間の
whaleboat	(オールでこぐ)海難救助船[もと捕鯨船だった]
hydrostatics	静水学|流体静力学
questioning	探求的な|詮索好きの|尋問|取り調べ|不審尋問|疑わしげな
sportsmanlike	スポーツマンらしい|公明正大な
joyfulness	うれしさ
aerofoil	=airfoil
thereabout	その近くで(に)|そのころ|およそ～ほど
polysyllabic	(単語が)多音節の|多音節語を特徴とする
cohesin	コヒーシン|姉妹染色分体の接着(複製された染色体を娘細胞に均等に分離する過程|sister chromatid cohesion)に主要な役割を果たすタンパク質複合体
fratricidal	兄弟･姉妹殺しの|相争う
decipherable	判読できる|解読できる
coquetry	〈U〉(女が男に)こびを売ること|〈C〉こび|しな|なまめかしさ
baldric	(昔の)飾り帯(剣・角笛などをつるすために肩から腰へ掛ける皮帯)
intein	DNAのスプライシング(splicing|転写)の際|タンパク質分子で自動的に切除された部分をインテインといい|残った部分(エクステイン)がペプチド結合で再結合される
ropy	ひどい[状態の]
cursorily	苦労することなく|ざっと|＜cursory(急ぎの|ざっと)
antineutrino	反中性微子
wifely	妻らしい|妻にふさわしい
quibbler	言い逃れる人
pusillanimous	気の弱い|臆病な
amus	愛|愛する|好き
formidably	恐ろしく;手ごわく;非常に
pianola	ピアノラ(自動ピアノの一種;商標名)
effulgent	さん然と輝く|光り輝く|まばゆいばかりの
eiderdown	〈U〉ケワタガモの綿毛|〈C〉(その綿毛を詰めた)羽根ぶとん
odoriferous	かんばしい|かぐわしい
slipperiness	滑りやすいこと;(滑って)つかみにくいこと
butterfingers	よく物を手から落とす人　下手な野球選手|無器用な人
paperhanger	壁紙張り職人
quadruplicate	四部複写
insensate	感覚(生命)のない|感受性(思いやり)のない|無情な;(〜に)感受性がない《+to+名》|理性を欠いた
osculate	接吻(キス)する|〜‘に'接吻(キス)する
causeless	原因のない;理由のない|いわれのない
drollery	〈U〉おどけ|こっけいさ|〈C〉おどけた動作|冗談
croquette	コロッケ
animalism	獣性;獣欲主義|人間動物説(人間の霊性を否定する説)
manhandle	人力で動かす(運転する)|手荒く扱う|虐待する
gravamen	告訴の主要点|苦情|不満|陳情書|不平
shebeen	もぐり酒屋;安酒場
preovulatory	排卵前の
moquette	モケット(じゅうたんや家具のおおいを作る厚い毛織物)
unprecedentedly	先例なく|前代未聞に|前例のないほどに
sententious	《今はまれ》(表現が)簡潔な(pithy)|(文体などが)説教調の|もったいぶった|金言(警句)の多い
switchman	(鉄道の)転轍(てんてつ)手(《英》pointsman)　ポインツマン　ポイントマン
remediable	治療できる|取り返しのきく|救済できる
embalm	香気を満たす|(死体に)防腐処理する
philatelist	切手収集家|切手研究家
cosiness	=coziness
vacuolation	(生命科学)空胞形成|液胞化|空胞化|胞化
tallboy	=highboy
messily	取り散らかして|ごたごたと
descry	〈遠くのもの・はっきりしないもの〉‘を'目を凝らして認める(進行形にできない)
inseparability	分離できないこと|不可分
complaisance	人を喜ばそうとする気持ち;愛想のよさ
imponderable	計れない|評価できない|(熱・光などの)不可量物
cilium	『cilia』の単数形
exclamatory	感嘆の
drayman	荷馬車屋
elfish	小妖精のような;いたずらっぽい
dogtooth	犬歯|糸切り歯
truckle	(〜に)ぺこぺこする《+to+名》
axotomy	軸索切断(外傷などにより神経細胞の軸索が切断されること)
gabble	訳の分からないことを早口にしゃべる《+『away』(『on』)》|〈言い訳など〉‘を'訳が分からないほど早口で言う《+『out』+『名|』+『名』+『out』》|早口で訳の分からないおしゃべり
absentminded	放心した|ぼんやりしている|忘れっぽい
smokiness	煙だらけ
tyrannous	暴君のような;暴虐の|残酷な
swarf	(金属やプラスチックなどの)削りくず
sacking	解任|解雇|首にすること|かばんや袋に使用される硬い布地
slanderer	中傷者|悪口を言う人
admix	(〜と)〜'を'混合する《+『名』+『with』+『名』》|混合する|まざる(mix)
monosyllable	単音節語
sluggard	怠け者|無精者
choirboy	少年聖歌隊員|純真でうぶな少年|まじめな新米警官
conniption	ヒステリーの発作|かんしゃく
marrowbone	(だしを取る料理用の)髄骨
grandiloquent	(話し方・文章が)ぎょうぎょうしい|大げさな
timeworn	年月を経て古びた;使い古した|陳腐な|ありふれた
participial	分詞の
bogg	排水不良な湿原|沼地
centavo	センタボ(スペイン語・ポルトガル語を話す国の硬貨;1|100ペソ)
homophone	異形同音異義語
threadlike	糸のような|細長い|ほっそりした
unessential	本質的(重要)でない|本質的(重要)でないもの
earthward	地球(地面)に向かう|地球(地面)に向かって
diplomatist	外交的手腕のある人|《まれ》=diplomat
emancipator	解放者
toothsome	(食物が)うまい|おいしい
barefaced	素顔の|公然の|恥知らずな
doorpost	=doorjamb
calk	=caulk
editorialist	論説委員
loutish	ぶこつな|無作法な
ashcan	《米》(金属製の)灰入れ|ごみ入れ
biculturalism	(同一国内に)二文化の共存
bleb	(小さな)水ばれ|水疱(大きいのはblister)|(水|ガラスの中の)泡|気泡
pryer	=prier
cornball	=corny
subcapsular	被膜下の
refashion	形直しする|改造(改装)する
unisexual	(動植物が)単位の|雌雄いずれかの器官しかない
ofttimes	=often =oftentimes
steersman	舵手(だしゅ)|かじとり|(自動車などの)運転手
caitiff	《古》卑劣な人|卑怯者
tuneless	調子はずれの|音楽的でない|(楽器が)音の出ない
scoria	〈U〉鉱滓(こうさい)|かなくそ|〈U〉〈C〉岩滓(噴石状の溶岩)
diametric	=diametrical
extortionist	=extortioner
overvalue	過大評価|過大評価する|買いかぶる
demodulate	(無線で)〈電波〉‘を'検波する|復調する
raceme	総状花序(フジ・スズランなどのふさ状の花のつき方)
aspersion	中傷
rudiment	《the rudiments》(〜の)初歩|基本|原理《+『of』+『名』》|《the rudiments》(〜の)きざし|芽ばえ|初期《+『of』+『名』》|〈C〉(生物の)痕跡器官|退化器官
embroil	(紛争など)に巻き込まれる|巻込む|混乱させる
hartal	(インド・パキスタンで)同盟閉店|同盟休業|ストライキ
pennon	槍旗(三角形または燕尾(えんび)形で騎士が槍につけた)|(一般に)旗
athirst	(〜を)渇望して(eager)《+『for』+『名』》|《おもに詩》のどがかわいて(thirsty)
debilitate	〈病気などが〉〈人・体〉'を'衰弱させる
nimbleness	すばやさ|敏しょう
tickertape	株式相場表示機(ticker)から刻々出てくるテープ
soapsuds	=suds 1
disarrange	〜‘を'乱す|混乱させる
rancidity	いやなにおい(味)のすること|いやなにおい|悪臭;いやな味
downregulate	下方制御する|減少させる|ダウンレギュレートする
anchorite	隠者|世捨て人|隠世者(hermit)
upshift	(自動車の)ギアを高速伝動に入れる|ギアを高速伝動に入れること　シフトアップ　シフトアップする
spitball	紙つぶて|スピットボール(野球でボールにつばをつけて投げる変化球;現在は反則)
middleclass	中流階級|中産階級|中流階級の|中産階級の
abeam	(海事用語で)(〜の)真横に《+『of』+『名』》
prosecutable	起訴(告訴)される[べき]
miry	泥だらけの;泥沼の
bureaucratically	官僚的に
fanlight	(ドアや窓の上にある)小窓|扇窓|《英》=transom
semiprivate	(病室など2|3人で共有の)準個室の|半私用の
clepsydra	水時計
highflying	高く飛ぶ|野心的な
abasic	脱塩基
belligerency	=belligerence
hospitalize	入院させる
eponym	名祖|名前の由来となった名|冠名
teletubby	テレタビーズ|イギリスのBBCで1997年から放送され|120カ国以上の国で視聴されている幼児向けテレビ番組
dipswitch	ディップスウィッチ(車のヘッドライトの光を下方の下げる装置)
backpedal	逆にこぐ|(ボクサーが)さっと引く|態度を翻す
cloy	あきあきさせる|満腹させる|飽きあきさせる
arteriosclerotic	動脈硬化[症]の
rainproof	防水の
phantasmal	《おもに文》幻の|空想の
vaunt	自慢|誇示する
greatcoat	(厚地で重い)外とう
subclone	サブクローン(生化学)|あるベクター(媒介者)でクローン化したDNA断片を他のベクターへ移すこと
unmeaning	無意味な|くだらない・(顔・表情などが)うつろな
hairnet	ヘアネット
untrodden	踏まれていない|前人未踏の
nerveless	勇気のない|意気地のない|力のない(weak)|冷静な|落ち着いた(calm)|神経のない;葉脈(翅脈)のない
zonked	酔った|うっとりした
regnant	君臨する|支配している
lunate	三日月形の
frump	(特にオールドミスなど)流行遅れの服装をしている女性
tuque	トーク(カナダで冬用に用いる毛糸の筒形の帽子)
gaberdine	〈C〉(中世に特にユダヤ人が着用した)ゆるやかな長い男物の上着|=gabardine
quondam	元の|以前の
proem	序文|緒言
raillery	(悪意のない)ひやかし|からかい
hyperthermic	温熱
accordant	《補語にのみ用いて》(〜と)一致した|合致した《+『with』(『to』)+『名』》
breakfront	(飾りだんす・本箱などが)前面の中央部がせり出している|前面中央部がせり出した飾りだんす(本箱)
potage	ポタージュ(濃いスープ)
lawbreaker	法律違反者
pleasurably	楽しく|愉快に
episodically	挿話的に
traumatize	に外傷を負わせる|を傷つける|に損傷を与える|に精神的ショックを与える|に心の痛手を負わせる
washtub	洗濯だらい|洗濯おけ
extenuation	(罪などの)情状酌量
colonnaded	列柱のある
dumbwaiter	(レストランなどで調理場から階上へ料理を運ぶ)小型エレベーター(《英》food lift)|《おもに英》移動式食品台
contumacious	反抗的な|がんとして命令をきかない
extrusive	突き出す|押し出す|(岩石が火山から)噴出する
loftily	高々と|高尚に|高慢に
pilau	=pilaf
congruous	=congruent
carpus	手首|手首の骨
placidity	平静|平穏
tenterhook	(張りわくの)くぎ
sternwheeler	外輪船(船尾の外輪で推進する)
spiracle	(こん虫の)気門|気孔;(鯨の)噴水孔
enterocyte	腸細胞
hotheaded	向こう見ずの|せっかちな|怒りっぽい
sulfo	スルホ|硫黄(いおう)の意|スルホ基
offhandedly	ぶっきらぼうに|即座に|無造作に
underdone	(食べ物が)生煮えの;(肉が)生焼けの
matchlock	火縄銃
geniality	温情|親切で愛想のよいこと
lockstitch	(ミシンの)二重縫い
diaphoretic	発汗させる|発汗性の|発汗剤
castigation	厳しい非難|難色
stutterer	どもる人|口ごもる人
cycloid	円形の
flippancy	軽薄|軽薄な言葉(行為)
breastwork	胸閉(胸の高さまで築き上げた防壁)
pellucid	(ガラス・流れなどが)透明な|澄んだ|(表現・文体が)明りょうな|明白な
homoeroticism	同性愛
undernourishment	栄養不足(不良)
harebrained	(人・計画などが)気まぐれな|軽率な|向こう見ずな
bioethicist	生命倫理学者
zealousness	熱心|熱狂
oafish	愚かな;ぶざまな
foreknow	〜‘を'予知する|前もって知る
prodigality	浪費|放蕩|(いくら使っても尽きないほど)たくさんあること
positiveness	明白さ|確実性;確信
euchromatic	(遺伝学)真正染色質の
incommunicable	伝達できない|話せない
freshet	(降雨・雪解けのための)出水|(海に注ぐ)淡水の流れ
deflower	〜‘の'花をもぎ取る|〈処女〉'を'犯す
canvasser	(選挙などの)運動員|(販売などの)勧誘員
livelong	長々しい
scarify	(種痘などで)〈皮膚〉‘を'乱切する|乱刺する|《文》〜‘を'酷評する|こきおろす|〈土〉‘を'かき起こす
heavyset	やや太めの|がっしりした
educationist	=educator
salesgirl	女店員
rubberstamp	ゴム印|《話》めくら判を押す人
tactual	触覚の
wordbook	単語集;辞書|(歌劇・歌曲の)歌詞集
opprobrious	(行為が)不名誉な|(言葉が)侮べつ的な|口ぎたない
proprietress	女性の経営者(所有者)
precipitant	まっさかさまに落ちる|大急ぎの|まっしぐらの
propitiatory	和解の|なだめる;きげん取りの
imbecilic	=imbecile
prizefighter	職業挙闘選手|プロボクサー
drearily	わびしく;気をめいらせて|退屈させて
inseminate	〈思想など〉‘を'吹き込む
telegenic	テレビ映りのよい|テレビ向きの|テレビうつりのよい
mistime	〜‘の'時機を誤る|(スポーツで)〈ボールなど〉‘を'打ち損なう
snowbank	雪の吹きだまり
contretemps	あいにくなできごと|意外な事故
inexpert	しろうとの;未熟な
sissified	=sissy
underplay	控えめな演技をする
machination	陰謀|たくらみ|策謀
transmogrify	(魔法のように)姿･性格を一変させる
snorer	いびきをかく人
hogtie	〈動物〉‘の'四つ足をいっしょに縛る|〈人〉‘の'手足をいっしょに縛る|《話》〜‘を'じゃまする|妨害する
immunoprecipitate	免疫沈降物
suicidology	自殺[医]学(自殺とその予防の研究)
oldster	老人|年配者
bloodmobile	移動採血車
straggly	落伍した
wolfsbane	トリカブト(キンポウゲ科の黄色の花をつける背の高い植物) = wolf's bane
peckish	腹のすいた
superscription	手紙などのあて名|上書き|表題|銘
sough	風がヒューヒュー鳴る||風がヒューヒュー鳴る音
entrepot	貨物の集散地|中央市場|倉庫
butterbean	アオイマメ|五色豆(米国南部産の種子の小さいライマメの変種)
housetrained	=housebroken|《おどけて》(人が)行儀のよい|きちんとした
khedive	(1867‐1914年にかけてトルコ政府派遣の)エジプト総督
pabulum	(珍しい)食物|栄養物|心を豊かにする糧(かて)
swineherd	(昔の物語で)豚飼い|養豚者
tessellate	〈床・舗道など〉‘を'モザイク模様にする;碁盤目状にする
unparliamentary	議院内の慣行に反する|議院内であるまじき言動をとる
disinter	(墓地から)〜‘を'掘り出す|発掘する
benumb	〜‘の'感覚を失わせる|'を'麻痺させる
carouse	痛飲する|飲み騒ぐ|飲みほす
muggins	ばか|まぬけ
cosmically	宇宙の原理に従って;広大無辺に
scilicet	すなわち|換言すれば
traduce	《文》〈人・性格など〉‘を'非難する|中傷する
adulterant	(品質を落とす)混ぜ物|混ぜ物をする
stickpin	スティックピン(ネクタイや飾りどめに使うピン;《米》tiepin)
repine	(〜に)不満足である|不平を言う|じれる《+『against』(『as』)+『名』》
biolab	バイオラボ|バイオ研究室
affricate	破擦音
drowsily	うとうとと|眠そうに
blowpipe	(俗)吹矢筒|トーチ|ライフル銃
mellowness	芳醇(ほうじゅん)|甘美;円熟|成熟
multiplicand	被乗数
plastron	プラストロン(フェンシング用の胸当て)
draughty	=drafty
gaoler	=jailer
sanctimony	殊勝らしく見せること|信心ぶること
microdissected	顕微解剖された
pamphleteer	パンフレットの著者(発行者)
onrush	突進;奔流
shirttail	ワイシャツのすそ(腰より下の部分)
oldish	いくぶん年をとった|やや年配の|古めかしい
acquaintanceship	=acquaintance 2
declamatory	大げさな|誇大な
elate	《受動態で》〜‘を'元気をつける|意気を高揚させる
oleaginous	油を含む|油からなる|油っぽい|油まみれの
catalepsy	強梗症(感覚喪失・硬直などのヒステリー症状)
reforest	〈森〉‘に'再び植林する|再植林する
appall	をぞっとさせる
paratroops	落下傘部隊
debone	〈鶏・あひるなどの肉〉から骨を取る
editorialize	意見を述べる|私見を交える|社説で論じる|編集者の意見を入れる
wicked	悪い|いたずらな|とてもひどい
loadstone	=lodestone
condemnable	非難すべき|とがめるべき
bromophenol	Bromophenol blueブロモフェノールブルー|pHが3|0から4|6の間で用いられる酸塩基指示薬|pHが3|0のときは黄色で|6では紫色となる
castellated	(銃眼つき胸壁のある)城造りの|城構えの
churchgoer	(きちんと･熱心に)教会に通う人
effluvium	臭気|悪臭
mispronunciation	発音の誤り|誤った発音
bestir	〈わが身〉'を'奮起させる
swearer	宣誓者|ののしる者
inapt	不適当な|適切でない;(〜に)適さない《+『for』+『名』》|《補語にのみ用いて》(〜が)へたな|不手際な《+『at』(『in』)+『名』》
bacteria	バクテリア
ninon	ニノン織り(軽いドレス用絹布)・薄絹
schoolmistress	女教師|女校長
surmountable	(困難・障害などが)克服できる;乗り越えられる
obloquy	(特に大勢の人から)非難|悪口|(非難・悪口で受けた)不名誉|汚名
cutpoint	カットポイント
profitless	もうからなし|利益の上がらない|むだな|無益な
bezique	ベジーク(2人以上で64枚のカードを用いて行うカードゲーム)
coryza	鼻カタル|鼻かぜ
anesthetize	麻酔する
acidify	酸性にする
confrere	(仏語)会員|同僚
lechery	好色
moralize	道徳を論じる
abstemious	(飲食物・享楽を)慎む|節制する;(食事が)節約した
rubdown	マッサージ
characterless	特徴のない|平凡な
cannonade	連続砲撃
fetlock	(馬の)けづめ毛|けづめの突起;球節(ひづめ上部の関節)
clannish	氏族の|一族の|党派的な|同族で固まった|排他的な
palmate	(葉などが)手のひらの形をした
alienable	(法律上所有権を)譲渡できる
scofflaw	法律をばかにする人|違反常習者
bellyache	《話》腹痛|ぶつぶつ不平を言う
preaching	説教
complaisant	愛想のよい|いんぎんな
votary	《文》(思想・主義などの)追求者|支持者|研究者|(特定の神・宗教の)信奉者|信者
doeskin	雌ジカの皮;雌ジカのなめし皮|ドスキン(ラシャ織りのウール地)
shoddily	安っぽく|見かけ倒しに
flossy	けばのような;軽くふわふわした
hoaxer	悪ふざけをする人
biconvex	(レンズなどが)両凸(とつ)の
capillarity	毛細管現象|毛状|毛管状
manageress	《おもに英》(商店やレストランなどの)女性経営者(支配人)
brochette	(料理用の)小ぐし|焼きぐし
waviness	波立ち|波形
rattrap	ネズミ取り[器]|うらぶれた汚い場所
percipient	知覚力(洞察力)のある
chilliness	冷気;寒け
inharmonious	(音が)不調和の|不協和の|感情(気持ち)が合わない|しっくりしない
ideologist	観念論者;空想家
amatory	恋愛の;好色な
corncob	(また『cob』)とうもろこしの穂軸|(また『corncob pipe』)コーンパイプ(火皿がとうもろこしのしんでできている)
eclogue	田園詩|牧歌(対話形式の短詩)
antinomy	二律背反(二つの命題が互いに矛盾すること)
plateful	(食物の)皿1杯分|1皿分《+『of』+『名』》
raffish	(人･行動･風采など)慣習にとらわれない|ルースで奔放な|低俗な
knavery	ごまかし|悪党根性|ふらちな行ない|不正行為
hairiness	毛深さ
impersonally	個人的でなく|個人的感情なしで
militiaman	民兵
vortexed	ボルテックス|渦を巻いた
woebegone	憂いに満ちた|悲しみに沈んだ
ritualist	儀式主義者
sybarite	ぜいたく(快楽)にふける人|快楽主義者
unconscionably	非良心的に|不謹慎にも|不当に|不合理に
horselaugh	(無礼な)高笑い
premonitory	(不吉な)前触れとなる|警告的な
altruistically	利他的に
tangibility	触知できること;明白|確実
irresolution	不決断|優柔不断
denotative	表示的な|指示的な(〜を)表示する《+『of』+『名』》|(論理学で)外延の
noncooperation	協力しないこと;(政府に対する)非協力
submicroscopic	(顕微鏡では見えないほど)極微小の
excoriate	の皮膚をすりむく|の表皮をむく|激しく非難する
shirtsleeve	ワイシャツのそで
hemophiliac	血友病患者(の)
algebraist	代数学者
jewelweed	(北米産の)ツリフネソウ
preponderate	(数量・勢力・重要性などにおいて)(〜より)優位を占める《+『over』+『名』》
analogize	類推する|(〜と)類似している《+『with』(『to』)+『名』》|〜'を'類推する
frenetically	逆上して;熱狂的に
benignant	(特に目下の人に)優しい|親切な|ためになる|有益な
garishly	派手に|けばけばしく
cockscomb	(おんどりの)とさか|(また『coxcomb』)《文》(道化師の)とんがり帽子|ケイトウ(赤紫色の花の一年草)
arraign	(法廷に呼び出して)〈被告〉‘に'起訴事実の認否を問う|《文》〈言動など〉'を'とがめる|糾弾(きゅうだん)する;(〜に関して)〈人〉'を'とがめる|非難する《+『名』+『for』+『名』》
ineluctably	避けられないで
layabout	なまけ者
purvey	まかなう|調達する|伝える
convoke	〈会議など〉'を'召集する
concubinage	同棲|内縁関係
lifework	一生をかけた仕事|ライフワーク
reparable	(誤りが)修正できる|直せる
ophthalmia	眼炎(目が赤くはれる炎症)
gallivant	(刺激・楽しみを求めて)ぶらつく|ほっつき歩く(gad)
deafen	聴覚を奪う
disfranchise	〈人〉‘から'公民権(選挙権)を奪う|〈都市〉‘から'特権を取り上げる
abjection	卑しさ|卑劣|下劣
folding	折り畳みの
victual	飲食物|食料(provisions)|〈多人数〉‘に'食物を供給する|〈船など〉‘に'食糧を積み込む
prognosticate	(知識・経験に基づいて)〜‘を'予知する|予測する;〈〜であること〉‘を'予知する《+『that節』》|〜‘の'前兆となる
addle	〈卵〉'を'腐らせる|《話》〈人|人の頭など〉'を'混乱させる|〈卵が〉腐る|《話》〈人|人の頭などが〉混乱する
agglutinate	〜'を'膠着(こうちゃく)させる|膠着する
benignity	仁慈　優しさ　親切な行為　恩恵　慈悲　温暖　親切温情
ouzel	クビワツグミ(全体が黒く胸に白い輪のある鳥)
rentier	不労所得生活者
coxcomb	しゃれ者|だて男|=cockscomb2
underquote	(特定の競争相手よりも)〜‘に'安い値をつける|‘を'安く見積もる(underbid)
floury	粉だらけの|粉のついた|粉っぽい|粉状の
congest	(〜で)〈道路・乗り物など〉'を'混雑させる|いっぱいにする《+『名』+『with』+『名』》|〜'を'うっ血(充血)させる|混雑する|いっぱいになる;うっ血(充血)する
zelkova	欅(ケヤキ) (ニレ elm の近縁種)
stateliness	荘重|威厳
landslip	=landslide1|2
delectably	快く|楽しく
unbuckle	〜‘の'留め金をはずす
smoothbore	(鉄砲が)滑腔(かっこう)の(施条の付いていないこと)|滑腔銃
jerkiness	急に動くこと|けいれんすること|愚かなこと
reinsure	〜‘を'再保証する|〜‘に'再保険をかける
yonks	長期間|長い間
peaky	峰のようにとがった|衰えた|やつれた|《話》気分が悪い
limbless	手足(翼)のない
cannily	慎重で抜け目なく
schuss	(スキーの)直滑降|直滑降する
aflutter	(旗などが)はためいて|ひらひらして
goddaughter	名付け娘|教女
naysayer	反対論者|反対|否定する人
plainspoken	遠慮なく(率直に)言った
catgut	腸線|ガット(小羊などの腸で作った強いひも・糸で弦楽器の弦|テニスのラケット|外科用縫合糸などに用いる)
cacodylate	カコジル酸塩
asterism	〈U〉星状光彩(結晶した鉱物に見られる星形の光の反射)|〈C〉星群;星座
hawser	(停泊･曳航(エイコウ)用などの)大綱|大索
underexposure	(写真)露出不足
leading	先導する|主要な|主な|優れた
embezzler	横領者
staging	上演できる|上演|駅馬車業|集結
cion	=scion
fluster	騒がす|あたふた|あわてる様子
suffuse	満たす
kinswoman	親類の女
saleslady	女店員
transship	〈乗客・貨物〉‘を'他の船(列車など)に移す|積み換える
taximeter	タクシーの料金メーター
fervency	熱烈|激情|熱意|白熱|熱さ|ほてり
refutable	論破できる|反証の余地のある
internee	抑留されている人|監禁されている人
bethink	(〜について)〈自分〉‘に'考えさせる|思い出させる《+one『self』 『of』+『名』(『wh-節』)》
tsarina	=czarina
potsherd	(特に考古学的価値のある)陶器片
priggish	気取った|口やかましい
serried	密集［林立］した(crowded)
wherefrom	[そこから]〜するところの(from which)
careworn	(人・顔などが)苦労でやつれた
charlock	ノハラガシ(黄色い花の咲くアブラナ属の植物)
tonsure	剃髪(ていはつ)(司祭職に就くため|または修道士になるため頭髪全部またはその一部をそること)|頭髪をそり落とした部分|〜を剃髪する
frolicsome	はね回る
overrate	過大評価する
patriotically	愛国的に
haziness	かすんだ状態|ぼんやりした様子
ritualism	《しばしば軽べつして》儀式[尊重]主義|形式主義
redistrict	(選挙などのために)〈区域〉‘を'分割(区画)し直す
phyletic	系統発生の
vinegary	酢のような|すっぱい|(人が)意地悪い|気むずかしい
strangulate	〈腸・血管など〉‘を'くくる|縛る;〈血行など〉‘を'縛って止める
roving	移動する|常駐しない|放浪する
hexameter	六歩格(ギリシア・ラテン叙事詩などの韻律);〈C〉六歩格の詩行
rowdiness	乱暴・騒々しさ
sinuosity	〈U〉曲がりくねり|湾曲|〈C〉(川・道路などの)湾曲部
seriatim	相次いで|順次
parricide	〈C〉近親者(特に父親)殺しの犯人|尊属殺人者|〈U〉尊属殺人
ullage	(たる・びんなどで液体の蒸発・漏出などによる)不足量|目減り量
disembowel	(動物から)内臓を抜き出す
grandness	雄大[さ]|壮大[さ]|堂々としていること
splotchy	汚れ(しみ)のついた;大きな斑点のある
allurement	〈U〉そそのかし|誘惑|〈C〉誘惑する物(事)
straggle	ばらばらに広がる|散在する|列などからはぐれる|落伍する|締まりがない
recreant	不実(忠)な;おく病な|裏切り者|おく病者
adrenalectomized	副腎を切除された
incontrovertibly	議論の余地がなく|明らかに
reportorial	記者の|報告者(記録係)の|報告(的)の|記録の
imputable	負わせられる|帰せられる;(〜を)負わせられる《+『to』+『名』》
castoff	解雇された人|脱ぎ捨てた|捨てられた人(物)
annelid	環形動物(ミミズなど)|環形動物の
candelabrum	枝付き燭台
bareness	裸|むき出し
browning	褐色化
shamefaced	恥じた|恥じ入った|はにかむ|内気な
spoilsport	他人の楽しみをだいなしにする人
photostatic	フォトスタットの|複写写真[機]の
perspicuity	(言葉などの)明快さ|理解しやすさ
visitant	《文》幽霊|亡霊|(またvisitor)渡り鳥
voracity	大食|猛烈な食欲;どん欲さ
telemeter	テレメーター|遠隔計器(温度・放射能などを護定し遠く離れた受信地に送る電気装置)
fadeless	しおれない|衰えない;色あせない|不朽の
judder	震える|きしむ(vibrate)
orrisroot	ニオイアヤメの根茎(香料などに用いる)
puckish	いたずら好きの
permissibly	許されて|差し支えなく
dogcart	(背中合わせの2座席がある)軽二輪馬車|犬に引かせる二輪車
topdress	〈土の表面〉に追肥をする(肥料|石灰などをまくこと) = top-dress
jocund	陽気な|快活な|楽しそうな(cheerful|gay)
unutterably	言語に絶するほどに|非常に
steamfitter	スチームパイプ(蒸気管)
inextinguishable	(火・感情が)消すことのできない;抑えきれない
cretinism	クレチン病(甲状腺障害で幼児期に発育が止まる)
embrocation	〈U〉(ローション・塗り薬などを)すりこむこと|塗布すること|〈C〉塗り薬
betoken	予示する
lysogenic	溶原性|ウイルス(Phage)が感染し|細胞膜を破壊された細菌がphageの形質を持つようになることをいう
merchantman	商船
peccadillo	ちょっとした過ち
cubbyhole	こぢんまりして(暖かくて)気持ちのよい部屋･場所
clericalism	聖職権[拡張]主義;聖職者の政治勢力
foeman	敵|敵兵
confute	論破する
muezzin	イスラム教徒の祈とう時報係(イスラム教寺院の尖塔から|定刻に大声で合図の言葉を唱える)
unexpectedness	思いがけないこと|不意|意外
fusty	かび臭い
rathskeller	(通例地下にある)ドイツ風レストラン
enfranchise	〜‘に'参政権(選挙権|自治権)を与える|〈奴隷(どれい)など〉‘を'解放する|自由にする
incertitude	確信(自信)のないこと|不確実|不安定
requital	返礼|報償|仕返し|報復(revenge)
capful	帽子1杯[の量]
drub	(棒などで)〜‘を'強く打つ|(試合などで)〈相手〉‘を'決定的に負かす
cognomen	名字|姓;家名|名称;あだ名
jackboot	ひざの上までくる長靴
miscalculate	計算違いをする
extenuate	軽くする|酌量のする|軽くみなす|酌量する|軽減する
aquacade	水上ショー(音楽に合わせて飛込み・水中ショーなどを見せる)
disinherit	〈相続人〉‘から'相続権を奪う;〜‘を'勘当する
wangle	を策略で手にいれる|をごまかす|ごまかし
roughen	〜‘を'粗くする|ざらざらにする|粗くなる|ざらざらになる
towline	(船・車などの)引き綱
plutocratic	金権政治[家]の
calomel	塩化第一水銀(下剤・殺菌剤用の白色の粉末)
muddler	物事を台なしにする人|マドラー(飲み物を混ざ合わせる棒)
bagful	(〜の)袋1杯[の量]《+『of』+『名』》
disquietude	不安|不穏
stingo	強いビール
calculative	計算の|打算的な;慎重な|抜け目のない
bundler	包み(束)を作る人|荷物をまとめる人
careerism	立身出世主義
nightrider	(特に南北戦争後の)夜の騎馬暴力団員
highfalutin	もったいぶった|大げさな
anile	老婆の[ような];もうろくした
artilleryman	砲兵|砲手
pessimistically	悲観的に|厭世的に
refection	〈U〉(特に飲食物による)元気回復|〈C〉軽食
semiprofessional	半職業的な|(選手など)セミプロの・半職業人|セミプロ選手
mismanage	〜‘の'管理(経営|取り扱い)を誤る
bigamist	重婚者
precessional	(地球の自転の)歳差[運動]の
compendious	簡潔な|簡明な
aleatory	偶然で決まる|偶然の
waylay	〈人〉‘を'持ち伏せする|〈人〉‘を'持ち受けて呼び止める
manometric	流体圧力測定器の(で測った)
putdown	〈U〉制圧|〈C〉《米話》相手をばかにした言葉(ふるまい)|ちゃかし|いじわる
fruiterer	果物屋|果実商
shirtwaist	カラーとカフスのついたワイシャツ型の婦人用ブラウス(ワンピース)
chrysalid	=chrysalis
cogitate	(〜について)熟考する《+『on』(『about』|『over』)+『名』》
hyperosmolar	高浸透圧性
thinking	思考力のある|理性的な|考え深い|思考|意見|思案|考え
overproduce	〜‘を'過剰生産する
propinquity	(時・場所・関係の)近接
countervail	に相等する|に対抗する|補償する|相殺する|埋め合わせる
calisthenic	美容体操の
chloromycetin	クロロマイセチナ(抗生物質の一種;商標名)
spermatozoon	精子|精虫
striation	〈C〉細い溝(筋)にはいった状態|筋を付けること|〈C〉細い溝(筋)に一本(stria)
phthisis	(特に重症の)肺結核
archaism	古語|古風な表現|〈U〉古文体|擬古体
lacerate	(lˈæsərèɪt)引き裂く|引き裂かれた|裂けた
seclude	(〜から)〈人〉‘を'引き離す|孤立させる《+『名』〈人〉+『from』+『名』》
ninefold	9倍の|九重の|9倍に|九重に
horsewoman	女騎手|婦人乗馬者
canonize	列聖する|敬う
disentanglement	もつれを解きほぐすこと
tenderhearted	心の優しい|思いやりのある
resoluteness	決心の固さ
eleemosynary	施し物の|慈善による
unbolt	〈戸・門など〉‘の'かんぬきをはずす|‘を'あける
veritably	ほんとうに|真に
extraditable	(犯罪者が)引き渡せる;(国外・州外逃亡犯人が)引き渡し可能な
protract	(時間的に)〜‘を'長引かせる
highjack	=hijack
disconcert	(人)の落ちつきを失わせる|当惑させる|混乱させる|くつがえす|(計画など)の裏をかく
coccus	球菌|個々の細胞の形状が球形の原核生物(真正細菌及び古細菌)のこと|桿菌(bacillus)|らせん菌(spirillum)と併せ|原核生物を形態で分類する場合の用語
choler	《まれ》かんしゃく|怒気
untidiness	だらしないこと;無精;乱雑
saintliness	(聖人のような)気高さ|こうごうしさ
hatless	帽子をかぶっていない
umbel	散形花序
epigrammatic	警句(風刺詩)の|警句ふうの|風刺的な;(人が)警句好きの
coachwork	自動車の外側車体
papule	丘疹(きゅうしん)|(皮被にできる)小さな吹き出物
granduncle	大おじ(親のおじ)
souse	(水などに)〜‘を'入れる|突っ込む《+『名』+『in』(『into』)+『名』〈水など〉》|〜‘を'ずぶぬれにする|〜‘を'酢(塩水)につける|《米》〜‘を'酔わせる|水につかる|ずぶぬれになる|《米》酔っ払う|(豚の足などの)塩づけ|(つけ物の)塩づけ汁|塩水|《米》大酒飲み|酔っ払い
conflictive	矛盾する|相反する
vassalage	(封建時代の)封臣(領臣)の身分|(家臣に要求される)忠誠心|(君主から与えられた)封土|従属|隷属(れいぞく)
overcall	=overbid
pastern	繋(けい)(牛・馬などの脚のくるぶしとひづめとの間の部分)
endotoxic	内毒素
snivel	鼻水(をたらす)|泣き言(を言う)|鼻をすする|鼻声
pectic	ペクチンの|膠素(こうそ)の
underclothing	=underclothes
designedly	計画的に|故意に
underpay	〈労働者など〉‘に'賃金を十分に支払わない|不当に安い給料を払う
whensoever	wheneverの強調形
engraft	(他の木に)〜‘を'接ぎ木する《+『名』+『on』(『upon』)+『名』》|(人の心などに)〈主義・考えなど〉‘を'しっかりと植え付ける《+『名』+『in』+『名』》
fellowman	(人類の)仲間|同胞
immolate	いけにえにする|犠牲にする
yowl	長く悲しそうに叫ぶ|遠吠えする|物悲しい鳴き声
periphrastic	回りくどい|遠回しの
onanism	オナニー|手淫|性交中絶
penurious	貧乏な;(〜が)欠乏した《+『of』+『名』》|けちな
caesura	中間休止(詩行の中間で意味の切れによる休止)
shipload	船1隻の積荷量
unlatch	〈戸など〉‘の'掛け金をはずす
obbligato	助奏(普通の伴奏以外につける装飾的伴奏)|(伴奏などが)不可欠の|省略できない
upperclassman	(大学・高校の)上級生(3年生または4年生)
syllabification	=syllabication
ortolan	キノドアオジ(ホオジロ属の鳥)
ebullience	幸福感と喜びに満ちあふれること
janissary	トルコ近衛(このえ)兵(1826年廃止);(一般に)トルコ兵
bonzer	非常に大きい|すばらしい|みごとな
protraction	(〜を)長引かせること《+『of』+『名』》
contumely	(言葉・態度の)ごう慢|無礼;(それによって受けた)恥辱
capriole	カプリオール(前脚を引いて飛び上がり|後脚をけり上げる)馬の跳躍)
mysid	アミ類(小型のエビ類)
achene	痩果(そうか)(タンポポ・キンポウゲの類の果実)
horridly	ひどく
cogwheel	[はめば]歯車
protuberant	突き出した|隆起した
perfunctorily	おざなりに
kibitz	(トランプなどゲームをそばで見物して)余計な口出しをする
jejune	《文》(特に書かれたものが)おもしろみのない|無味乾燥な|未熟な|《米》子供っぽい
sickbed	病床
shrillness	(声の)甲高さ|鋭さ
coping	(塀などの頂部の)笠木|笠石
scenically	風光明美に|舞台的に
mishandle	の取り扱いを誤る|へたにいじくる|まずく処理する|虐待する|手荒く取り扱う
surd	無理数(ルート3など)
wadge	(〜の)ぎゅっとつめた束《+of+名》　塊（かたまり）　ケーキ一切れ
piquancy	ぴりっとかる良い味|痛快;しんらつ
cresset	かがり(かがり火を燃やす金属製のかご)
inflexibly	不屈に|がんこに
unpremeditated	前もって考えてない|故意でない
paradisiacal	天国の[ような]
conge	(公株の)退去|(突然の)免職|解任
sermonize	小言を言う|説教する|説法する
forepaw	(犬や猫など爪のある哺(ほ)乳動物の)前足
bigamous	重婚罪の|同時に2人の夫(妻)を持った
draggy	無気力の|不活発な|非常に退屈な
dizzily	目まいがして;目がくらむほど
copout	(決断すべき事の)放棄|断念;破約
servicewoman	(電話などの)女性の修理人(係)
pauperism	(救済の必要な)貧窮状態|赤貧
maltreat	〜‘を'虐待する|酷使する
diaminobenzidine	ジアミノベンジジン(化学的に安定な合成繊維の名称)
oviparous	(生物が)卵生の
kummel	キュンメル酒(北ドイツ産の強い酒)
peroration	(講演などの)結論|熱のこもった演説
anisette	アニス入りのリキュール酒
disfranchisement	公民権(選挙権)はく奪
suspiciousness	疑惑|不審
bedspring	寝台のマットレスを支えている床座のスプリング
nonrigid	堅くない|柔軟な|(飛行船が)軟式の
bereave	(bereft|bereaved)(生命･財産など)を奪う|失わせる
shootdown	シュートダウン|撃ち落す|(人を)撃ち殺す
collaborationist	敵に協力する人|敵に協力的な
leisured	暇のある|有閑の;ゆっくりした
prolixity	冗長
humidify	〜‘を'湿らす|ぬらす
intermit	〜‘を'一時中断する|一時中断する
planetesimal	微惑星体(太陽系生成時に互いとの衝突・合体によって原始惑星に成長する小天体)
hydropathy	=hydrotherapy
buskin	(一種の)編み上げ半長靴|(古典悲劇役者がはく)半長靴|《the~》悲劇(tragedy)
chaffer	値切り|掛け合い|値切る|値を掛け合う
roughrider	ロデオに出す馬の調教師|荒馬を乗りこなす人
coarsen	あらくなる|粗雑になる|〜'を'あらくする|粗雑にする
expostulate	(〜について人を)いさめる|訓戒する《+『with』+『名』+『about』(『on|for』)+『名』(do『ing』)》
attaint	(法律上)〈人〉‘の'私権を剥奪(はくだつ)する|《古》〈名誉など〉'を'汚す|私権喪失|《古》汚名
dybbuk	(人に取り付くというユダヤ民俗の)悪霊(りょう)|死人の霊
staysail	支索帆(両マスト間の三角帆など)
clearway	停車禁止道路[区間]
perjure	偽誓する
betroth	(〜と)〜'を'婚約させる《+『名』+『to』+『名』》
ladyfinger	指状のカステラ風の菓子
prudery	淑女ぶり
strongpoint	長所|強み
eclectically	取捨選択して|折衷して
vasopressor	昇圧剤
outdistance	(競技などで)〈相手〉‘を'はるかに引き離す
atonality	(音楽の)無調[性]|(作曲上の)無調様式
posthaste	《文》大急ぎで
nosecone	ノーズコーン(ロケット先端の円錐(えんすい)形部分)
vicissitude	(人生・境遇などの)変化|変動|浮沈
scurf	(頭の)ふけ|あか|(一般に)薄くてうろこ状にはげ落ちるもの
underdress	〈人〉‘に'場所(状況)にそぐわない服装をさせる　略式（簡単）すぎる服装をする　くだけすぎた服装をする
swelter	暑さでまいる|汗だくになる
gluey	にかわ質(状)の|にかわのようにねとねとする
tragedian	悲劇作家|悲劇俳優
nitre	=niter
massiveness	どっしりとしていること
immodesty	慎みなさ|みだら;無遠慮|うぬぼれ
dissuasion	(説得して)思いとどまらせること
goodhearted	親切な|やさしい(kind)
commonalty	一般民衆|庶民|民衆団体
overcrowd	混雑さ
distend	膨張させる|広げる|膨脹させる|誇張する|膨らませる
clearheaded	頭の冴えた
correlogram	相関曲線
indorse	=endorse
sluttish	(女が)だらしのない|(女が)身持ちの悪い
dishearten	落胆させる
shagbark	ヒッコリー(北米産のクルミ科の木);|その木材
noncontributory	(年金が)雇用者負担の
individuate	〜‘を'個別化する|〜‘に'個性を与える
exurb	準郊外(郊外のさらに外部にあり|富裕階級が住む地域)
oversleep	寝過ごす|寝坊をする
murkiness	暗さ;陰気;曇っていること
berkelium	バーケリウム(超ウラン元素;化学記号はBk)
hypothecate	〜‘を'仮定する;〜‘と'いう仮説を作る《+『that節』》|仮説を立てる
consolatory	慰めの|慰問の
typing	typewriting
placode	(発生学)母組織|原基|プラコード
oozy	にじり出る|じくじくする|どろどろした|泥のような
thighbone	大腿(だいたい)骨
ligate	(強く)縛る|ligate the artery動脈を結紮(ケッサツ)する
cerumen	耳あか
alienist	《古》精神病医(特に法廷での証言を専門とする)
thermocycler	サーモサイクラー|生物学や医学の実験で|ポリメラーゼ連鎖反応(PCR)によりDNA断片を複製させる機器
drupe	核果|石果(さくらんぼ・梅・桃など)
fraudulence	詐欺|いかさま|不正
afforest	〈荒地・畑など〉'を'山林にする;〈土地〉‘に'造林する|植林する
choky	監獄
thieve	盗む|どろぼうを働く
eulogize	賞賛する|ほめたたえる|賛美する|の賛辞を述べる
tetchy	気難しい|怒りっぽい
civvies	(軍服に対して)平服|背広
treacly	糖みつの[ような];(飲食物)が甘ったるい|(声・言葉などが)甘ったるい
aboveboard	公明正大な|隠すことのない|公明正大に|隠しごとをせずに
pugilistic	＜pugilist|ボクシングの|ボクサーの|ボクシング|ボクサーに関する
earsplitting	(音・声が)耳をつんざくような
popinjay	しゃれ者|気取り屋
transfuse	〈血液〉‘を'輸血する:transfuse blood 輸血する
veracious	(人が)真実を語る|正直な|(話などが)正確な|ほんとうの
anywise	どうしても|なんとしても
unguent	軟こう;こう薬
overtax	重税をかける
loudmouthed	大声の|やかましい
squally	突風の吹く|荒れ模様の|《話》形勢が悪い;不穏な
frontbench	大臣|野党の幹部(議会で正面に近い席につくことから)
busywork	忙しいが価値のない仕事
spiritualistic	唯心論的; 心霊術（的）
sideway	横道|歩道|脇道
speechify	演説をぶつ|長談義をする
appositive	同格の(語･句･節)
incorruptibility	買収されないこと|清廉潔白|腐敗しないこと
blighter	いやなやつ|男|やつ
xpost	(発音krɔ'ːspóust)|(=x-post)|クロスポストする(同一内容のＥメールを複数のメーリングリストに投稿する)
contumacy	権威無視|命令服従
chromatically	彩色を施して|彩色的に|半音階に
cumbrous	=cumbersome
labium	くちびる;くちびる状の物|《複数形で》陰唇
convect	〈熱・流体〉'を'対流によって移動させる
carbocation	カルボカチオン(正に帯電した炭素を含む化合物)
repoint	〈壁のれんがの間〉‘に'モルタルを塗り直す
ubiquitylation	ユビキチン化 
kedge	〈船〉‘を'錨(いかり)綱をたぐって動かす|〈船が〉錨綱のたぐりで動く|(船を移動させる)小錨
superlatively	最上に|最高に
bloodcurdling	血も凍もような|ぞっとするような
waspish	スズメバチのような|怒りっぽい|短気な
execration	〈U〉憎悪|〈C〉のろいの言葉|〈C〉のろうべき相手(物)
comestible	食料品
uncoil	〈巻いたもの〉‘を'ほどく|解く|ほどける|解ける
ratiocination	推論|推理
prearrangement	前もっての打ち合わせ
kicky	おしゃれな|面白い|蹴り癖のある|すてきな|シックな|活気のある|元気な|最新の|刺激的な|ワクワクする
belike	どうも〜らしい|おそらく|たぶん
tardily	のろのろと
smoulder	くすぶる|煙
depopulate	〈戦争・悪疫などが〉〜‘の'人口を減らす
shrewish	口やかましい;意地の悪い
unversed	(〜を)経験していない|(〜に)熟達していない《+in+名》
nonaligned	(国家が)非同盟の|中立の
superabundant	(物・愛情などが)過多の|あり余る;(〜が)あり余っている《+in+名》
hypercritical	酷評の|あら捜しする(overcritical)
obduracy	強情|がん固;冷酷
lifebuoy	救命用浮き袋|救命ブイ
delouse	〜‘から'シラミを駆除する