weeny	ちっちゃな|ちっぽけな
jetlag	時差ぼけ
exoneration	免罪|罪を晴らすこと
intimal	血管内膜の
metamorphose	魔術などで違ったものに変身する|変える
motional	of or relating to or characterized by motion
myelinated	有髄
fruitfulness	生産性
illusionary	幻影の|幻想の
variola	裳瘡|痘瘡|天然痘|御厄|疱瘡
laminectomy	椎弓切除
dehydrate	〜'を'脱水する|脱水状態にする|水分を失う|〈体が〉脱水状態になる
ambo	朗読台|高座|立ち台|教壇|立台|説教台|論壇|演壇|講壇|街頭演説台
fretwork	雷文飾り
uprightness	垂直|律儀|廉直|真面|正直|正面|律義|清廉|方正
woodcutter	きこり
cytochalasin	サイトカラシン(がん研究用試薬|細胞分裂･アポトーシス関連の基礎研究用試薬)
apposite	適切な|きわめて適切な
gerontologist	a specialist in gerontology
uncial	アンシアル書体の|アンシアル書体(4‐8世紀にギリシア・ラテンの写本に用いられた)
flooring	床|床張り(材料)
bilby	bandicoot with leathery ears like a rabbit
alterative	治癒的|治療的
sloppiness	だらしなさ|乱雑;いいかげんさ
arteria	動脈
limpid	透明な
kiloton	キロトン|キロトン
tuppence	=twopence
hypospadias	尿道下裂
forecastle	(船の)前甲板|船の前甲板下の船員部屋
calculable	計算できる|信頼できる;予想できる
undemanding	requiring little if any patience or effort or skill; "the pay was adequate and the job undemanding"; "simple undemanding affection"; "an undemanding boss"|requiring little if any patience or effort or skill
statuesque	彫像のような
unsatisfiable	not capable of being satisfied; "he knew the trap of unsatisfiable longing"|not capable of being satisfied
bracer	a protective covering for the wrist or arm that is used in archery and fencing and other sports|a tonic or restorative (especially a drink of liquor)
maladministration	やりそこない;悪政|失政
cogitation	〈U〉熟考|熟慮;思想力|〈C〉《しばしば複数形で》熟慮の結果;考案|着想
farsighted	先見の明のある|遠視の
cholecalciferol	カルシフェロール|コレカルシフェロール|エルゴカルシフェロール
grippe	インフルエンザ(influenza)
encouragingly	激励して
subcloned	サブクローンされた
salivate	つば(よだれ)を出す
maleficent	害をなす|有害な
evenness	the parity of even numbers (divisible by two)|a quality of uniformity and lack of variation|the quality of being balanced
bema	聖堂内陣|ユダヤ教の会堂内にある壇
anaphoric	relating to anaphora; "anaphoric reference"|relating to anaphora
aril	仮種皮
reversionary	復帰権のある・復帰権のある，将来享有すべき.
shigellosis	細菌性赤痢
scriber	a sharp-pointed awl for marking wood or metal to be cut
shogunate	(日本の)幕府の
communally	by a group of people rather than an individual; "the mills were owned communally"|by a group of people rather than an individual
dolorous	悲しみを誘う|悲しそうな|悲しい|痛ましい
unenlightened	あることによく通じていない|無学の|無知の|偏見をもつ
handsewn	sewn by hand rather than machine
naphthol	ナフトール
wholesomeness	体によいこと|健全さ
capably	りっぱに|うまく
atriplex	アトリプレックス属
nosedive	急降下|～以上|～に勝るとも劣らない
symbolical	記号的|シンボリック|象徴的
magistracy	magistrateの職; （the ～） ((集合的)) 行政官; 治安判事・行政長官、判事の職(任期|管区)・《the ~》《集合的に》長官(判事)たち
foretaste	当て込み|予測|予想|前触れ|予知|(将来の苦楽を)前もって味わうこと|予期
incoherently	しどもど
ladylike	貴婦人らしい|淑女にふさわしい;上品な|しとやかな
ayin	the 16th letter of the Hebrew alphabet
kyanite	藍晶石
actinomycin	アクチノマイシン|放線菌が産生するポリペプチド系の抗生物質|20種以上が知られている|試薬や抗がん剤に使われる
panpipe	パンの笛(管を長さの順に並べた原始的な吹奏楽器;牧神Panが作ったとされる)
interrelate	(〜と)相互関係にある《+『with』+『名』》
dentine	象牙質|象牙質
vagrancy	放浪|浮浪
pandanus	タコノキ科|タコノキ|タコノキ科
coterminous	=conterminous
segregationist	分離主義の
palpably	明らかに
softy	センチメンタルな人|情にもろい人|だまされやすい人|あほ|=softie
ophrys	a hardy genus of terrestrial orchids of Europe and northern Africa and western Asia
ganger	(労働者の)組がしら|人夫がしら
improbably	たぶんそうでもない
expressionless	無表情の|表情に乏しい
bowstring	弓のつる
satchmo	アームストロング
lubricity	欲情|好色
gastrulation	原腸形成
pumpernickel	ライ麦パン|黒パン
detrimentally	in a detrimental manner
hellhole	不快な(不潔な)場所
shipbuilder	造船技師(業者)
seismogram	震動記象(地震計によって描かれた記録)
floatplane	a seaplane equipped with pontoons for landing or taking off from water
arteriography	動脈造影法
phycoerythrin	フィコエリトリン
intramuscularly	筋肉内
transcendentalism	(カントの)先験論;(エマソンの)超絶論
humanness	人間性|ヒュマニティ|人間らしさ|ヒューマニチー|ユーマニテー|ヒューマニティー|ヒューマニティ|ユマニテー|ユマニテ
overconfident	自信過剰
soundless	音をたてない|静かな
rennet	レンネット(チーズなどを作るときの牛乳の凝固剤)
sambuca	an Italian liqueur made with elderberries and flavored with licorice
integumentary	外被
propellor	推進機|プロペラー|プロペラ|スクリュー|推進器
melanocyte	メラニン細胞
eriogonum	any plant of the genus Eriogonum with small clustered flowers
cooperativity	共同性
discolouration	染み|汚れ目|染|汚目|汚|汚点|色変わり|変色|汚れ|変色
unspeakably	口では言えないほど|お話にならない
engrossment	専念|傾注|一心|専心|一心不乱|集中|夢中|埋没|没入|コンセントレーション|一心不乱|熱中|無我夢中|夢中|没頭
viand	《通例複数形で》《大げさに》食物;ごちそう
dinkum	本物の|真正の;正直な
subnormal	正常以下の
strake	thick plank forming a ridge along the side of a wooden ship
unconquerable	征服(克服)できない
offertory	(ミサ・聖餐(せいさん)式における)パンとぶどう酒の奉献|(教会の礼拝式で集められる)献金;(その時用いられる)祈とう文
perisher	困ったやつ|うるさいやつ;がき
ghanian	a native or inhabitant of Ghana|of or relating to or characteristic of Ghana or its people or language; "Ghanaian cocoa production"|of or relating to or characteristic of Ghana or its people or language
pasteboard	ボール紙|厚紙
leiomyoma	平滑筋腫
tearaway	向こう見ず|衝動的
sunbathe	日光浴をする
sophomoric	(高校･大学)2年生の|青くさい|知ったかぶりの|生意気な
mangy	軽蔑すべき|卑劣な
catarrh	カタル(特にかぜなどで鼻・のどなどの粘膜に起こる炎症)
yodeling	singing by changing back and forth between the chest voice and a falsetto
heliosphere	the region inside the heliopause containing the sun and solar system
terrycloth	テリークロス(両面のけば(毛羽)の輪奈を切らずに残した布地;タオル地など)
torchbearer	たいまつを持つ人|啓蒙する人|文化人
macroevolution	evolution on a large scale extending over geologic era and resulting in the formation of new taxonomic groups
epimedium	イカリソウ
leav	去る|残して去る|許可|休暇
dislocate	〜‘の'場所を移す|位置をずらす|〜‘を'脱臼(だっきゅう)させる(disjoint)|〈正常な状態〉‘を'乱す|混乱させる
aspirator	a pump that draws air or another gas through a liquid
reverential	敬けんな|恭(うやうや)しい|慎重な
associateship	the position of associate (as in an office or academy)
schoolmate	学校友達
ophthalmoscope	検眼鏡
comint	コミント
indocin	インドメタシン
meaninglessness	ちんぷんかん|虚言|たわけ|戯言|虚誕|無稽|世迷言|出鱈目|ノンセンス|出たら目|無意味さ
protist	原生生物
warhorse	(昔の)軍馬|百戦練磨の兵士;(政界などの)古つわもの
cervus	the type genus of the Cervidae
snowdrift	雪の吹きだまり(堆積)
sensationalist	扇情的な人|(哲学で)感覚論者
formosan	the Austronesian languages spoken on Formosa|of or relating to or characteristic of the island republic on Taiwan or its residents or their language; "the Taiwanese capital is Taipeh"|of or relating to or characteristic of the island republic on Taiwan or its residents or their language
inerrant	誤りのない|間違いのない
infallibly	絶対確実に|全然誤りなく|《英話》いつも|きっと
violist	ビオラ奏者
trigonal	having threefold symmetry
ileus	イレウス
unbidden	招かれない
valency	=valence
gumdrop	ガムドロップ(ゼリー菓子の一種)
eugenic	優生学上の|優秀な子孫を残す
preincubation	前保温
callousness	冷淡|無情|冷酷|心なさ|無感覚|心無さ|非人情
cowpens	battle in the American Revolution; Americans under Daniel Morgan defeated the British|battle in the American Revolution|Americans under Daniel Morgan defeated the British
unselfishly	in an unselfish manner; "he acted unselfishly when he helped her get the promotion"|in an unselfish manner
nontransferable	incapable of being transferred
prefatory	序文の|前置きの
extirpation	根絶|撲滅
sangoma	a traditional Zulu healer and respected elder
killingly	in a very humorous manner
noiselessly	without a sound; "he stood up soundlessly and speechlessly and glided across the hallway and through a door"|without a sound
plasm	プラズマ|血漿|血しょう
burnup	a high-speed motorcycle race on a public road|the amount of fuel used up (as in a nuclear reactor)
diagnostician	診断専門医
craver	切望する人|懇願する人
potently	強力
pawpaw	=papaw
synesthesia	共感覚
adventuress	女性冒険家|女やま師
etui	small ornamental ladies' bag for small articles
illogic	不合理|非合理
turbojet	タービン式噴射推進機関(turbojet engine)|ターボジェット機
politicize	政治に携わる|政治を論じる|政治化する|政治に関心を持たせる|政治的に扱う|政治問題化する|政党化する
benedick	a newly married man (especially one who has long been a bachelor)
supergiant	an extremely bright star of very large diameter and low density
mandara	a Chadic language spoken in the Mandara mountains in Cameroon; has only two vowels|a Chadic language spoken in the Mandara mountains in Cameroon|has only two vowels
commodious	(いすが)ゆったりとした;(部屋・家が)広々とした
skullduggery	=skulduggery
industrialism	産業(工業)主義
midlevel	中間レベル
calorimetric	熱量測定
busboy	食堂の下働き(食卓を片付け次の客がつけるように準備するボーイ)
margrave	(中世ドイツの)辺境伯(国境地域防衛を任とする地方官)
sulindac	スリンダク
conurbation	都市集団|(特に)大都市圏
plainclothes	(警官が)私服の
musicological	of or relating to musicology
lahar	ラハール
epiphytic	of or relating to epiphytes
gimlet	(T字形の柄をもつ)錐(きり)|ギムレット(カクテルの一種)
anlage	(生物)原基(細胞群で器官に成熟する前の段階のもの)|(心理)素質|遺伝的素質
damascene	a native or inhabitant of Damascus|a design produced by inlaying gold or silver into steel|of or relating to or characteristic of Damascus or its people; "damascene city gates"|of or relating to or characteristic of Damascus or its people|(of metals) decorated or inlaid with a wavy pattern of different (especially precious) metals; "a damascened sword"|(of metals) decorated or inlaid with a wavy pattern of different (especially precious) metals|inlay metal with gold and silver
pincer	ピンセット|毛抜き|ニッパ|はさみ
bleah	あかんべー
lignum	woody tissue
psycholinguistic	of or relating to the psychology of language
musette	ミュゼット
conduce	(ある結果に)導く|貢献する《+『to』(『toward』)+『名』》
fucus	any member of the genus Fucus
passing	過ぎて行く
maidservant	お手伝いさん|女中(maid)
potamogeton	a large genus of aquatic herbs found in quiet waters in temperate regions; leaves usually float on the water|a large genus of aquatic herbs found in quiet waters in temperate regions|leaves usually float on the water
metrological	of or relating to metrology
kail	ケール
camarilla	分派|政派|徒党|党派|秘密結社|私党|党閥|派閥|会派|閥
methacholine	メタコリン
wheal	(腫れてかゆい)虫さされ|(蚊の)刺し跡|みみずばれ(=wale)
soave	ソアーヴェ
compartmental	divided up into compartments or categories; "most sciences have become woefully compartmentalized"|divided up into compartments or categories
stapedectomy	surgical removal of the stapes of the middle ear
ingenuous	無邪気な|率直な|淡白な|純真な|あどけない
syndicalism	サンディカリズム(労働組合が生産と分配の手段を握るべきだとする理論)
coalescent	growing together, fusing; "coalescent tradititions"; "coalescent bones"|growing together, fusing
assignation	あいびきの約束|指定|割当て
worrier	悩む人|心配症の人
smutty	黒穂病にかかった|汚れた
nonplus	〜‘を'困惑させる;〜‘を'途方に暮れさせる
gudgeon	セイヨウカマツカ(釣りやすいコイ科の淡魚;釣りえ|および食用)・《英》だまされやすい人|かも
beefsteak	(ステーキ・フライ用)牛肉の切り身;(それを焼いた)ビフテキ
cocklebur	オナモミ|ゴボウ
keratoplasty	角膜移植
triploid	3倍体(3つで1対から成る染色体のセットを持つ細胞)
falsifiable	capable of being tested (verified or falsified) by experiment or observation
womanizer	女たらし|女遊びにふける男
glassblowing	ガラス吹き;(フラスコなどの)ガラス器製造
pneumatically	圧縮空気を含んで|圧縮空気の作用で
phytotherapy	薬草療法
exploiter	(人・物などを)利用する人|搾取者;開発者
gyroscopic	ジャイロスコープ(回転儀)の
oratorical	演説の|雄弁の|雄弁家の|雄弁家ふうの
layby	曲線引き|休憩所|待避所
sacerdotal	聖職者の|司祭の;聖職制の
dorsum	背部|背|後ろ|後|背中|脊|背部
czerny	チェルニー
ontogenetic	個体発生的
crosshatch	(ペン画･製図などで)網状線(を描く|で陰影をつける)
eventuate	(〜の)結果になる|結局(〜に)なる《+『in』+『名』》
architectonic	形成性
armhole	そでぐり(そでを付けるための穴)
premolar	小臼歯|小臼歯の
remora	コバンザメ(頭上の吸盤で他の魚の腹部なとに吸着する)
courbet	クールベ
farmhand	作男|農場労働者
disembarkation	陸揚げ;上陸
bombyx	type genus of the Bombycidae: Chinese silkworm moth
intraperitoneally	腹腔内に
cladogram	a tree diagram used to illustrate phylogenetic relationships
hibachi	火鉢、小型のバーベキュー用コンロ
phytochemical	ファイトケミカル
mislay	置き忘れる
mesosphere	中間圏(地表約40から80キロメートルの所に広がっている大気層)
antidiabetic	a drug used to treat diabetes mellitus
conciseness	簡潔さ
fettuccini	フェットチーネ
cockcroft	コッククロフト
karabiner	カラビナ
rotund	丸まると太った|丸い|太った
lutheranism	ルーテル派
pickaxe	ピック
coattail	(燕尾服)上着のすそ|人のおかげで|人の助けで
bentwood	曲げ木製の
pleather	人工レザー|合皮|語源plastic and leather|polyurethane製が主
aspic	アスピック(肉・魚・野菜の煮汁から作るゼリー)
swordsmanship	剣術の腕前;剣術|剣道
hormonally	ホルモン性の
creditworthy	責任がある
blandly	(人･態度など)人当たりがよい|穏やかな|穏和な|口当たりのよい
sensually	エロ
mutability	変わりやすさ|無常|むら気|かわりやすさ
freemail	フリーメール|フリーメイル
configurational	of or relating to or characterized by configuration
imperforate	穴のあいていない|(切手に)ミシン目のない|ミシン目のない切手
mainspring	(時計などの)主ぜんまい|主因|主要動機
myelitis	脊(骨)髄炎
internecine	互いに殺し合う|共倒れの|多数の死傷者を出す|血なまぐさい
streusel	pastry with a topping of streusel|a crumbly topping for a pastry
nasogastric	鼻腔と胃の|鼻腔から胃に挿管された
mechanisation	自動化|機械化
cupful	茶わん1杯[の量]|カップ1杯の量(1|2pint=《米》0.47l|《英》0.57l)
dimorphic	二形性の|両形|2つの異なる形式で生じるまたは存在する
apophysis	(botany) a natural swelling or enlargement: at the base of the stalk or seta in certain mosses or on the cone scale of certain conifers|a natural swelling or enlargement: at the base of the stalk or seta in certain mosses or on the cone scale of certain conifers|(anatomy) a natural outgrowth or projection on an organ or body part such as the process of a vertebra|a natural outgrowth or projection on an organ or body part such as the process of a vertebra
polestar	北極星・= Polaris
oogenesis	卵形成
encyclopaedic	broad in scope or content; "encyclopedic knowledge"|broad in scope or content
dimwit	ばか|うすのろ
limited	制限された|特別
sensorial	involving or derived from the senses; "sensory experience"; "sensory channels"|involving or derived from the senses
legation	公使館|(集合的)公使館員
electrify	に電気を流す
flowage	大水|出水|横流|越流|氾濫|洪水
leafless	葉のない・葉の落ちた
piperacillin	ピペラシリン
chauvinistic	熱狂的(盲目的)愛国主義の|熱狂的性差別主義の
gainsay	(主に否定文で)を否定する|反対する|反論する
contortion	ねじれ|ゆがみ|歪曲|こじつけ
sunstroke	日射病
iseult	イゾルデ
hypersomnia	過眠症
pedigreed	血統の正しい;由緒(ゆいしょ)のある
greenmarket	グリーンマーケット
birdseed	つぶえ(小鳥のえさ)
miscegenation	(白人と黒人の)異種族混交|雑婚
echolocation	レーダー反射法(レーダーを使って物体の位置を決定する方法)
chlorthalidone	クロルタリドン|利尿剤|高血圧や浮腫(むくみ)を制御する
ungrammatical	文法に合わない
ogee	a molding that (in section) has the shape of an S with the convex part above and the concave part below
taconite	タコナイト|角岩(鉄鉱石の一種)
genetical	of or relating to or produced by or being a gene; "genic combinations"; "genetic code"|of or relating to or produced by or being a gene|of or relating to the science of genetics; "genetic research"|of or relating to the science of genetics
gluttonous	食いしんぼうの|大食の|(〜に)どん欲な《+『of』+『名』》
ragout	ラグー(野菜と肉や魚の煮込み料理)
youthfulness	若々しさ|青年らしさ
colobus	コロブス
grandam	祖母|老婆|おばあさん
brickfield	《英》= brickyard
revalue	〜‘を'再評価する|〈通貨〉‘を'切り上げる
hypotenuse	(直角三角形の)斜辺
stob	a short straight stick of wood
living	生き生きしている|生計|暮らし|生命のある|活発な|燃えている|生存|暮らし方
systole	心臓収縮
sorbate	a material that has been or is capable of being taken up by another substance by either absorption or adsorption
catenary	垂曲線|懸垂線
ferryman	渡し守|渡船業者
craniotomy	開頭術
mockingly	あざけって|ばかにして
barong	バロン
recondition	を修繕する
spirea	アワモリショウマ
nymphomaniac	(女性が)色情狂の|淫乱な女性
epitomize	典型的に示す|概略を作る
phosphorylate	リン酸化する
xenograft	異種移植片
bulgur	parched crushed wheat
epiphysis	骨端
ascaris	回虫
cogently	(議論など)説得力をもって|効果的に|適切に
tenpin	《複数形で》《単数扱い》十柱戯(10本のピンを使うボウリング)|〈C〉そのピン
dubliner	a resident of Dublin
prognosticator	予言者|占いをする人
equipoise	〈U〉釣り合い|均衡|〈C〉平衡おもり;対抗勢力
duckweed	ウキクサ科の植物;浅い水面に茂る
sepulcher	墓|を埋葬する
filch	くすねる
hypocalcemia	低カルシウム血症
loquacious	おしゃべりな|多弁な|騒々しい
mercantilism	重商主義
pastorate	牧師の職(任期)|《集合的に》牧師団
euphemistically	in a euphemistic manner; "his violent death was euphemistically referred to as a passing away"|in a euphemistic manner
flurbiprofen	フルルビプロフェン
chondrite	a rock of meteoric origin containing chondrules
frumpy	=frumpish
pterodactyl	テロダクティル(絶滅した翼竜の一種)
striate	線条体
afters	《英話》食後のデザート(菓子など)
unexciting	not stimulating|not exciting; "an unexciting novel"; "lived an unexciting life"|not exciting
muybridge	マイブリッジ
velar	(比較変化なし)軟口蓋の|軟口蓋と舌との接触により発音された|軟口蓋|軟口蓋音
prudish	極端に潔癖でお堅い|淑女ぶる|とりすました
pentagonal	五角形の|五辺形の
dextrous	=dexterous
cinquefoil	キジムシロ(バラ科の植物;ある種は五弁の葉を持つ)
soothingly	なだめるように|和らげるように
sugarplum	小さな砂糖菓子|ボンボン(bonbon)
tesseract	the four-dimensional analogue of a cube
nonprofessional	not professional; not engaged in a profession or engaging in as a profession or for gain; "the nonprofessional wives of his male colleagues"; "nonprofessional actors"|not professional|not engaged in a profession or engaging in as a profession or for gain
capercaillie	ヨーロッパオオライチョウ
heavenward	天に向かう|天の方へ
tortfeasor	a party who has committed a tort
fallibility	誤りやすさ
discoid	円板状
ideographic	of or relating to or consisting of ideograms
imbed	=embed
valedictory	告別の辞|告別演説|別れの言葉|告別の|別れの
economizer	エコノマイザー
osier	コリヤナギ[の枝](枝はかご細工に用いる)
priapism	持続勃起症
repugnance	大嫌い|いや気|反感|嫌悪|in (with) repugnance憎悪して
demurrage	(船の)超過停留|停留日数超過割増金
joyless	喜びのない|楽しくない|わびしい
paintbox	a box containing a collection of cubes or tubes of artists' paint
overcook	cook too long; "The vegetables were completely overcooked"|cook too long
execrable	憎むべき|呪うべき|忌まわしい|実にいやな|劣悪な
stolid	ぼんやりした|鈍感な|無神経な|感情を見せない
cabinetmaking	家具の製作|家具製作業(技術)
unacquainted	疎い
fluvastatin	least expensive statin drug (trade name Lescol); usually taken orally at bedtime|least expensive statin drug (trade name Lescol)|usually taken orally at bedtime
bullfinch	ウソ(短く厚いくちばしを持つ美しい鳴き鳥)
bastardize	change something so that its value declines; for example, art forms|change something so that its value declines|for example, art forms|declare a child to be illegitimate
pontifex	a member of the highest council of priests in ancient Rome
nymphaea	スイレン科
gamely	勇敢に(game:遊び･闘志･勇気の副詞形)|遊戯|遊び|ゲーム|競技|スポーツ|冗談|戯れ|からかい
sambucus	ニワトコ属
slavishly	in a slavish manner; "his followers slavishly believed in his new diet"|in a slavish manner
abase	〈品位・地位など〉'を'落とす|下げる;〈自分〉'を'卑しめる
barilla	アッケシソウ|ミルナ|ミルナ
asynchrony	異時性|非同時性|脱同期化|脱同調|非同期化|非同期性|脱同期
anthus	pipits
unachievable	及びない|及び難い|及び無い|及びがたい|無理
mandragora	a genus of stemless herbs of the family Solanaceae
misname	《しばしば受動態で》〜‘を'誤って名を呼ぶ
leaseholder	借地人|借家人
titter	クスクス笑い|パイかぶれ|女好きの男|忍び笑い|クスクス笑う|忍び笑いをする|クスクス笑いながら言う
pentoxifylline	ペントキシフィリン
transsexualism	変性症
wackiness	狂気さ
paleoclimatology	the study of the climate of past ages
coccidiosis	コクシジウム症
legatee	遺産受取人
chlorobenzene	クロロベンゼン
concertmaster	コンサートマスター(オーケストラの主席奏者;通例主席第一バイオリニスト)
dissemble	隠す|偽る|装う|のふりをする|見ないふりをする|無視する
pleasance	快|楽しさ|慶び|喜び|悦び|大喜び|歓楽|歓|愉楽|快味
oenanthe	poisonous herbs: water dropworts|wheatears
countin	counting 数え上げる
gibberellin	ジベレリン
immunoelectrophoresis	免疫電気泳動
sumptuously	贅沢
epigraph	碑文
tawney	トーニー
unemotional	ドライ
lodine	a nonsteroidal anti-inflammatory drug (trade name Lodine)
amputate	切断手術をする
swimmingly	すらすらと|順調に
usufruct	用益物権
coarseness	卑陋|低劣|平凡|俚俗|俗気|粗野|下品|不意気|卑俗|俗
truncheon	杖
teff	an African grass economically important as a cereal grass (yielding white flour of good quality) as well as for forage and hay
brueghel	ピーテル・ブリューゲル
siris	large spreading Old World tree having large leaves and globose clusters of greenish-yellow flowers and long seed pods that clatter in the wind
firebug	放火魔
marketeer	市場商人
erythropoiesis	the process of producing red blood cells by the stem cells in the bone marrow
bolometer	ボロメーター
burster	容疑|負担|受け持ち|チャージ|代価|突貫|装填|受持ち
rulership	the position of ruler
conchology	貝類学
facer	メン
precognition	[超感覚的]予知
intermittency	間歇
solfege	階名唱法
dramaturgy	芝居|劇道|テアトル|演劇術|演劇|芝屋|劇
disproportion	不均衡|不釣り合い|の均衡を破る|不釣り合いにする
romanticize	ローマ的にする
counterpane	(装飾的な)ベッドカバー(bedspread)
manat	the basic unit of money in Turkmenistan|the basic unit of money in Azerbaijan
totalizer	加算機
stomachache	『腹痛』|胃痛
coagulate	〈液体〉'を'凝固させる|〈液体が〉凝固する
eyeless	lacking eyes or eyelike features; "eyeless fish that evolved in dark caves"; "an eyeless needle"|lacking eyes or eyelike features|lacking sight; "blind as an eyeless beggar"|lacking sight
potbelly	太鼓腹
ricinus	a genus of herb having only one known species: castor-oil plant
pengo	formerly the basic unit of money in Hungary until it was replaced by the forint in 1946|a Dravidian language spoken in south central India
collembola	minute wingless arthropods: springtails
venerate	尊ぶ|崇拝する
apsis	アプス
telamon	アトラス
sartorial	仕立て屋の|裁縫(師)の|衣服に関する
urtica	a nettle yielding fiber resembling flax
cathedra	a throne that is the official chair of a bishop
guesstimate	当て水量|推測で見積もる
superfecta	a bet that you can pick the first four finishers in a race in the right order
sexploitation	the commercial exploitation of sex or sexuality or explicit sexual material; "sexploitation by advertisers is notorious"|the commercial exploitation of sex or sexuality or explicit sexual material
unsavoury	morally offensive; "an unsavory reputation"; "an unsavory scandal"|morally offensive|not pleasing in odor or taste
exemplification	〈U〉例をあげること|例示|〈C〉実例(example);好例
pleader	申立て人;嘆願者|弁護人
nucleate	核を持った|核になる|〜‘を'核にする
casque	(中世に用いた)かぶと
vainglory	非常なうぬぼれ|強い虚栄心
explorative	serving in or intended for exploration or discovery; "an exploratory operation"; "exploratory reconnaissance"; "digging an exploratory well in the Gulf of Mexico"; "exploratory talks between diplomats"|serving in or intended for exploration or discovery
lowermost	最低の|どん底の
arthrodesis	the surgical fixation of a joint which is intended to result in bone fusion
templet	テンプレート|鋳型|指針
backburner	(順位・権利で)後に回されること|他より劣ること
mikvah	ミクワー
langtry	ラントリー
estrange	遠ざける|引き離す|の心を離す|の仲を裂く|疎遠にする
animalistic	of or pertaining to animalism
syrinx	牧羊神パンの笛|鳴管(鳥の発声器官)
woodworm	(各種の)木くい虫
fecund	よく実る|多産の|よく肥えた|創造力豊かな
expressively	表情たっぷりに;意味ありげに
driftnet	流し網
euphony	音調のよさ
fishmonger	魚屋
kissable	(特に女性が肉体的魅力のために)キスしたくなる
cepacia	地中等に住む環境細菌
notability	〈U〉顕著|著名|〈C〉《複数形で》名士
gspc	an Algerian extremist Islamic offshoot of the Armed Islamic Group; now the largest and most active armed terrorist group in Algeria that seeks to overthrow the government; a major source of support and recruitment for al-Qaeda operations in Europe and northern Africa|an Algerian extremist Islamic offshoot of the Armed Islamic Group|now the largest and most active armed terrorist group in Algeria that seeks to overthrow the government|a major source of support and recruitment for al-Qaeda operations in Europe and northern Africa
peristalsis	蠕動(ぜんどう)運動(筋肉の収縮と弛緩(しかん)の運動)
ostler	=hostler
pleomorphic	relating to or characterized by pleomorphism
megalopolis	メガロポリス(いくつかの大都市と隣接する複数の都市から成る大都市圏)
nitrogenase	ニトロゲナーゼ
ragwort	widespread European weed having yellow daisylike flowers; sometimes an obnoxious weed and toxic to cattle if consumed in quantity|widespread European weed having yellow daisylike flowers|sometimes an obnoxious weed and toxic to cattle if consumed in quantity|American ragwort with yellow flowers
scheele	シェーレ
extortionate	(値段・要求などが)法外な|途方もない
diptych	a painting or carving (especially an altarpiece) on two panels (usually hinged like a book)
asthenia	無力症
sparerib	スペアリブ
synteny	生物学において「ゲノム上で遺伝子の並びが保存されている」度合い　cf|syntenic
drachm	dram|drachma
saxifraga	type genus of the Saxifragaceae; large genus of usually perennial herbs of Arctic and cool regions of northern hemisphere: saxifrage|type genus of the Saxifragaceae|large genus of usually perennial herbs of Arctic and cool regions of northern hemisphere: saxifrage
avow	率直に言う|(率直に|公然と)認める
firebreak	(山火事などをくい止めるための)防火帯(線)
putamen	果核
introspect	reflect on one's own thoughts and feelings
beneficiation	選鉱
hepcat	ジャズ気違い|新事情通|ジャズ通|ジャズミュージシャン
geosphere	岩石圏
spiraea	アワモリショウマ
undefiled	free from stain or blemish|(of language) not having its purity or excellence debased; "uncorrupted English"; "learn to speak pure English undefiled"- Van Wyck Brooks|(of language) not having its purity or excellence debased
tipu	semi-evergreen South American tree with odd-pinnate leaves and golden yellow flowers cultivated as an ornamental
harmonically	with respect to harmony; "harmonically interesting piece"|with respect to harmony
underspend	spend less than the whole of (a budget, for example)|spend less than the whole of (a budget, for example) |spend at less than the normal rate
macrocosm	《the ~》大宇宙|〈C〉(小さな体系を含む)大体系
grindle	primitive long-bodied carnivorous freshwater fish with a very long dorsal fin; found in sluggish waters of North America|primitive long-bodied carnivorous freshwater fish with a very long dorsal fin|found in sluggish waters of North America
puissant	権力の|勢力のある
egoistic	利己主義の|自己本位の
divertissement	楽しみ|娯楽|=divertimento
overpopulate	cause to have too great a population; "Some towns in New Jersey are becoming overpopulated"|cause to have too great a population
chummy	仲よしの|親しい
leiomyosarcoma	平滑筋肉腫
baddie	悪役|悪玉
heatstroke	熱射病
unio	type genus of the family Unionidae
cutis	素肌|ひと肌|人肌|外皮|人はだ|肌膚|素はだ|皮膜|膚|素膚
godown	(アジア諸国で)(港の)倉庫
cloudburst	(突然の)穀雨|どしゃ降り
ethnocentric	自民族中心主義の
pigsty	豚小屋|きたない所
demarche	(仏)(外交)手段|転換策|処置|政策の変更
dolman	トルコ人の前の開いた長い外とう|そでがケープのような婦人用コート
sucralfate	スクラルファート
slipway	船架(造船所などで船を進水させたり水から引き上げたりするために用いる水面に向って傾斜した台)
nonmilitary	非軍事
nondeductible	not allowable as a deduction
permeabilized	透過処理
fraise	a ruff for the neck worn in the 16th century|sloping or horizontal rampart of pointed stakes
multimillionaire	億万長者|大富豪
brokenhearted	失意の|悲嘆にくれた;失恋の
disparagement	軽蔑|非難
oncological	of or relating to or practicing oncology; "oncological nurse"|of or relating to or practicing oncology
fisticuffs	げんこつでのなぐり合い
repercussion	(好ましくない間接的な)影響|(音の)反響|(銃などの)反動|はね返り
quaver	震える|震音|声が震える|声の震え|震え声
magnesite	マグネサイト|菱苦土鉱
stonecutter	石工|石切り工;石切り機
favouritism	=favoritism
unmentionable	口に出せない
unimpeachable	非難できない|非の打ちどころのない|申し分のない
persuasiveness	説得力
simpatico	気の合う|同じ性質の
creativeness	創造性|創造力|クリエーティビティー|独創性
malleability	(mˈæliəbl)|展性(箔に広がる性質|cf|引っ張って伸びる性質は延性ductilityという)
cheerily	元気よく|陽気に|元気で
sickbay	(通例船内の)病室
papaverine	パパベリン
alkene	アルケン|オレフィン
ziggurat	ジッグラト(古代バビロニア・アッシリアのピラミッド形の間院)
faintness	幽かさ|臆病
damselfly	イトトンボ
crazily	夢中になって
regularisation	均一化
beguile	欺く|だます
crossbill	イスカ
cnidaria	hydras; polyps; jellyfishes; sea anemones; corals|hydras|polyps|jellyfishes|sea anemones|corals
guzzle	鯨飲する|がぶがぶ飲む|がつがつ食う
kunzite	a pinkish lilac crystal form of the mineral spodumene that is used as a gemstone
upperclass	上流の|上流階級の|(米国高校・大学で)上級の
mylanta	an antacid
docudrama	ドキュメントドラマ
cotoneaster	any shrub of the genus Cotoneaster: erect or creeping shrubs having richly colored autumn foliage and many small white to pinkish flowers followed by tiny red or black fruits
glogg	Scandinavian punch made of claret and aquavit with spices and raisins and orange peel and sugar
inhere	〈性質などが〉(〜に)固有のものとしてある《+『in』+『名』》
rearguard	(軍隊の)後衛|しんがり
pieris	あせび|あせび
officeholder	公務員
inextricable	(結び目などが)ほどけない|手がつけられないほどこみいった|脱出できない|抜け出せない
repechage	敗者復活戦
pamelor	ノルトリプチリン
popery	ローマカトリック教[の教義・儀式]
trustful	信じやすい|人をすぐ信用する
amort	utterly cast down
lewdness	猥褻|姦濫|卑猥|婬猥|淫猥|卑猥さ|如何わしさ|猥らさ|淫靡|邪淫
faille	ファイユ(絹・レーヨンなど柔らかくうねのある布地)
misguide	間違った方へ導く|間違って指導する
mujahedin	ムジャーヒディーン
therapeutical	治療学的|治療的
breezeway	建物間の屋根つき通路
looter	＜loot|略奪者
transvestism	服装倒錯(同性愛者などが異性の服装をすること)
coyly	はにかんで
malinger	(特に軍務|労働などを避けるために)仮病を使う
wotan	ヴォタン
gravid	in an advanced stage of pregnancy; "was big with child"; "was great with child"|in an advanced stage of pregnancy
enantiomer	光学異性体|鏡像体
gerrymander	ゲリマンダー(自党に有利なように選挙区を区割りすること;その選挙区)|〈選挙区〉‘を'自党に有利に改正する
pentose	五炭糖
woad	(大青(たいせい)から採った)青色染料
demyelination	脱髄
plainsong	=Gregorian chant|(またplainchant)(中世の)無伴奏教会聖歌
contort	をねじる|本来の意味を曲げて解釈する
phonogram	発音文字
bifurcate	〈道路・川などが〉二またに分かれる|分かれて二本になる|二またに分かれた
tolbutamide	トルブタミド
embolus	塞栓(そくせん|embolism)|栓子(血塊などの塊|単数形embolus|複数形 emboli)が血液中に遊離し|血管が塞がれ血流が遮断されること
dogbane	バシクルモン(キョウチクトウ科の多年草)
tepee	ティピー(北米インディアンのテント小屋)
puffball	ホコリタケ(球形のキノコの一種)
dowse	=douse
flytrap	ハエトリソウ
busk	大道芸をする
hydrolyse	加水分解
elephantine	象の|象のように巨大な;のっそりした
measureless	限界のない|測りしれない|測れないほど大きい
northeastward	北東へ(に)|北東の;北東へ向かう|北東;北東部
scandalize	あきれさせる|あきれる|(人を)憤慨させる
babbling	片言交じり
demerara	デメララ
jaybird	=jay
subtilisin	サブチリシン|スブチリシン|(枯草菌のタンパク質分解酵素)
reflectively	in a reflective manner; "he watched her reflectively"|in a reflective manner
burble	さらさら音をたてる
downspout	縦樋(=down pipe)|(石油化学工場などの蒸溜塔内にある)溢流管
trackless	道のない人|人跡未踏の|(雪などで)道の跡が消えた
demographer	人口統計学者
patroness	(仏語)patronの女性形
monistat	ミコナゾール
inconsolable	慰められない;あきらめがつかない
horary	relating to the hours; "the horary cycle"|relating to the hours
realness	レアリテ|レアリテー|リアリティ|アクチュアリティ|現実|現つ|リアリティー|誠|現|現実性
metaphysically	in a metaphysical manner; "he thinks metaphysically"|in a metaphysical manner
virtu	〈U〉(美術品などの)優秀性|よさ|値打ち|《集合的に》《複数扱い》美術品|骨とう品|{U}美術品(骨とう品)に対する造詣(知識) = vertu
explicable	説明できる|説明可能な
unreason	無分別
reincarnate	(〜として)〈新しい肉体〉‘に'生まれ変わらせる《+『as』+『名』》
crepuscule	逢魔が時|暮れ|日の暮れ|日の暮|昏黄|夕やみ|たそがれ|入り方|片夕暮れ|夕まぐれ
colouration	音色|彩色|呈色
trews	(スコットランド兵士がはく)細身の格子じまのスボン
demonization	to represent as diabolically evil; "the demonization of our enemies"|to represent as diabolically evil
gastropod	腹足類の動物(カタツムリ・ナメクジなど)
isobar	(地図上の)等圧線
manicurist	マニキュア師
intermingle	混りあう|混る|を混ぜる|混ざる
buggery	=sodomy
lynching	私刑
papist	(新教徒側から軽べつして)カトリック教徒
monozygotic	一卵性の
argot	(盗賊などの)暗語|隠語|符牒
austenite	オーステナイト
tornillo	shrub or small tree of southwestern United States and northwestern Mexico having spirally twisted pods
punctate	点状の
tamer	ならし手|使い
halobacterium	好塩菌
reovirus	レオウイルス
fontina	羊乳から作ったイタリアチーズ
hypochondria	心気症|憂鬱症|気病み|うつ病
icosahedron	正二十面体
briquette	豆炭|練炭
aconitum	トリカブト
chervil	チャービル(セリ科の植物;芳香があり葉はスープ・サラダ用)
tinkerer	鋳掛け屋|鋳掛け屋
idealize	を理想的にする|を理想化する
whang	ラップ|打撃
propitiation	なだめること;〈C〉(なだめるための)ささげ物
sinewy	引き締まった|筋っぽい|筋骨たくましい|硬い|丈夫な|力のこもった|腱質の
phylogenetically	系統発生的に
interlaboratory	研究室間の
worshiper	参拝者|崇拝者
radiochemistry	核化学|放射化学
uproarious	騒々しい|騒然たる|爆笑させる|ひどくおかしい
polymyositis	多発性筋炎
perianal	around the anus
penitential	後悔の|ざんげの
autophosphorylation	自己リン酸化 (細胞が自ら細胞内のタンパク質をリン酸化|脱リン酸化し|酵素活性や他のタンパク質との会合状態を変化させる機能)
phrenic	横隔膜の|(生理学上の意味で)精神の|精神活動の
belabor	(議論|仕事)長々とする(続ける)
dagga	relatively nontoxic South African herb smoked like tobacco
autoantigen	自己抗原
alkalosis	アルカローシス
fibril	小繊維|根毛
juglans	type genus of the Juglandaceae
burnish	磨く
blacktail	mule deer of western Rocky Mountains
pucka	absolutely first class and genuine; "pukka sahib"; "pukka quarters with a swarm of servants"|absolutely first class and genuine
desegregate	人種的差別を廃止する
acuminate	(of a leaf shape) narrowing to a slender point|make sharp or acute; taper; make (something) come to a point|make sharp or acute|taper|make (something) come to a point
decadron	a corticosteroid drug (trade names Decadron or Dexamethasone Intensol or Dexone or Hexadrol or Oradexon) used to treat allergies or inflammation
hyperpolarization	過分極
colorfast	having color that is resistant to fading or running
factionalism	派閥主義
sulfonamide	スルホンアミド|サルファ剤
sandpit	砂掘り場|砂坑|《英》(子供が遊ぶ)砂場
overdevelop	〜‘を'過度に発達させる
mastication	咀嚼(そしゃく)|かみこなすこと
hyoscyamine	ヒヨスチアミン
hooey	ばかな(不承知・不信などを表す)|ばかなこと|くだらぬ話
pettiness	取るに足らないこと|つまらなさ|狭量
immanence	(物質・要因などの)内在|(神・神の意志の)宇宙遍在
uncork	コルクを抜く
ibidem	同じ箇所に|同書に|同章に|同節に
bent	傾向|好み|曲がった|熱中している|湾曲した
dawdle	時間を浪費する|ぐずぐずする|ぶらぶらして時を過ごす|空費する|ぶらぶら歩く
actium	an ancient town on a promontory in western Greece|the naval battle in which Antony and Cleopatra were defeated by Octavian's fleet under Agrippa in 31 BC
unapproachable	(人が)話しかけにくい|親しみを持てない
putatively	推定上|一般に考えられられているところでは
gunstock	銃床
incapacitate	耐えられなくする
unnoticeable	人目をひかない|重要でない
salable	売り易い
chlorosis	萎黄病
annona	type genus of the Annonaceae; tropical American trees or shrubs|type genus of the Annonaceae|tropical American trees or shrubs
cordiality	〈U〉心からの気持ち|温情|〈C〉心からの言葉(行為)
norovirus	ノロウイルス|非細菌性急性胃腸炎を引き起こすウイルス|貝類の食中毒や|感染者の吐瀉物から経口感染する
sarracenia	サラセニア
butterball	太っちょ|でぶ|ヒメハジロ
fedayeen	(特に反イスラエル運動している)パレスチナのゲリラ隊
tody	tiny insectivorous West Indian bird having red-and-green plumage and a long straight bill
thuggery	残忍な殺人強盗|暴行|暴力
oropharynx	中咽頭
teasingly	悪戯
inconstant	変わりやすい|気まぐれま|移り気の
cotyledon	子葉(胚の初葉)
effete	時代遅れの|退廃的な|衰えた|(男が)女々しい
crestfallen	うなだれた|意気消沈した
suchlike	このような
multivalent	used of the association of three or more homologous chromosomes during the first division of meiosis|having more than one valence, or having a valence of 3 or higher|having many values, meanings, or appeals; "subtle, multivalent allegory"|having many values, meanings, or appeals
tangibly	触知できるよう(ほど)に;明白に
gloomily	暗く|薄暗く|憂うつに|意気消沈して
perfective	完了時制
lovage	herb native to southern Europe; cultivated for its edible stalks and foliage and seeds|herb native to southern Europe|cultivated for its edible stalks and foliage and seeds|stalks eaten like celery or candied like angelica; seeds used for flavoring or pickled like capers|stalks eaten like celery or candied like angelica|seeds used for flavoring or pickled like capers
chondrocyte	軟骨細胞
gnatcatcher	very small North American and South American warblers
otterhound	オッターハウンド
rosehip	ローズヒップ
adulterer	不義者|浮気者
fluoresce	けい光を発する
lexicographer	辞書編集者
incandescence	白熱[光]
simazine	a herbicide used to control weeds (especially among crops)
fluorophore	蛍光色素分子
lucidly	明快に;透明に
chevre	made from goats' milk
monogenic	of or relating to an inheritable character that is controlled by a single pair of genes
biryani	an Indian dish made with highly seasoned rice and meat or fish or vegetables
issachar	(Old Testament) a son of Jacob and a forebear of one of the tribes of Israel|a son of Jacob and a forebear of one of the tribes of Israel
astir	(〜に)わきたって|ざわめいて《+『at』+『名』》;(〜で)にぎわって《+『with』+『名』》|(ベッドから)起きて
metazoan	後生動物(Metazoa)の|後生動物は|動物分類学で動物扱いだった単細胞生物の原生動物に対し|多細胞の動物をまとめた呼び名として使用された
psychoanalytical	of or relating to or incorporating the methods and theory of psychiatric treatment originated by Sigmund Freud; "Freud's psychoanalytical theories"; "psychoanalytic treatment"|of or relating to or incorporating the methods and theory of psychiatric treatment originated by Sigmund Freud
resolvent	溶材|溶剤|溶解剤|溶媒
freakishly	気まぐれに
electrostatically	静電気的
photocoagulation	surgical procedure that uses an intense laser beam to destroy diseased retinal tissue or to make a scar that will hold the retina in cases of detached retina
glamorise	make glamorous and attractive; "This new wallpaper really glamorizes the living room!"|make glamorous and attractive
echinoderm	(ヒトデ･ウニ･ナマコなどの)棘皮動物
qabalah	カバラ
immiscible	(特に液体などが)混合できない|混じらない
branta	wild geese
undulate	波のようにうねる
disinflation	ディスインフレーション
divvy	分け合う|山分けする|分け前|配当
insidiously	陰険に|狡猾に|知らぬ間に
egregiously	とんでもなく|ひどく
ungulate	有蹄(ゆうてい)動物|ひづめのある動物
cootie	シラミ
shipshape	きちんとした|整然と
outcropping	露頭
manacle	《複数形で》|手錠|束縛|拘束|〈人〉‘に'手錠を掛ける|〜‘を'束縛する
claptrap	場当たりな
odium	憎悪|反感|汚名|悪評
doctrinaire	空論家|教条的な|空論の
hustings	演説台
besot	make dull or stupid or muddle with drunkenness or infatuation
electromotive	電動の|起電の
mandola	an early type of mandolin
charioteer	chariotを駆る人(御者)
adroitly	うなだれた|うつむいた
geomancy	divination by means of signs connected with the earth (as points taken at random or the arrangement of particles thrown down at random or from the configuration of a region and its relation to another)
ovenware	オーブン用耐熱食器
transubstantiation	(宗教)全質変化|聖変化|カトリック教会のミサや正教会の聖体礼儀でパンとぶどう酒がイエス･キリストの体(聖体・聖体血)に変化するとされること
electronegativity	電気陰性度
frequence	頻度数|頻度|頻数
sloe	スロー(ベリー)|リンボク(スモモの一種)
squab	ハト|ひな鳥|ひな鳥|ひな鳥
pilus	線毛|髪の毛|線毛
altruist	利他主義者
catastrophically	悲劇的に|破滅的に
localise	舞台とする
unflappable	(危機に臨んでも)動じない|冷静な|泰然とした
diplopia	複視
unformed	まだ形をなさない|定形のない|未発達の|未熟の
watchfulness	警戒|警戒
empyema	蓄膿症
inescapably	必定|勢
bouillabaisse	ブイヤベース(魚・エビ・トマト・サフランなどをオリーブ油でいため|水を加えて煮たフランス風寄せなべ)
erotically	性愛的に|好色に
schooling	学校教育|教育現場|教育する
medially	内側
lactuca	アキノノゲシ属
apparat	旧ソ連の政治機構
impulsiveness	直情
irretrievable	(過失・損失などが)取り返しのつかない|元どおりにならない
roguish	悪党らしい
hallucinate	幻覚を生じる|幻覚を感じる
bootmaker	a maker of boots
spikelet	トゲ|いばら|とげ|茨|刺|荊棘|小穂|棘|荊
saltine	塩ふりクラッカー
uvula	喉ひこ|(俗称|のどちんこ)
paleoecology	古生態学
housefly	イエバエ
bullnose	a small carpenter's plane with the cutting edge near the front
rapacity	貧欲(greed)
cense	香を焚く
sicken	吐き気がする|うんざりする
elopement	駆け落ち;家出;失踪(そう)
harmattan	ハルマッタン
quackgrass	European grass spreading rapidly by creeping rhizomes; naturalized in North America as a weed|European grass spreading rapidly by creeping rhizomes|naturalized in North America as a weed
monosyllabic	(単語の音節が)単音節の|単音節語の
autoregulation	(physiology) processes that maintain a generally constant physiological state in a cell or organism|processes that maintain a generally constant physiological state in a cell or organism
incontestable	明らかな|議論の余地のない
chapultepec	a pitched battle in the Mexican War that resulted in a major victory for American forces over Mexican forces at a locality south of Mexico City (1847)
fritillaria	fritillary
languor	(け)だるさ|倦怠|無気力|思い悩み|物思い
papio	baboons
corneum	角質層
epochal	一新紀元を画する|画期的な|新しい時代をもたらす|新紀元の|前代未聞の|比類のない
ventriloquism	腹話術
slovenly	(服装・言語などが)だらしのない|いいかげんな|だらしなく|いいかげんに
hoarding	貯蔵
translucence	半透明
unflavored	without flavoring added
charr	岩魚
reckoner	計算する人|建算者|=ready reckoner
fortissimo	(音楽の演奏で)最も強く(《略》ff)|最も強い|フォルテシモの
dreamboat	魅力的な異性
purloin	〈ささいな物〉‘を'盗む|盗む
yggdrasil	(Norse mythology) a huge ash tree whose roots and branches hold the earth and Heaven and Hell together|a huge ash tree whose roots and branches hold the earth and Heaven and Hell together
catalyse	触媒
celeriac	セルリアク|セルリアク
dibasic	(化学)二塩基性の
overprotect	オーバーケア|オーバーケア
aquanaut	海洋潜水士(深海に設置された居住設備内に生活し|学術上のデーターをとる人)
mandrill	マンドリル(西アフリカ原産のヒヒの一種)
ingrate	恩知らず|忘恩の徒
talky	おしゃべりな
inanity	ばかなこと|愚鈍|空|空虚|考えのない行為|無意味な言葉
embayment	入江|浦|入り江|潟|湾
infantilism	小児病|小児病
purposeless	目的のない|動機のない;無意味な
hypotonic	(of living tissue) lacking normal tone or tension|(of a solution) having a lower osmotic pressure than a comparison solution
avifauna	the birds of a particular region or period
gobbledygook	分かりにくい言葉|ややこしい言葉|お役所言葉|チンプンカンプン
adduction	内転
unshared	非共有
ingroup	連中|党|社中|同人|政派|一群れ|徒党|党派|派|私党
immunopathology	免疫病理学
assort	〜'を'分類する|仕分ける
carryall	大きな手さげ袋|(数人乗りの1頭立ての)四輪馬車|乗合バス
peplum	ペプラム
careerist	出世第一主義者
fibroma	線維腫
metalhead	a fan of heavy metal music
bivalent	二価の(二つの原子価を持つ)
tableland	高原|台地
damned	のろわれた
unselfishness	無私|無欲
undistorted	without alteration or misrepresentation; "his judgment was undistorted by emotion"|without alteration or misrepresentation
sycophant	追従者
goodby	さようなら=goodbye
homegirl	a fellow female member of a youth gang
paresis	不全麻痺|局部的運動麻痺
bagman	《米俗》わいろ(身代金)の受け渡しの使い走り
astrocyte	星状膠細胞
egoist	利己主義者|自己中心的な人|うぬぼれの強い人
cowman	牛飼い|牧畜業者
newspaperman	新聞記者
cocoanut	ココナッツ|ココナツ
phenotypically	表現型(肉眼で見える生物の形質)
neuroticism	ノイローゼ|神経症|気の病|精神神経症
sublimely	卓越して|抜群に|荘厳に|すばらしく|全く|ひどく
destructible	破壊し(され)やすい|壊れやすい
astutely	敏感|鋭く
mesentery	腸間膜
kraal	(垣を巡らした)南アフリカ原住民の村|(南アフリカで|牛・羊などを飼うために)囲ってある場所
defeasible	capable of being annulled or voided or terminated; "a claim to an estate may be defeasible so long as the claimant is under 21 and unmarried"|capable of being annulled or voided or terminated
semitone	半音
airing	空気で乾かすこと|外出|散歩
semigloss	a paint that dries with a finish between glossy and flat
alyssum	ニワナズナ(白・黄色の花をつける雑草)
avulsion	摘出|剥離|裂離|捻除
multitudinous	非常に多くの|多数の|多項目から成る
fishhook	釣り針
subjectivism	主観論
penology	刑務所学(刑務所の機能や管理について研究する)
beatific	幸福にする
backing	裏うち|逆行
prognostication	予言|予測|前兆
primidone	プリミドン
bigness	大
innerspring	内ばねの
caesarian	帝王切開
chicha	an oriental tobacco pipe with a long flexible tube connected to a container where the smoke is cooled by passing through water; "a bipolar world with the hookah and Turkish coffee versus hamburgers and Coca Cola"|an oriental tobacco pipe with a long flexible tube connected to a container where the smoke is cooled by passing through water
bollworm	any of various moth caterpillars that destroy cotton bolls
artificiality	人工的なこと|人工物|わざとらしさ
fortuitously	幸い|つごう好く|都合好く|つごう良く|幸いにして|幸く|折好く|幸いなるかな|折りよく|運よく
parrotfish	gaudy tropical fishes with parrotlike beaks formed by fusion of teeth
integument	(動物の)外皮;(植物)珠皮(しゅひ)
chaperon	付添い|行儀作法の監督を任された人
lysosome	リソソーム(lysosome)|真核生物が持つ細胞小器官の一つ|水解小体(すいかいしょうたい)とも呼ばれる|語源は“lysys(分解)”+“some(〜体)”に由来
sparkplug	(内燃機関の)点火プラグ(《英》sparking plug)
cosigner	(手形などの)連帯保証人|=cosignatory
colocalization	同時局在|共局在性|共局在
muckle	多量|許多|山積み|百千|山盛り|あまた|数多|洪水|万斛
ixodes	type genus of the family Ixodidae
respecter	《軽べつして》権力にへつらう人|えこひいきする人
mujahedeen	ムジャーヒディーン
malar	頬骨
bromate	ブロム化|ブロム化
photomontage	合成写真|フォトモンタージュ
pyrolytic	resulting from pyrolysis
churlish	粗野な|田舎ものの|けちな
treasonable	反逆の，大逆の，国事犯の
thermosphere	温度圏(温度が高さとともに上昇していく地上80Kmより上部の大気圏)
saxifrage	ユキノシタ(高山植物)
anomalously	異常
dysuria	排尿障害
australopithecus	オーストラロピテクス
transoceanic	大洋横断の|大洋の向こうの
tandoor	a clay oven used in northern India and Pakistan
whelk	エゾバイ(食用の巻き貝)
antrum	骨の空洞|(特に)上あご骨の空洞
svengali	someone (usually maleficent) who tries to persuade or force another person to do his bidding|the musician in a novel by George du Maurier who controls Trilby's singing hypnotically
brittleness	firm but easily broken
immutability	不変[性]
homonym	(文法)同音異義語
derate	lower the rated electrical capability of electrical apparatus
primatology	霊長類学
gundog	銃猟犬(ポインター・セッター犬など)(《米》bird dog)
kowtow	叩頭(こうとう)(昔の中国の礼;ひれ伏して額を地面につける)|(〜に)叩頭の礼をする《+『to』+『名』》|(〜に)ぺこぺこする《+『to』+『名』》
hydroelectricity	水力電気
prideful	横風|横柄|見高|御高い|高飛車|権高|驕傲|頭勝ち|不遜|かさ高|狂喜した
legitimise	法律化|合法化|合法化する
undine	ウンディーネ
criollo	a Spanish American of pure European stock (usually Spanish); "Mexico is a country of mestizos, criollos, and indigenes"|a Spanish American of pure European stock (usually Spanish)|cocoa of superior quality
timorous	(人が)臆病な|気の弱い
reciprocation	お返し|仕返し|交換|往復運動
seminoma	精上皮腫
tribesman	部族の構成員
trichotillomania	抜毛症|抜毛癖
cockeyed	斜視の|やぶにらみの|《俗》ゆがんだ|一方に寄った|《話》ばかな|ばかげた
unionised	非イオンの|非イオン性の|イオン化していない
nonpareil	無比の|無類の|比類のない人(もの)|絶品|6ポイント活字
backstab	（人）を陥れる、害を加える、陰で中傷する
jujube	ナツメ[の実または木]|ナツメ形のゼリー菓子
unspectacular	not spectacular; "an unspectacular but necessary task"|not spectacular
beggarly	こじきのような|見すぼらしい|貧銃な|おそまつな
boysenberry	ボイセンベリー(木イチゴの一種)
urate	a salt of uric acid
nonconformance	a lack of orthodoxy in thoughts or beliefs|failure to conform to accepted standards of behavior
leflunomide	アラバ|レフルノミド
philologist	文献学者|言語学者(研究者)
unhesitatingly	即座に|一も二も無く|てきぱきと
blackmailer	ゆすりを働く者
liquefy	液化する
treacherously	in a disloyal and faithless manner; "he behaved treacherously"; "his wife played him false"|in a disloyal and faithless manner
diastole	心臓拡張[期]|心弛緩(しかん)[期]
ridiculousness	目茶苦茶|不合理|目茶|滅茶苦茶さ|背理|滅茶|悖理|不道理|ばかばかしさ|荒唐無稽さ
kirghizia	キルギスタン|契骨
skittle	《複数形で;単数扱い》九柱戯(ninepins)|〈C〉九柱戯のピン|(クリケットで)〈打者〉‘を'ばたばたとアウトにする
sinequan	a tricyclic antidepressant (trade names Adapin and Sinequan) with numerous side effects (dry mouth and sedation and gastrointestinal disturbances)
aforethought	(名詞の後で)あらかじめ考えた|計画的な|故意の
stonemason	石工
ytterbium	イッテルビウム(希土類元素;化学記号は Yb)
gasohol	ガソホール
cytolytic	of or relating to cytolysis, the dissolution or destruction of a cell
deoxyguanosine	デオキシグアノシン|グアノシン
unbox	remove from a box; "unbox the presents"|remove from a box
synchronism	同期|同調|同時発生|同期性|同時性
concreteness	the quality of being concrete (not abstract)
dishcloth	《米》(またdishrag)皿洗い用ふきん|《英》皿洗いまたは皿ふき用ふきん
schismatic	分裂の(を引き起こす)|宗派分立論者
switcheroo	a sudden unexpected switch
paginate	葉状|給仕
irrelevancy	見当違い|見当違いの言葉|的外れの質問|不適切|無関係
slaty	スレートの|スレート状の
allamanda	a plant of the genus Allamanda having large showy funnel-shaped flowers in terminal cymes
haricot	インゲン豆
sullenly	不機嫌|くよくよ
evilly	in a wicked evil manner; "act wickedly"; "grin evilly"|in a wicked evil manner
breastbone	胸骨
gonadotrophin	性腺刺激ホルモン|ゴナドトロピン
bulldoze	整地する|おどしつける|ごり押しする|ブルドーザーでならす
peaty	泥炭を含む|泥炭に似た
splanchnic	内臓の
clausal	of or relating to or functioning as a clause; "clausal structure"|of or relating to or functioning as a clause
hypothermic	of or relating to or affected by hypothermia
subtropics	亜熱帯地方