hitless	(of a batter) without a hit; "he went hitless for three innings"|(of a batter) without a hit
companionable	人好きのする
kindliness	〈U〉親切さ|思いやり|温情;〈C〉《古》親切な行い|〈U〉《古》(気候などの)温和
diversely	多種多様|千千に|千々に|多様|色色
documentarian	記録担当者
sirenia	ジュゴン目
hypocritically	in a hypocritical manner; "he behaved hypocritically by praying piously when people were watching"|in a hypocritical manner
convulsively	ひこひこ|ぴくっと|ぴくり|ひくひく
melan	メラン|遺伝子名
immunodeficient	免疫不全
laudanum	ローダナム|阿片チンキ(opium tincture)|アヘン末のエタノール浸出液|アヘンのアルカロイド(特にモルヒネ)を含み|歴史的に様々な病気治療|鎮痛|咳止め|今も下痢の治療に使われる
residuum	残留物|残り
significative	示唆的
waul	make high-pitched, whiney noises
decontrol	統制解除|管理撤廃|統制を撤廃する|管理から外す
servility	奴隷状態;奴隷根性;卑屈|屈従
desmodium	beggarweed; tick trefoil|beggarweed|tick trefoil
miscibility	混和しやすいこと|混和性
pylorus	(胃の)幽門
sabayon	ザバイヨーネ
honkytonk	a cheap disreputable nightclub or dance hall
myofibril	筋原繊維
rarefaction	(気体の)希薄化|希薄状態
unendurable	耐えられない
crecy	クレシー
withy	=withe
protozoal	of or relating to the Protozoa
explicitness	clarity as a consequence of being explicit
oxaprozin	オキサプロジン
multilaterally	in a multilateral manner;so as to affect many parties or governments; "they worked out an agreement unilaterally"|in a multilateral manner|so as to affect many parties or governments
interrelatedness	相互関係|相関関係|相関
cassock	司祭平服(丈の長いきっちりした服で通例黒色)
excommunicate	(教会から)〈人〉‘を'破門する
timbale	individual serving of minced e.g. meat or fish in a rich creamy sauce baked in a small pastry mold or timbale shell|small pastry shell for creamy mixtures of minced foods
elicitor	引き出す人
straightjacket	=strait jacket
antirrhinum	=snapdragon
sleepyhead	眠たがり屋・(特に呼びかけで)お寝坊さん
poilu	(第一次大戦中の)フランス兵
disestablishment	the act terminating an established state of affairs; especially ending a connection with the Church of England|the act terminating an established state of affairs|especially ending a connection with the Church of England
hamartoma	過誤腫
megohm	メグオーム|百万オーム(電気抵抗の単位;{略}『meg』)
preponderant	(数量・勢力などにおいて)優勢な|圧倒的な;(〜に)まさっている《+『over+名』》
avowal	公言|言明|公然たる是認
lycee	中等学校
hurdler	ハードル競技選手
pathless	道のない|だれも足を踏み入れたことのない
elodea	蛭藻
epiphyte	着生植物|エアプランツ
witchgrass	North American grass with slender brushy panicles; often a weed on cultivated land|North American grass with slender brushy panicles|often a weed on cultivated land|European grass spreading rapidly by creeping rhizomes; naturalized in North America as a weed|European grass spreading rapidly by creeping rhizomes|naturalized in North America as a weed
nonliteral	比喩的
baldly	ありのまま|あからさまに
asafoetida	the brownish gum resin of various plants; has strong taste and odor; formerly used as an antispasmodic|the brownish gum resin of various plants|has strong taste and odor|formerly used as an antispasmodic
denature	(物質などを)変性させる
prevue	an advertisement consisting of short scenes from a motion picture that will appear in the near future
whitebait	シラウオ;シラス(イワシ・ニシンなどの稚魚)
testate	(法的に)有効な遺言を残した
dustman	=garbage collector
beggarweed	West Indian forage plant cultivated in southern United States as forage and to improve soil
oilskin	〈U〉油布|防水加工生地|〈C〉レインコート;《複数形で》防水服上下
adjustor	清算人
chlorofluorocarbon	クロロフルオロカーボン(CFC)|フロンガス(Freon)
reenactor	a person who enacts a role in an event that occurred earlier
stanch	を止める|の血を止める
gluteal	of or relating to or near the gluteus muscles
roseola	発疹
perspicacity	洞察力|明敏
afterbirth	後産(あとざん)(出産後|胎盤などが出ること)
stridently	in a strident manner; "the cheap clock ticked stridently"|in a strident manner
denudation	削摩
nakedly	裸で|ありのままに
disarrangement	a condition in which an orderly system has been disrupted
undulation	波動|うねり|振動|音波|光波|動悸
rubato	ルバート
valuate	〜‘を'評価する|見積もる
polyarteritis	inflammation of several arteries
oxaloacetate	オキザロ酢酸
highroad	《おもに英》幹線道路|本道(highway)|《比喩(ひゆ)的に》楽な道
fulmar	フルマカモメ(寒い北の海に住む海鳥)
amonte	上流に|の上流
castling	キャスリング
gondolier	ゴンドラの船頭
mezcal	メスカル
ascendency	優越|優勢|優位
veery	ツグミの一種(米国東部産の鳴鳥)
chaconne	シャコンヌ(静かで穏やかな感じのスペインのダンス);その曲
valuator	鑑査員|鑑定家|評価者|鑑定人|鑑定官
aesthetician	a worker skilled in giving beauty treatments (manicures and facials etc.)|a philosopher who specializes in the nature of beauty
manioc	=cassava
thylacine	タスマニア狼|フクロオオカミ
bryophyte	any of numerous plants of the division Bryophyta
nitrosomonas	ellipsoidal soil bacteria
calvaria	頭蓋冠|タツナミソウ
sendoff	(旅・人生の門出などへの)見送り|送別
chintzy	チンツ(更紗)のように派手な|安っぽい|けばけばしい|けちな
sulfacetamide	a topical sulfonamide (trade name Sulamyd) used to treat eye infections
superordinate	目上|上位|上役|優良|上位語|広義語
actinomycosis	放線菌症
approachability	the attribute of being easy to meet or deal with
teratogen	any agent that interferes with normal embryonic development: alcohol or thalidomide or X-rays or rubella are examples
centaury	any of various plants of the genus Centaurium|any plant of the genus Centaurea
tancred	Norman leader in the First Crusade who played an important role in the capture of Jerusalem (1078-1112)
windless	風のない|なぎの
razzmatazz	any exciting and complex play intended to confuse (dazzle) the opponent
sanguinary	流血の|血なまぐさい|《英》口ぎたない
damselfish	small brilliantly colored tropical marine fishes of coral reefs
concessioner	営業権保有者
blotto	酔っぱらった|へべれけの
motherwort	bitter Old World herb of hedgerows and woodland margins having toothed leaves and white or pale pink flowers
aphrodisia	a desire for heterosexual intimacy
noncritical	not critical; not at a point of abrupt change|not critical|not at a point of abrupt change|not in a state of crisis or emergency|marked by disregard for critical standards or procedures; "news sources reflected uncritical estimates of the number of juvenile addicts"|marked by disregard for critical standards or procedures
kopek	コペイカ
gamey	エロい
decompensation	(心臓の)代償不全
thundercloud	雷雲
triumvir	(古代ローマの)三執政官の一人
endometritis	子宮内膜炎
framboise	the common European raspberry; fruit red or orange|the common European raspberry|fruit red or orange
dumbly	in a stupid manner; "he had so rapaciously desired and so obtusely expected to find her alone"|in a stupid manner|in an inarticulate manner; "I nodded dumbly and he slit the envelope"|in an inarticulate manner
spandrel	an approximately triangular surface area between two adjacent arches and the horizontal plane above them
choirmaster	聖歌隊の指揮者
marbleize	〜‘に'大理石模様をつける
inquisitiveness	好奇心
adad	Babylonian god of storms and wind
liposarcoma	脂肪肉腫
fipple	a wooden plug forming a flue pipe (as the mouthpiece of a recorder)
outclass	〜‘の'勝る|‘より'優れた
conceptus	受胎産物 (胎児と胎盤の総称)
ophthalmoplegia	眼筋麻痺
satiation	充満|飽満|飽食|満腹|飽食
actinium	アクチニウム(放射性元素;化学記号Ac)
unidimensional	relating to a single dimension or aspect; having no depth or scope; "a prose statement of fact is unidimensional, its value being measured wholly in terms of its truth"- Mary Sheehan; "a novel with one-dimensional characters"|relating to a single dimension or aspect|having no depth or scope
meprobamate	メプロバメート
bloodworm	赤虫
abscond	(〜から)〈犯人などが〉ひそかに逃亡する|行くえをくらます《+『from』+『名』》
ruddle	代赭(たいしゃ)石|羊に印をつける赤い塗料(代赭石で作る)|〈羊〉‘に'赤い印をつける
gaillardia	テンニンギク|ガイラルジア
slipshod	かかとのつぶれた靴をはいた|だらしのない
euphemistic	婉曲語法の|婉曲な|遠回しな
angioma	血管腫
singable	suitable for singing; "singable melody is the essence of music"- Winthrop Sargeant|suitable for singing
overmuch	過度に|あまりに|過度の
sleekly	in a sleek glossy manner; "the wet road was shining sleekly"|in a sleek glossy manner
centenarian	百才(以上の)人
bearberry	shrubby tree of the Pacific coast of the United States; yields cascara sagrada|shrubby tree of the Pacific coast of the United States|yields cascara sagrada|deciduous shrub of southeastern and central United States|chiefly evergreen subshrubs of northern to Arctic areas
hawala	an underground banking system based on trust whereby money can be made available internationally without actually moving it or leaving a record of the transaction; "terrorists make extensive use of hawala"|an underground banking system based on trust whereby money can be made available internationally without actually moving it or leaving a record of the transaction
nosology	診断学|疾病分類学
sexily	性的に
jaggery	unrefined brown sugar made from palm sap
tappa	the thin fibrous bark of the paper mulberry and Pipturus albidus|a paperlike cloth made in the South Pacific by pounding tapa bark
chinch	bug of temperate regions that infests especially beds and feeds on human blood
cadaverous	死体(死人)のような|青ざめてやせこけた
anthemis	アンセミス
mandelstam	マンデリシュタム
levelheaded	良識ある|分別ある|冷静な
thymol	チモール
hoofprint	馬決り|馬決|ひづめの跡
terabit	テルビウム
capoten	カプトプリル
cognisant	(sometimes followed by `of') having or showing knowledge or understanding or realization or perception; "was aware of his opponent's hostility"; "became aware of her surroundings"; "aware that he had exceeded the speed limit"|having or showing knowledge or understanding or realization or perception
transformable	翻訳可能|形質転換性
irritatingly	in an irritating manner
whin	ハリエニシダ
echinococcus	エキノコックス
philia	好き|温かさ|慈しみ|愛情のこもったこと|温か味|慈|愛情|愛|優しいこと|暖か味
boardinghouse	寄宿舎|下宿|下宿屋|合宿|合宿所
greediness	どん欲|がつがつしていること
southeastward	南東へ(に)|南東の|南東へ向かう|南東;南東部
psittacosis	おうむ病(高熱を出す)
maund	a unit of weight used in Asia; has different values in different countries; "the official maund in India is 82.6 pounds avoirdupois"|a unit of weight used in Asia|has different values in different countries
oenophile	someone who appreciates wine
grazier	a rancher who grazes cattle or sheep for market
rebelliousness	反抗
sulfurous	辛辣|痛烈|苛辣|息苦しい
preferment	(稀に教会などで)昇進|登用
lubber	(体の大きな)ぶこつ者|無器用者|未熟な水夫
scabby	かさぶたのある
fakery	にせ物[作り]|いかさま[行為]
propylthiouracil	プロピルチオウラシル
lunda	puffins
unequipped	without necessary physical or intellectual equipment; "guerrillas unequipped for a pitched battle"; "unequipped for jobs in a modern technological society"|without necessary physical or intellectual equipment
fermata	フェルマータ|フェルマータ
orangery	オレンジ栽培畑(温室)
uproariously	騒々しく|やかましく|どっと(笑うなど)
abstractness	the quality of being considered apart from a specific instance or object
harmonizer	a musician who sings or plays in harmony|a mediator who brings one thing into harmonious agreement with another
rehydrated	再水和
agriculturalist	農業経営者;農業専門家
cochineal	コチニール(サボテンに寄生するコチニールカイガラムシの雌から採る赤色色素;食物・インクの着色用)
ninjitsu	the traditional Japanese method of espionage; involves stealthy movements and the use of camouflage|the traditional Japanese method of espionage|involves stealthy movements and the use of camouflage
crassula	フチベニベンケイ
unsworn	not bound by or stated on oath; "the witness stands unsworn"; "unsworn testimony"|not bound by or stated on oath
anaxagoras	a presocratic Athenian philosopher who maintained that everything is composed of very small particles that were arranged by some eternal intelligence (500-428 BC)
usurious	高利の|高利を取る
planchet	a flat metal disk ready for stamping as a coin
stochasticity	でたらめさ|出たら目さ|出鱈目さ
presentiment	(〜の)(悪い)予感|胸騷ぎ《+『that節』》
godparent	名付け親(生まれた子の洗礼式に立ち会って名前を与える人)
sturdily	たくましく;がんじょうに;がん強に
governmentally	by government; "governmentally determined policy"|by government
cyclopean	of or relating to or resembling the Cyclops; "Cyclopean eye"|of or relating to or resembling the Cyclops
astatic	not static or stable
parthenogenesis	単為生殖
censorious	厳しく詮索する|あら探ししたがる|非難を表わす
hypoglossal	舌下神経
malodorous	悪臭のひどい|(社会的に)受け入れがたい
noontide	=noon 1
avirulent	無毒の
salutatorian	(高校・大学で)卒業式で開会のあいさつをする次席優等生
argillite	粘土鉱物
sickroom	病室
riffraff	(社会の)下層民|下層階級|くだらない(卑しい)連中|人間のくず|ろくでなし
semisolid	partly solid; having a rigidity and viscosity intermediate between a solid and a liquid; "a semisolid mixture"|partly solid|having a rigidity and viscosity intermediate between a solid and a liquid
florilegium	詞華集
basotho	a member of a subgroup of people who inhabit Lesotho
brownout	(節電などによる)消灯　電灯制限　電圧低下
acclimatisation	馴化|気候順化
salsify	バラモンジン(紫色の花をつける;根は食用)
weatherboard	(また weather boarding)《英》=clapboard
kildeer	フタオビチドリ
possessiveness	欲情
notturno	ノクターン|夜想曲|夜曲
custodianship	管財
sociologically	with regard to sociology; "sociologically speaking, this is an interesting phenomenon"|with regard to sociology
reappraise	再評価
nekton	遊泳動物
kneeler	a person in a kneeling position|a board (sometimes cushioned) for someone to kneel on
nominalism	唯名論
agaric	fungus used in the preparation of punk for fuses|a saprophytic fungus of the order Agaricales having an umbrellalike cap with gills on the underside
dactylorhiza	genus of terrestrial orchids of Europe and Asia and North Africa
kirgizstan	キルギスタン|契骨
cornflour	=cornstarch
podocarpus	犬槙
micrococcus	type genus of the family Micrococcaceae
sweetbread	(特に子牛・子羊の)すい臓|胸線(食用)
desirably	望ましい形で(やり方で)|願わしいことに
sericulture	養蚕|蚕業
lyonnaise	リヨン風の(刻みタマネギを入れて料理したものについていう)
fruitlessly	損
unbeknown	(〜に)知られない《+to+名》|(〜に)知られずに《+to+名》
photoplay	劇映画
piggery	《おもに英》=pigsty
callboy	(俳優の出番を告げる)呼び出し係
makespan	メイクスパン(開始時と終了時の時間差や進捗度などの意)
bonsoir	こんばんは(good evening)
homogenize	均質化する
dextrin	デクストリン|糊精(こせい)(印刷用インク・水あめなどの粘着剤)
overbid	競る
cuirass	胴よろい;よろいの胸当て
crepuscular	《文》たそがれ時の|薄明の|(動物が)薄明活動性の(たそがれ時に動き回る習性)
aphasic	失語症患者|失語症の|失語症にかかっている
exoteric	suitable for the general public; "writings of an exoteric nature"|suitable for the general public
phocoena	porpoises
tetragrammaton	four Hebrew letters usually transliterated as YHWH (Yahweh) or JHVH (Jehovah) signifying the Hebrew name for God which the Jews regarded as too holy to pronounce
unrewarding	だめ
pinkeye	はやり目|伝染性結膜炎
kindhearted	心優しい|情け深い
crossbeam	(建物の)横はり|横げた
arachis	a genus of plants with pods that ripen underground (see peanut)
enthronement	即位式
sawhorse	(X字型の)木びき台
hireling	でくの坊
overweening	うぬぼれた|思い上がった|ごう慢な
spirally	with spirals; "spirally fluted handles"|with spirals
protology	the study of origins and first things; "To Christians, protology refers to God's fundamental purpose for humanity"|the study of origins and first things
pangloss	an incurable optimist in a satire by Voltaire
beatify	幸福にする
stannous	錫(すず)の(を含む)|(特に)第一錫の|2価の錫を含む
preterite	a term formerly used to refer to the simple past tense
electrophoresed	泳動
odontology	歯科学
compartmentalize	を区切る
predetermine	を予定する|を運命づける
lygus	plant-sucking bugs
abruptness	素っ気なさ|不愛嬌|不愛想|不愛敬|ぶっきらぼう|無愛敬|ぶっきら棒|素っ気無さ|無愛嬌|無愛想
defrock	=unfrock
unhealthful	不衛生|不健全|不健全
poult	(七面鳥・鶏などの)ひな
cosign	sign jointly; "Husband and wife co-signed the lease"|sign jointly|sign and endorse (another person's signature), as for a loan|sign and endorse (another person's signature) , as for a loan
maladroit	無器用な
beatable	susceptible to being defeated
formalistic	concerned with or characterized by rigorous adherence to recognized forms (especially in religion or art); "highly formalized plays like `Waiting for Godot'"|concerned with or characterized by rigorous adherence to recognized forms (especially in religion or art)
archenemy	大敵|宿敵
tripeptide	トリペプチド(アミノ酸の元としてタンパク質proteinを作る) cf|peptide
scaling	scaling拡大縮小|スケーリング|皮むき|歯石除去|鱗落し
adventurism	(政治･外交面での)冒険主義
flibbertigibbet	軽薄な人;おしゃべり女|浮気女・おしゃべりで軽薄な人
fairlead	a pulley-block used to guide a rope forming part of a ship's rigging to avoid chafing
tachograph	タコグラフ
epimetheus	(Greek mythology) brother of Prometheus; despite Prometheus's warning against gifts from Zeus he accepted Pandora as his wife|brother of Prometheus|despite Prometheus's warning against gifts from Zeus he accepted Pandora as his wife
micturition	排尿(=voiding)
regicide	国王殺し|大逆罪
allusive	暗示的な
ajuga	キランソウ属
lymphokine	a cytokine secreted by helper T cells in response to stimulation by antigens and that acts on other cells of the immune system (as by activating macrophages)
bandmaster	(楽隊の)楽長|指揮者
gawky	ぶざまな
lobule	小葉;小裂片
monetarist	マネタリスト
chiasmus	inversion in the second of two parallel phrases
mainsheet	(nautical) a line (rope or chain) that regulates the angle at which a sail is set in relation to the wind|a line (rope or chain) that regulates the angle at which a sail is set in relation to the wind
recuperative	回復に役立つ|元気づける|回復力のある
androgenetic	of or related to androgenesis
miniver	ミニバー(貴族の礼服に用いられる白い毛皮)
indecently	じゃらくら
touchingly	感動的
interminably	果てしなく
doctrinally	教義的に
noncommunicable	(of disease) not capable of being passed on
crinkly	しわの寄った;(頭髪が)巻き毛の|縮れた
muskeg	北米北部の沼沢地帯
steroidogenic	ステロイド産の|ステロイド製の
industriously	こまめ
confusedly	in a confused manner; "Queen Augusta wrote him an hysterical letter in which she confusedly sympathised with him"|in a confused manner
nosepiece	鼻革
nebuliser	噴霧器|スプレー
headcheese	ヘッドチーズ(豚肉を加工した食品)(《英》drawn)
shlock	merchandise that is shoddy or inferior
hangnail	(指の)ささくれ|逆むけ
toter	軽子|脚夫|輸送業者|運搬人|運送人
orangewood	fine-grained wood of an orange tree; used in fine woodwork|fine-grained wood of an orange tree|used in fine woodwork
malignity	〈U〉〈C〉悪意|敵意|恨み|〈U〉(病気の)悪性
usurer	高利貸し
serratus	鋸筋
jehad	ジハード|ジハード
sashay	すべるように(軽々と)動く(進む)|さっさと歩く
crouton	(仏語)クルトン(スープに浮かす揚げパンの小片)
loxodonta	a genus of Elephantidae
blackcap	黒帽(もと死刑宣告時に裁判官が着用した)
halloo	=hallo
houseboy	屋敷やホテルのボーイ(雑役夫)
cicatrix	瘢痕(はんこん)(傷を修復して再生した新しい組織)
pasturage	牧草|牧草地;牧畜業
stemless	not having a stem; "stemless glassware"|not having a stem|(of plants) having no apparent stem above ground
bawd	売春宿のおかみ|売春婦
monied	=moneyed
perfusate	(医)潅流液
granisetron	グラニセトロン|嘔吐を抑制する制吐薬の一種
ocher	(óukər)|オークル(黄土色)|(俗)金(かね)|金貨
tideland	land near the sea that is overflowed by the tide
gofer	給仕
blastomycosis	ブラストミセス症
variegation	(特に植物の)多彩な色合い|雑色|まだら
sensationally	in a sensational manner; "in the summer of 1958 the pianist had a sensationally triumphant return"|in a sensational manner
adjudge	〈人〉‘に'判決を下す|宣告する|(法律・審査で)(人に)〜'を'与える《+『名』+『to』+『名』〈人〉》(award)|《『adjudge』+『名』[+『to be』]+『形』(『名』)〈補〉》(〜と)〜'を'考える|見なす
pharmaceutic	drug or medicine that is prepared or dispensed in pharmacies and used in medical treatment|of or relating to pharmacy or pharmacists; "the pharmaceutical industry"|of or relating to pharmacy or pharmacists
zostera	(or in some classifications family Zosteraceae) small genus of widely distributed marine plants|small genus of widely distributed marine plants
dactyl	(古典詩の韻律で)長短短格(‐);(英詩の)強弱弱格(‐‐‐)
mucoid	any of several glycoproteins similar to mucin|relating to or resembling mucus; "a mucoid substance"|relating to or resembling mucus
sturnus	type genus of the Sturnidae: common starlings
interchurch	occurring between or among or common to different churches or denominations; "interchurch aid"; "interdenominational cooperation between Methodists and Presbyterians"|occurring between or among or common to different churches or denominations
shakiness	震え|揺れ|動揺|不安定
leftwards	《おもに英》=leftward
mirthful	楽しい|愉快な|陽気な(merry)
coeval	同年齢の|同年代の
trochanter	one of the bony prominences developed near the upper extremity of the femur to which muscles are attached
discreteness	別個|別別|分離性|別々|別箇
trypsinogen	トリプシノーゲン
galvanometer	(微少電流の)検流計
tanacetum	a large genus of plants resembling chrysanthemums; comprises some plants often included in other genera especially genus Chrysanthemum|a large genus of plants resembling chrysanthemums|comprises some plants often included in other genera especially genus Chrysanthemum
glasswork	ギヤマン
anthropoid	人間に似た|類人猿
blowgun	吹き矢筒
pilfer	(こそこそ)盗む|(名詞はpilferage)
klaxon	クラクション(自動車の警笛)[の音]
vouvray	a dry white French wine (either still or sparkling) made in the Loire valley
graceless	無作法な
unlikable	(of characters in literature or drama) tending to evoke antipathetic feelings; "all the characters were peculiarly unsympathetic"|(of characters in literature or drama) tending to evoke antipathetic feelings|difficult or impossible to like; "a disagreeable and unlikable old woman"|difficult or impossible to like
logging	伐木搬出
distressingly	ひどく|苦痛なほど
nonporous	非多孔性
forcemeat	フォースミート(詰め物料理などに用いる味付けひき肉)
lexicographical	of or relating to lexicography
urbanite	都市居住者|都会人
spectinomycin	スペクチノマイシン
slouchy	lacking stiffness in form or posture; "a slouchy sweater"|lacking stiffness in form or posture
adman	advertising man|広告係
acanthosis	表皮肥厚
saltpeter	硝石(肥料や爆発物として用いられる)|Chile saltpeterチリ硝石
adrenocorticotropic	副腎皮質刺激
accretionary	marked or produced by accretion
chinwag	気楽な会話|おしゃべり
cellularity	細胞性
armillaria	genus of edible mushrooms having white spores an annulus and blue juice; some are edible; some cause root rot|genus of edible mushrooms having white spores an annulus and blue juice|some are edible|some cause root rot
creepiness	はい回る(のろのろ動く)こと|ぞくぞくすること|身震い
gambusia	mosquitofish
falseness	うそ|嘘|虚偽|嘘偽|嘘偽り|偽|虚|虚妄|虚偽|気まぐれ|不誠実|がらんどう|虚偽|不誠意|不誠実
origanum	any of various fragrant aromatic herbs of the genus Origanum used as seasonings
betimes	おそくならないうちに|折よく|《古》ただちに
spikenard	〈C〉カンショウ(甘松)(根から香料をとる芳香のある植物);〈U〉(その根からとった)甘松香|〈C〉(北米産の)ウド
renascence	=renaissance
consonantal	子音の|子音の特徴のある
fifthly	in the fifth place; "fifthly, we must adhere to the rules set by the local government"|in the fifth place
huggin	ハギング|(inviting cuddling or hugging|寄り添い|あるいは抱擁を促す)
incommensurable	同じ規準(尺度)で比較できない;(〜と)比べ物にならない《+『with』+『名』》
deglutition	飲み込むこと|呑|飲|飲み|嚥下|飲み込み|呑み
nonpolitical	非政治的な
nincompoop	とんま|ばか者|つまらない人
wilmut	イアンウィルマット
spidery	くものような|くもの巣の
footpad	追いはぎ
pachisi	an ancient board game resembling backgammon; played on a cross-shaped board|an ancient board game resembling backgammon|played on a cross-shaped board
exoticism	異国情緒|異国ふう|外来語法
dramatise	修飾|扮飾|粉飾|潤色|脚色
hypochondriasis	憂欝症|心気症|ヒポコンデリー
columella	a small column (or structure resembling a column) that is a part of a plant or animal
assaultive	disposed to attack
anamnesis	既往症|病歴|物覚|もの覚え|物おぼえ|記憶力|覚|覚え|物覚え|憶え|憶
implausibly	信じられないほど
dogmatics	(特にキリスト教の)教義学|教理学
twitter	くすくす笑う|さえずる|ピーチク|パーチク|小鳥の鳴き声
halm	stems of beans and peas and potatoes and grasses collectively as used for thatching and bedding
angiosarcoma	血管肉腫
nuzzle	愛撫する|鼻で掘る|鼻を押しつける|すり寄る|気持ちよく横になる
irreverently	不敬|不敬
benefaction	〈U〉慈善|寄進|寄金|〈C〉寄付金[額]
prehensile	巻き付きやすい
freewheeler	自由人
lutjanus	type genus of the Lutjanidae: snappers
revengeful	復讐(ふくしゅう)心に燃えている;復讐の|仕返しの
trinomial	三項[式]の|三項式
suppliant	嘆願者|懇願者|嘆願する|懇願する
pancytopenia	汎血球減少
monotonously	ぽくぽく
benignly	in a benign manner; "this drug is benignly soporific"|in a benign manner
radioman	無線技師
bedpan	湯たんぽ
phenolphthalein	フェノールフタレイン
gratefulness	warm friendly feelings of gratitude
lavaliere	ラバリエール(宝石をちりばめたペンダント)
eryngium	large genus of decorative plants with thistlelike flower heads; cosmopolitan in distribution|large genus of decorative plants with thistlelike flower heads|cosmopolitan in distribution
venule	小静脈|細静脈
involute	うず巻状の|らせん状の|入り組んだ|複雑な
scabrous	ざらざらした|でこぼこの|わいせつな|きわどい
inexpedient	得策でない|不適当な|不便な
uncreative	not creative; "an uncreative imagination"|not creative
pimply	にきびのできた|吹き出物だらけの|にきびだらけの
suffragan	属司教|属主教|副監督
oceanology	海洋学|海洋研究
disorganisation	a condition in which an orderly system has been disrupted|the disturbance of a systematic arrangement causing disorder and confusion; "the disorganization of the enemy troops by a flank attack"|the disturbance of a systematic arrangement causing disorder and confusion
untutored	訓練(教育)を受けていない
baptistry	bowl for baptismal water
pureness	純一無雑|単純|生一本|無雑|生粋|精粋|清浄|潔白|純潔
enshroud	〜‘を'覆い隠す|包んで見えなくする
genu	膝小僧|膝車|ニー|膝関節|膝口|膝|膝坊主
hypocenter	(地震・核爆発の地下の)震源地
overlie	〈覆い・地層などが〉〜‘の'上に横たわる(重なる)
differentia	(論理学で)種差(ある種が同じ属の他の種と区別される属性);本質的な相違点
uninfluenced	左右されていない|心を動かされない|影響されない
questionably	不審
jape	ふざける|からかう|からかい|いたずら
guesser	a person who guesses
hatful	多量|許多|山積み|百千|山盛り|あまた|数多|洪水|万斛
primaquine	プリマキン
breastpin	ブローチ|胸飾り
hyperon	ハイペロン
teletypewriter	テレタイプライター|印刷電信機(電信を送受信するタイプライター式の機械)
homonymous	of or related to or being homonyms
leathern	皮のような|皮製の
bract	(植物の)ほう(苞)
necrolysis	表皮壊死症
commandery	the position or office of commander
verticality	垂直
intelligibly	分かりやすく・明りょうに
teredo	フナクイムシ
enzootic	of a disease that is constantly present in an animal community but only occurs in a small number of cases
garfish	primitive predaceous North American fish covered with hard scales and having long jaws with needlelike teeth
craftily	ずるく|悪がしこく
purdah	(特にイスラム教国で)婦人を人目に触れぬようにする慣習
antipodal	対蹠(たいせき)地の(地球の正反対側にあることをいう)
finagle	いんちきする|ごまかす
epha	an ancient Hebrew unit of dry measure equal to about a bushel
hymnody	賛美歌の吟唱(作曲)|《集合的に》賛美歌|聖歌
inhabitable	住む(居る)ことができる|住むのに適した
servomotor	サーボモーター(サーボ機構の一部)
viviparous	(動物が)胎性の
extravehicular	(宇宙船飛行士によって)宇宙船外で行われる|宇宙船外の
syzygium	a tropical evergreen tree of the myrtle family native to the East Indies but cultivated elsewhere
fugal	of or relating to or in the style of a musical fugue
charbroil	〈食物〉'を'炭火で焼く|炭火で焼く
centerboard	a retractable fin keel used on sailboats to prevent drifting to leeward
musketry	小銃射撃;射撃術
myosotis	forget-me-nots; scorpion grass|forget-me-nots|scorpion grass
cercis	ハナズオウ
destabilisation	不安定化
caleche	a woman's large folded hooped hood; worn in the 18th century|a woman's large folded hooped hood|worn in the 18th century|the folding hood of a horse-drawn carriage
gaine	飾り台座
hosier	靴下・下着商|メリヤス商
agropyron	カモジグサ属
counterrevolution	反革命
measurability	the quality of being measurable
polybutylene	ポリブチレン
mesmerism	催眠術(hypnotism)
catling	仔猫
gurnard	ホウボウ|魴鮄
carrack	a large galleon sailed in the Mediterranean as a merchantman
prancer	a mettlesome or fiery horse
astrocytic	アストロサイト
leaving	(複数で)残り物|くず
clinometer	測斜器|傾斜計
brummie	a native or resident of Birmingham, England
selectee	(義務兵役による)応召兵　選抜徴兵応召者
hydrocele	disorder in which serous fluid accumulates in a body sac (especially in the scrotum)
mucopolysaccharidosis	any of a group of genetic disorders involving a defect in the metabolism of mucopolysaccharides resulting in greater than normal levels of mucopolysaccharides in tissues
meanly	卑しく;みすぼらしく|意地悪く|つれなく|けちに
thalictrum	widely distributed genus of perennial herbs: meadow rue
flattener	平らにする人(物)|打ち倒す人
caladium	カラジウム|ハニシキ(熱帯アメリカ産の観賞植物)
submissiveness	服従
disinterestedness	freedom from bias or from selfish motives
ovenbird	カマドムシクイ
boulle	ブール
rachet	爪車
endodontist	歯内療法専門医
ideational	観念的|概念的
subtend	(幾何で)〈弦・三角形の辺が〉〈弧・角〉‘に'対する|向かい合う
expectoration	喀痰
reformism	改良主義
chloropicrin	a heavy colorless insoluble liquid compound that causes tears and vomiting; used as a pesticide and as tear gas|a heavy colorless insoluble liquid compound that causes tears and vomiting|used as a pesticide and as tear gas
interschool	used of competition or cooperation between secondary schools
bushbuck	antelope with white markings like a harness and twisted horns
spinous	having spines; "the dorsal fin is spinous"|having spines|shaped like a spine or thorn
sunup	有り明け方|有明け方|夜明け|彼誰|明けがた|有明|日出|払暁|白白明け|暁天
pantheistic	汎神論の|自然崇拝の
epaulette	肩章|エポレット
tubercular	結節のある|結節状の|(また tuberculous)結核の|結核性の
bronchiole	気管支梢|細気管支
symphysis	an abnormal adhesion of two or more structures|a growing together of parts or structures
hostler	(昔|宿屋で客の馬の世話をした)馬丁
cuneate	(of a leaf shape) narrowly triangular, wider at the apex and tapering toward the base
unsurpassable	not to be exceeded; "unsurpassable skill"; "unsurpassable standards of workmanship"|not to be exceeded
hyperemesis	悪阻
hubel	ヒューベル
cumber	(〜で)〈人〉'を'じゃまする|‘に'負担をかける《+『名』+『with』+『名』》
quartette	カルテット|四重|４人組|四重奏
doddle	容易に(簡単に)できること
usnea	サルオガセ
deducible	演繹可能な
irredeemable	救いようのない|買い戻しのできない
degauss	〈船体・車体など〉‘の'磁場を消す|'を'消磁する
glop	(ごた混ぜの)どろりとしたもの
deictic	a word specifying identity or spatial or temporal location from the perspective of a speaker or hearer in the context in which the communication occurs; "words that introduce particulars of the speaker's and hearer's shared cognitive field into the message"- R.Rommetveit|a word specifying identity or spatial or temporal location from the perspective of a speaker or hearer in the context in which the communication occurs|relating to or characteristic of a word whose reference depends on the circumstances of its use; "deictic pronouns"|relating to or characteristic of a word whose reference depends on the circumstances of its use
psychokinetic	moving an object without apparent use of physical means
gumboots	ゴム長靴
brusquely	ずけずけ|けんけん|すっからかん
aetiological	病因的|病原学的|病因的|病原学的
stigmatisation	the act of stigmatizing
unsynchronized	非同期の
scandalously	in a scandalous manner; "you behaved scandalously when you walked out of that meeting!"|in a scandalous manner
slickly	滑らかに
misfeasance	(法律用語で)不法行為
sirup	=syrup
shelduck	female sheldrake
expedience	便宜|オポテュニズム|気侭|ご都合主義|オポチュニズム|気儘|私意|我慾|我がまま|我侭|主我主義
presidentially	in a presidential manner
meteoroid	流星体(大気圏にはいる前に|宇宙にある間の流星)
reproachfully	恨めし気に
wineskin	ぶどう酒用の皮袋(ヤギ1頭分を縫い合わせて作る)
codpiece	15・16世紀の男性用のぴったりしたズボンの股のふくらみをおおう飾り布
roulade	a dish consisting of a slice of meat that is rolled around a filling and cooked|(music) an elaborate run of several notes sung to one syllable|an elaborate run of several notes sung to one syllable
futilely	in a futile and unproductive manner
prefigure	の形を前もって示す|あらかじめ示す|予想する
garble	(故意に事実など)を歪める|(知らずに)取り違える
unshaded	(of pictures) not having shadow represented; "unshaded drawings resembling cartoons"|(of pictures) not having shadow represented|not darkened or dimmed by shade; "an unshaded meadow"; "a bright and unshaded lane"|not darkened or dimmed by shade
threadfin	mullet-like tropical marine fishes having pectoral fins with long threadlike rays
offensiveness	the quality of being offensive
antedate	〜'を'実際よりも早い日付にする|〜‘より'早い時期に起こる
practicably	実行可能に|実用的に
osteodystrophy	骨形成異常
hygienically	衛生的に|衛生上
conodont	the tiny fossil cone-shaped tooth of a primitive vertebrate of order Conodonta|small (2 inches long) extinct eellike fish with a finned tail and a notochord and having cone-shaped teeth containing cellular bone; late Cambrian to late Triassic; possible predecessor of the cyclostomes|small (2 inches long) extinct eellike fish with a finned tail and a notochord and having cone-shaped teeth containing cellular bone|late Cambrian to late Triassic|possible predecessor of the cyclostomes
hoodwink	目をくらます|だます|ごまかす
lour	=lower
sise	六|６|６つ|半ダース|六つ|陸
propanediol	プロパンジオール|プロピレングリコール
hourlong	lasting for an hour; "an hourlong examination"|lasting for an hour
nightstick	(米語)警棒
dumbstruck	ぽかんと|吃驚仰天
undersize	smaller than normal for its kind
delusive	人を惑わせる|紛らわしい
sepulchral	墓の|埋葬の|陰鬱な
fantast	未来派
protriptyline	tricyclic antidepressant used to treat clinical depression
frier	=fryer
bedpost	(ベッドの四すみにある)寝台の柱
complexly	複雑
groundmass	石基
fourscore	80の(eighty)
specialness	習性|特有性|気質|特異性|特色|固有性|特徴|お株|徴表|特殊性|特殊性
portulaca	スベリヒユ(マツバボタンなどを含む植物)
purulency	化膿
misdeed	悪い行い|悪行|犯罪
auspice	幸先
dubbin	皮革用油脂合剤(皮の仕上げに用いる)|〈皮革製品〉‘に'油脂合剤を塗る
proctitis	直腸炎
redtail	アカオノスリ
mawkish	甘くて鼻につくような(味の)|吐き気を催すような
thioguanine	チオグアニン
saltiness	しょっぱさ|鹹味|塩分|塩気|塩
diathesis	素因
blepharospasm	眼瞼痙攣
millibar	ミリバール(気圧の単位;1000分の1バール)
postulation	願文|建白|建白書|願状|申し文|訴状|嘆願書|申状|訴願|請願
deceitfully	in a corrupt and deceitful manner; "he acted dishonestly when he gave the contract to his best friend"|in a corrupt and deceitful manner
shortgrass	any of various grasses that are short and can tolerate drought conditions; common on the dry upland plains just east of the Rocky Mountains|any of various grasses that are short and can tolerate drought conditions|common on the dry upland plains just east of the Rocky Mountains
unrewarded	手ぶら
immunolocalization	免疫学的局在決定
donatus	ドナトゥス
graininess	the quality of being composed of relatively large particles
xyy	(genetics) abnormal complement of sex hormones in a male who has two Y chromosomes|abnormal complement of sex hormones in a male who has two Y chromosomes
balloonist	気球
hematologist	血液学者
disgracefully	恥曝し
rambutan	ランブータン|ランブータン
married	結婚の|夫･妻のある|結婚して|夫婦間の|既婚の|(関係が)密接な|献身的な
psychokinesis	念力[による物体の移動]
grison	carnivore of Central America and South America resembling a weasel with a greyish-white back and dark underparts
oken	オーケン
spectrographic	relating to or employing a spectrograph
sadomasochistic	of or relating to sadomasochism; "sadomasochistic sexual practices"|of or relating to sadomasochism
lamentably	嘆かわしく
propagandize	布教|布教
univalent	一価の|(a univalent chromosome一価染色体|1価の酸は1分子中に放出できる水素イオンHを1個持ち|1価の塩基は水酸化イオンOH-を1個持つ)
asexually	無性生殖的
purgative	下剤|下剤の
flatwork	ironing that can be done mechanically
countermand	〈命令・注文など〉'を'取り消す|(命令・注文などの)取消し
hogweed	ハナウド
autostrada	イタリアの高速道路
misfolded	ミスフォールド|(タンパク質が)誤って折り畳まれた
braggart	ほら吹き|自慢(話)|ワラビ|蕨の茂み
mesophilic	(生科学)中等温度好性の(中温が好適な温度環境である性質)|中温性の
cordierite	菫青石
felicitation	祝賀|祝辞
earthshaking	世界をゆるがす|非常に重要な
indisposition	気分がすぐれないこと|少し加減の悪いこと|(〜に)気が進まないこと《+『for』+『名』(do『ing』)》;(〜する)気がしないこと《+『to』 do》
forlornly	侘しく|(forlornの副詞形)
hinderance	妨|妨げ|足手纏|差し合い|害|差し障り|妨害|邪魔立て|手足まとい|さし支え|荷厄介|足手まとい|足手纏|妨害|邪魔立て|手足まとい|足手まとい|手足纏い|障碍|足纏い|足まとい|障害
arsine	アルシン
zill	ジル
shammy	=chamois　シャモア　灰色がかった黄色　シャミー　セーム革
amphipoda	端脚類
nutriment	〈U〉〈C〉営養分|養分;食物(food)
swinge	〜‘を'むち打つ|罰する
pupate	〈幼虫が〉さなぎになる
boneheaded	おたんちん|おたんこなす
healthiness	健康であること|健全さ
unkindness	不親切|不人情|無情
flatulent	腹にガスのたまった|大げさな|誇張した
construal	an interpretation of the meaning of something; the act of construing|an interpretation of the meaning of something|the act of construing
pinche	South American tamarin with a tufted head
sensationalistic	typical of tabloids; "sensational journalistic reportage of the scandal"; "yellow press"|typical of tabloids
salvific	pertaining to the power of salvation or redemption
undermanned	(船が)通常の人員を欠いている|(職場などに)人手が足りない|要員不足の
cyclopaedia	百科|百科辞書|百科全書|エンサイクロペディア|百科事典|百科辞典
hyoid	舌骨
gastroduodenal	胃十二指腸
exudation	滲出物|分泌物|浸出|浸出物
translocate	転居する
chlorothiazide	クロロチアジド
rascally	playful in an appealingly bold way; "a roguish grin"|playful in an appealingly bold way|lacking principles or scruples; "the rascally rabble"; "the tyranny of a scoundrelly aristocracy" - W.M. Thackaray; "the captain was set adrift by his roguish crew"|lacking principles or scruples
defenestration	窓外放出
sulfisoxazole	スルフイソキサゾール
negativism	否定論|懐疑論
strumpet	姦婦
genuflect	(礼拝のため)片ひざを曲げる|卑屈に追従する
mysoline	プリミドン
yastrzemski	ヤストレムスキー
venality	金銭ずくで動くこと|金で自由になること
uncross	〈両腕・両足〉の交差を解く
systematization	ラショナリゼーション|合理化|組織化
precariousness	不確定度|疑惑|危なさ|懐疑|怪訝|心許無さ|不確実さ|不明|半信半疑|不確実
myrmidon	(王の)家来|忠僕;手先|子分
unreconstructed	自説を曲げない|変革に抵抗する
electrometer	電位計
motoneuron	運動ニューロン
dysphonia	発声障害
ratable	liable to payment of locally assessed property taxes; "the ratable value of property"|liable to payment of locally assessed property taxes
agnosia	失認
cyclicity	循環性|周期性
metrication	メートル法換算
twofer	(劇場の入場券が1枚で2人分買える)割引クーポン券
lithographer	石版画家
commissure	a bundle of nerve fibers passing from one side to the other of the brain or spinal cord
vileness	卑陋|曲事|悪行|曲悪|醜悪|悪事|邪悪|横様|兇|悪質
clostridia	クロストリジウム|クロストリジウム属
dehumanize	から人間性を奪う|機械的な存在にする|非人間化する|非人間的にする
rubeola	はしか|麻疹
celosia	annual or perennial herbs or vines of tropical and subtropical America and Asia and Africa
winker	指示器|目隠し|指示器
taxonomically	with regard to taxonomy; "closely related taxonomically"|with regard to taxonomy
whipping	笞刑|鞭打ち|むち打ち|スマート
cupidity	(特に富に対する)どん欲|強欲
electrosurgery	surgery performed with electrical devices (as in electrocautery)
intraspecies	種内
frivolously	in a frivolous manner; "she spends her time frivolously enjoying the easy life of a rich and spoiled girl"|in a frivolous manner
limbus	a border or edge of any of various body parts distinguished by color or structure
rising	のぼりつつある|立ち上る|騰貴する|昇進する
heatedly	ひりひり
serialisation	連載
egomaniac	極端な自尊家|極端に自己中心的な人|病的な自己中心者
fervid	(しつこいほど)熱烈な|燃えるような
quiddity	あげ足とり|あげ足とり
tonometry	the measurement of intraocular pressure by determining the amount of force needed to make a slight indentation in the cornea
truculent	痛烈な|野蛮な|凶暴な|喧嘩腰の
wollastonite	a white or greyish mineral typically found in metamorphic limestone; a silicate of calcium|a white or greyish mineral typically found in metamorphic limestone|a silicate of calcium
quadruplex	having four units or components; "quadruple rhythm has four beats per measure"; "quadruplex wire"|having four units or components
illimitable	無限の|限りのない
immunoperoxidase	(酵素抗体法)|免疫ペルオキシダーゼ法
supervene	続いて起こる|付随して起こる|〜‘に'続いて起こる|付随して起こる
gayly	いそいそ|楽しく|陽気に
siderophore	シデロフォア|微生物が作る|鉄を含むか鉄と結合した有機化合物|鉄イオン(Fe3+)と親和性があり|鉄の可溶化や輸送に働く|腸内細菌|土壌細菌|真菌|藻類に広く分布
saltbox	木造建築の一様式;正面が2階で裏面は屋根が傾斜して1階になっている
parboil	〈肉・野菜など〉'を'さっとゆでる|さっと湯を通す|《まれ》〈部屋など〉'を'熱くしすぎる|〈人〉'を'ひどく暑がられる
serration	鋸歯
urging	勧説|策励|鞭撻|ご鞭撻|奨励|勧奨|御鞭撻
cigarillo	細い葉巻
nonparticipant	a person who does not participate
sarasate	パブロ･サラサーテPablo M|Sarasate|1844年生|スペインの作曲家|代表作はジプシー(ロマ)の民謡による「ツィゴイネルワイゼン」
impetuosity	猛烈さ;〈C〉性急な行動
encomium	ほめ言葉|賛辞
hypervariable	超可変
duple	(音楽が)2拍子の|偶数拍子の
bluejacket	水兵
aztreonam	アズトレオナム
tetrode	a thermionic tube having four electrodes
tamarix	タマリクス
fusilier	フュージリア(伝統ある英国歩兵連隊の兵士)
querulous	不平を言う
orphenadrine	a skeletal muscle relaxant (trade name Norflex) used to treat severe muscle strain and Parkinsonism
satrap	(古代ペルシアの)太守|(専制的な)総督|知事
ordinariness	普通|平凡なこと
pemmican	ペミカン
discomfit	(人)を完全に打ちまかす|敗走させる|まごつかせる
deadeye	a dead shot|(nautical) a round hardwood disk with holes and a grooved perimeter used to tighten a shroud|a round hardwood disk with holes and a grooved perimeter used to tighten a shroud
pellicle	thin protective membrane in some protozoa
limn	を描く|描写する
foliate	葉状|葉状|葉状|給仕|葉状
zinnemann	ジンネマン
prosthodontic	of or relating to prosthodontics
micropterus	American freshwater black basses
sulphurous	辛辣|痛烈|苛辣|息苦しい
parterre	花壇をあしらった庭園|《おもに米》劇場の平土間
overexpress	(生命科学用語)過剰発現する
shakspere	ウィリアム・シェークスピア|シェークスピア
untypical	not representative of a group, class, or type; "a group that is atypical of the target audience"; "a class of atypical mosses"; "atypical behavior is not the accepted type of response that we expect from children"|not representative of a group, class, or type
vulcanization	加硫
pedicab	(特に東南アジアの)輪タク
cucurbit	any plant of the family Cucurbitaceae
suer	求婚者
foredeck	the deck between the bridge and the forecastle
eparchy	a province in ancient Greece|a diocese of the Eastern Orthodox Church
classificatory	類別的
burette	ビュレット
homograph	同音同形異義語(sealが「アザラシ」と「印」を表すなど)
buddleia	ブッドレア
pule	〈赤ん坊が〉弱々しく泣く
nowise	=noways
hewer	(木・石などを)切る人採炭夫
gentrify	renovate so as to make it conform to middle-class aspirations; "gentrify a row of old houses"; "gentrify the old center of town"|renovate so as to make it conform to middle-class aspirations
diagrammatically	図表(図式)で
elephantiasis	象皮病(皮膚や肉が厚くなる熱帯病)
magnetisation	磁化|磁気誘導
detestation	〈U〉嫌悪|憎悪|大きらい|〈C〉大きらいな人(物)
californium	カリフォルニウム(人工放射性金属元素;化学記号は『Cf』)
theophrastus	Greek philosopher who was a student of Aristotle and who succeeded Aristotle as the leader of the Peripatetics (371-287 BC)
vigilantism	the actions of a vigilance committee in trying to enforce the laws
compline	last of the seven canonical hours just before retiring
chipping	the act of chipping something
brambly	イバラの多い;イバラのような|木イチゴのような
paranoiac	偏執病患者
rudderless	かじ(方向舵)の無い|導くものの無い
lhotse	ローツェ山
qianlong	乾隆帝|1711生|清王朝の最盛期の第6代皇帝|在世時の元号の乾隆を取って乾隆帝と呼ばれる
brinkmanship	瀬戸際政策
trotskyite	トロツキスト
rondel	a French verse form of 10 or 13 lines running on two rhymes; the opening phrase is repeated as the refrain of the second and third stanzas|a French verse form of 10 or 13 lines running on two rhymes|the opening phrase is repeated as the refrain of the second and third stanzas
enflurane	エンフルラン
infinitude	〈U〉無限|無数|〈C〉無限大の数量
unchristian	(宗教が)キリスト教でない|キリスト教的精神に反する
fetich	呪物|お守り|咒物|物神
floozy	ストリートガール|街娼|売春婦
phlogiston	a hypothetical substance once believed to be present in all combustible materials and to be released during burning
lamella	(組織・細胞などの)薄板|薄膜
adiantum	ホウライシダ
loligo	somewhat flattened cylindrical squid
leatherneck	米国海兵隊員
stabbing	突き刺すような|のを刺す|刺す
transactivator	トランスアクチベーター|トランス活性化因子|(自身以外の特定DNA配列を認識して転写を活性化する調節タンパク質)
innominate	名の無い|無名の
monitory	警告する|注意を与える
laparoscope	腹腔鏡
epilation	loss of hair; the result of removing hair|loss of hair|the result of removing hair|the act of removing hair (as from an animal skin)
panhandler	物乞い
indistinctly	ぼうっと|茫と|薄々|うすうす|ぼやっと|薄薄|薄らと|杳として
redact	〈布告など〉‘を'作成する|〜‘を'編集する;〜‘を'校正(改訂)する
metastability	the quality of a physical system that persists in its existing equilibrium when undisturbed (or only slightly disturbed) but able to pass to a more stable equilibrium when sufficiently disturbed
insultingly	不正
thalamocortical	視床皮質系
stocker	a domestic animal (especially a young steer or heifer) kept as stock until fattened or matured and suitable for a breeding establishment
guerdon	報い|報賞
bise	備瀬
hyperemia	充血
casuistry	決疑論(特定の行為を道徳的原理に照らしてその是非を解決しようとすること)|〈C〉詭弁(ぎべん)
lovechild	私生児
agendum	協議事項|アジェンダ|予定表|日程|次第|議題|議事日程|会議事項
technophobia	テクノフォビア
lifehack	make one's day-to-day activities more efficient
unmarketable	not fit for sale|not capable of being sold
decipherment	解読|復号
postglacial	relating to or occurring during the time following a glacial period
blende	閃亜鉛鉱
cavort	はねまわる|はねる|遊び戯れる|はしゃぎまわる
uprise	発出|生起|起きる|起る|発生|起こる|逆だつ|逆立つ|起きる|立っち|起立|立上がる|立つ|起き上がる|立上る|昇る|差し上る|差昇る|差上る|上る|差し登る|上ぼる|差登る|差し昇る|上がる|上騰|立昇る|昇る|立ち上る|差昇る|差上る|上る|立ちのぼる|上ぼる|起床|起きる
siderite	菱(りょう)鉄鉱;隕(いん)鉄
matricide	〈U〉〈C〉母殺し|母殺しをする者
fricassee	フリカッセ(鳥・子牛・ウサギなどのこま切れ肉を用いた汁の少ないシチュー)|〈肉〉‘を'フリカッセにする
rotifer	minute aquatic multicellular organisms having a ciliated wheel-like organ for feeding and locomotion; constituents of freshwater plankton|minute aquatic multicellular organisms having a ciliated wheel-like organ for feeding and locomotion|constituents of freshwater plankton
justness	正しさ|公正|正当|合法
proteinaceous	relating to or of the nature of protein
sophora	cosmopolitan genus of trees and shrubs having odd-pinnate leaves and showy flowers; some species placed in genus Podalyria|cosmopolitan genus of trees and shrubs having odd-pinnate leaves and showy flowers|some species placed in genus Podalyria
gyratory	渦を巻く;旋回する|回転する
charwoman	雑役婦|日雇い女
azido	アジド
blueness	ブルー|青|青み|青味|青碧|青色
glowworm	ツチボタル(雌は羽がなく尾の先から微光を放つ)
unpatented	(of devices and processes) not protected by patent; "unpatented inventions"|(of devices and processes) not protected by patent
paddlewheel	外輪(昔の汽船の両舷(けん)の外側についた水かき車)
walkaway	楽勝|楽勝の試合
subtribe	亜族
unuseable	not capable of being used
moisturise	加湿
tucket	ファンファーレ
inspirit	〜‘を'元気づける|鼓舞する
countersign	(特に戦場で歩哨・斥候などの)合い言葉|応答信号|副署(他の人の文書に確認のためにする署名)|〜‘に'連署(副署)する
somnambulist	=sleepwalker
brabble	argue over petty things; "Let's not quibble over pennies"|argue over petty things
pluperfect	過去完了|大過去
smoother	スムーズに
winey	having the taste of wine; "a rich winy taste"|having the taste of wine
cambric	(上等の)白麻布
deamination	removal of the amino radical from an amino acid or other amino compound
confabulation	おしゃべり|談笑
tattletale	他人の秘密を漏らす人
polystichum	small to medium-sized terrestrial ferns especially holly ferns; in some classification systems placed in Polypodiaceae|small to medium-sized terrestrial ferns especially holly ferns|in some classification systems placed in Polypodiaceae
dowser	someone who uses a divining rod to find underground water|forked stick that is said to dip down to indicate underground water or oil
rattigan	ラティガン
arhat	羅漢|阿羅漢
eldership	the office of elder
drumlin	ドラムリン(氷河堆積物の土の長円形の丘陵)
corroboree	オーストラリア原住民の祭;その踊り(歌)|《話》騒々しいパーティー(踊り)
centerfielder	(野球で)センター|中堅手
cashbook	現金出納簿
overindulgence	甘やかし過ぎ|わがまま;(〜に)ふけり過ぎること《+『in』+『策名』》
spermatocyte	精母細胞
lowliness	(地位・身分などの)低いこと|腰の低いこと|謙そん
unaccredited	無資格
autogenic	originating within the body
monotheist	一神論者|一神教信者|一神論者の|一神教信者の
blueish	= bluish
catching	伝染性の|心を奪う
wyclif	ウィクリフ
kirtle	カートル|(中世に用いられた)婦人服|男子用の短い上着
aitch	H|hの字(音)
catheterisation	the operation of introducing a catheter into the body
atomiser	噴霧器|スプレー
condescendingly	with condescension; in a patronizing manner; "he treats his secretary condescendingly"|with condescension|in a patronizing manner
pianissimo	(音楽で)きわめて弱く(《略》『pp.』)
bolometric	of or relating to a bolometer
homozygosity	同型接合性
falchion	鎌(かま)形刀(中世の幅広でそり返った刀)
frangible	壊れやすい|折れやすい
pushup	腕立て伏せ
secretaire	主事|事務官|秘書|机|書記|幹事|参事
impalement	(とがった物で)突き刺すこと|くし刺しの刑
effulgence	輝かしさ|光輝
phaeochromocytoma	褐色細胞腫
dieresis	=diaeresis
hesitatingly	ためらいながら|ちゅうちょして;口ごもって
affray	《文》(公共の場所での)乱闘|口論
pensively	しんみり
chicle	チクル(ゴム質の乳状液;チューインガムの原料)
bolide	火球
scouser	a native or resident of Liverpool
shambolic	(British slang) disorderly or chaotic; "it's a shambolic system"|disorderly or chaotic
skeg	a brace that extends from the rear of the keel to support the rudderpost
farfalle	ファルファッレ
tartness	酸味|酸っぱさ|辛辣|辛さ
disavowal	否定|否認
actinolite	緑閃石
meretricious	(装飾･文体など)俗悪な|けばけばしい
pimiento	=pimento
fascinatingly	魅惑的に|うっとりさせるほど
animistic	of or pertaining to the doctrine of animism
albizia	any of numerous trees of the genus Albizia
promiscuously	ぱっぱと
megacolon	巨大結腸症
demagogic	扇動的な|デマの
bronchiolar	細気管支
myoblast	筋芽細胞(筋線維を形成する)
soupcon	少量|小量|１つまみ|一撮|微塵|一つまみ|一撮み|一摘み|一点|微量
repetitiveness	verboseness resulting from excessive repetitions
mrta	a Marxist-Leninist terrorist organization in Peru; was formed in 1983 to overthrow the Peruvian government and replace it with a Marxist regime; has connections with the ELN in Bolivia|a Marxist-Leninist terrorist organization in Peru|was formed in 1983 to overthrow the Peruvian government and replace it with a Marxist regime|has connections with the ELN in Bolivia
snowline	雪線(高山などで万年雪の残る地点の最低境界線)
calbindin	カルビンジン|ビタミンD依存性のタンパクとして中枢神経系に多く存在する
macerate	湯や水に浸して柔らかにする|やせ衰えさせる
molter	羽抜け鳥
vaginismus	膣痙攣
transplantable	移植可能
alterable	変えられる|改められる
larghetto	(music) a composition or passage played in a slow tempo slightly faster than largo but slower than adagio|a composition or passage played in a slow tempo slightly faster than largo but slower than adagio|(of tempo) less slow and broad than largo
oatcake	オートケーキ(オートミールで作った堅焼きビスケット)
cabalist	a member of a cabal|an expert who is highly skilled in obscure or difficult or esoteric matters|a student of the Jewish Kabbalah
professionalisation	the social process whereby people come to engage in an activity for pay or as a means of livelihood; "the professionalization of American sports"; "the professionalization of warfare"|the social process whereby people come to engage in an activity for pay or as a means of livelihood
chaotically	混とんとして|無秩序に
kookie	クーキー
extroversion	(心の)外向性(自分以外の物に興味が向けられる性格)
persea	avocado
deputize	代理
undefinable	言い難い|えも言われぬ|得も言われぬ|言いがたい
dishy	魅力的な
disparagingly	軽蔑して|非難して|けなして
chaetodon	any fish of the genus Chaetodon
phycology	the branch of botany that studies algae
meritocratic	実力主義の
reciter	暗唱する人|話し手|語り手|返答者
pruning	刈り込み|剪定
abaxial	facing away from the axis of an organ or organism; "the abaxial surface of a leaf is the underside or side facing away from the stem"|facing away from the axis of an organ or organism
rarebit	=Welsh rabbit
neuroglia	神経膠
delightedly	嬉しがって|喜んで|嬉しそうに
chimerical	想像上の|幻想上の|怪物的な|空想的な|妄想的な
glowingly	in an enthusiastically glowing manner; "in her letter she praised him glowingly"|in an enthusiastically glowing manner
caloocan	カローカン
autocatalytic	自己触媒的な
importunate	(人・要求などが)うんざりするぼどしつこい|わずらわしい
inebriation	酩酊(めいてい)|泥酔(でいすい)
bandoneon	バンドネオン
mistranslation	誤訳
expansively	心広く|発展的に|展開的に|広々として|広大に|拡張的に|膨張的に
coiner	貨幣鋳造者;《しばしば》にせ金造り
sunbonnet	(婦人・赤ちゃん用)日よけ帽
piratical	海賊の|著作権を侵害する
pointlessness	無駄|無意味さ|真空
indigence	貧困|窮乏
cycloserine	サイクロセリン
artifactual	人為的な
mutely	黙って|無言で
billowy	うねりの高い;大波のようにうねる
repletion	充満|充実|満腹|食べ(飲み)すぎ
suzerainty	宗主権;領主の地位(権力)
hyrax	ヒラックス|ハイラックス(ウサギに似たひづめのある小動物)
choriomeningitis	脈絡髄膜炎
shalwar	a pair of light loose trousers with a tight fit around the ankles; worn by women from the Indian subcontinent (usually with a kameez)|a pair of light loose trousers with a tight fit around the ankles|worn by women from the Indian subcontinent (usually with a kameez)
hanker	あこがれる|こがれる|渇望する
dug	an udder or breast or teat
fenoprofen	フェノプロフェン
oligochaeta	貧毛類
halfhearted	気乗りのしない|身が入らない|冷淡な|いいかげんな
auchincloss	オーキンクロス
thiobacillus	硫黄菌属
pillager	略奪者
imperturbable	動じない|冷静な
caravanserai	隊商宿
reproducer	繁殖する生物|複写機|再生機
phonation	ボイス|音声|発声|音吐|声音|声
encipher	〈通信文など〉‘を'暗号文にかえる
copacetic	completely satisfactory; "his smile said that everything was copacetic"; "You had to be a good judge of what a man was like, and the English was copacetic"- John O'Hara|completely satisfactory
vacillation	動揺
toiler	働き者;労働者
scaphoid	舟状
heathenism	異教|邪教
regimentation	連隊編成|規格化
rancour	辛辣|憎み|怨嗟|仇|憤り|遺恨|憎しみ|憤慨|忿怒|怨恨
serkin	ゼルキン
contrasty	having sharp differences between black and white
unredeemed	救われない
muscadet	white grape grown especially in the valley the Loire in France|dry white wine from the Loire valley in France
mesothelium	中皮
singsong	〈U〉単調な調子(リズム)|抑揚のない話し方|〈C〉単調な詩[歌]|〈C〉《英》(一般会衆による)即席合唱会|単調な|抑揚のない
apercu	a short synopsis
pugilist	(pjuː|dʒəl|ɪst) )(プロ)ボクサー|けんか(議論)好きな人
debark	=disembark
facetiously	おちょくって|冗談に|ふざけて|本気でなく|からかい半分で
nephrolithiasis	the presence of kidney stones (calculi) in the kidney
miniaturisation	小型化
styrax	エゴノキ
ingathering	取入れ|収穫|集会|会合
linaria	genus of herbs and subshrubs having showy flowers: spurred snapdragon
riband	=ribbon
teargas	催涙ガス
episteme	エピステーメー
thermotherapy	温熱療法
deceitfulness	悪知恵|狡知
mitigative	緩和性
sardonically	冷笑的に|皮肉に
strongbox	金庫|貴重品入れ
pediculosis	シラミ寄生症
nidus	病巣|病巣
cytisus	large genus of stiff or spiny evergreen or deciduous Old World shrubs: broom