wonder	(～かと)疑問に思う|に驚く|を不思議に思う|驚き|不思議なもの
solution	ソリューション|解決|解答|溶解|溶液
fine	すばらしい|元気な|申し分ない|すてきな|晴れ|晴れている
wrong	まちがった|故障して|具合が悪い
shoulder	肩|(道路の)路肩
charge	料金|非難(する)|充電(する)|突撃(する)|告訴(する)|(義務など)を負わせる|請求する|つけにする
wind	風|曲がる|巻く
eye	目
pressure	圧力|圧すること|押すこと|圧縮|圧搾|電圧|苦難|苦痛|(するように)圧力をかける
patient	がまん強い|忍耐強い|辛抱強い|根気よく働く|患者
surprise	驚き|を驚かせる
beyond	〜を超えて
sometimes	ときどき
produce	を作る|を生み出す
ability	能力|腕力|才能
review	見直す|復習する|批評
dead	死んだ|死んでいる|活気のない
date	日付|デート
wave	手を振って合図する|波立つ|振る|ウェーブ|振ること|高まり
addition	足し算|追加
piece	一部|(全体の)一部|1つ
floor	床|底|立会所
total	全体の|全ての|総計の|全くの|総力の|(車が)全壊する|全損する
road	道
special	特別な
seem	と思われる
lay	横たえる|並べる|置く|位置|状態|横たわる|横になる
behavior	振る舞い
security	安全|安全保障|無事|安心|有価証券|証券(通常複数形で)
memory	記憶装置|記憶|記憶力|思い出|記念
promise	約束|約束する
site	場所|用地|サイト
task	に負担をかける|仕事|に仕事を課する|職務|事業
international	国際的な|インターナショナル(国際労働者同盟)
rule	規則|ルール|を支配する
exist	存在する
authority	権威|権威者|出典|権限|権力|許可|職務権限|当局
round	丸い|〜の周り
save	救う|蓄える|省く
church	教会
immediately	すぐ接して|すぐに|早速|ただちに|直接に|直ちに
everyone	すべての|すべての人|みんな
instead	その代わりに
lack	足りない|がない|欠ける|不足
goal	目標|目的
fast	速く|速い
cold	風邪|冷たい
sort	分類する|仕分けする|ソート|種類|人|区別する|片付ける
ready	用意ができて
pattern	パターン|模範|原型|模様|柄|型|傾向|模様をつける
phone	電話|電話をかける|telephone
contain	含む|を持つ|を収容できる|抑制する
carry	を運ぶ
achieve	を達成する|を完成する
nor	もまた～でない|そしてまた～ない
private	私用の|個人の|私有の|秘密の|(反)public
below	〜の下で
strength	強度|兵力|力|強さ|体力|強み|長所
happy	しあわせな|うれしい|glad
degree	程度|度合い|学位|地位|階級|親等|(文法)級
complex	コンプレックス|強迫観念|固定概念|合成物|複合体|コンビナート|総合ビル|複合の|複雑な
dress	に着物を着せる|衣服を着る|正装する|ドレス
pass	通る|経つ|に合格する|パス|狭い道|山道
finally	ついに
check	チェックする|急に止める|を抑制する|を調査する|一致する|停止|妨害|検査|照合|小切手|勘定書
distance	隔たり|距離|離れた場所
listen	聞く
positive	明白な|人為的な|肯定的な|積極的な|正の|実在|正数|原級
yourself	あなた自身
particularly	特に|詳しく
prove	を証明する|とわかる
cultural	文化的な|教養の|文化の|栽培の|培養の
presence	プレゼンス|存在|物腰|面前|居ること|存在すること|出席|同席|人前|参列
cover	覆う|カバーをかける|償う
scale	鱗|薄片|うろこを落とす|(重さを)量る|(長さを)測る|目盛り|規模|縮尺|てんびん|(山)登る|(高いところを)きわめる
operation	操作|手術|活動|軍事行動
trust	を信用する|信用|信頼
press	報道する|押す|抱きしめる|絞る|せがむ|アイロンをかける|出版物|新聞界|徴発
chance	機会|可能性|偶然
heat	加熱する|熱|暑さ|激しさ|体温|熱する|を燃やす
add	加える|足す
target	目的物|対象の|的
statement	声明|陳述|述べたこと
financial	財務の|財政上の|金融の|財界人の
post	ポスト|郵便局|郵便|郵送する|柱|職|地位
entire	全部揃った|全部の|全体の|まったくの
buy	買う
search	を捜す|を探る
grow	育つ|成長する|(ある状態)になる|を育てる|を栽培する
supply	を供給する|支給する|供給
sister	姉妹|姉|妹
picture	絵|写真|心に想いえがく
unit	(学科の)単位|一人|一個|一群|部隊|あれ(stuffやthingのように軽い意味で用いられる)
street	ストリート|道路|通り
basis	基礎|主成分|土台|原理
gain	もうける|得る|を増す|利益|増加
conduct	振舞う|管理する|導く|行なう|案内する|行為|処置|経営
avoid	を避ける
maintain	維持する|養う|を主張している|支持する|保存する
worry	心配する
regard	みなす|思う
legal	法律の|強制的な|法定の|合法の
protect	を守る
skin	皮膚(の)|皮|外皮|皮をすりむく|皮をはぐ
describe	(言葉で)説明|描写する
forget	を忘れる
weight	重さ|おもし|重荷|重要さ|ウエイト|を重くする
daughter	娘
spirit	アルコールの|元気づける|心･精神|霊(魂)|気分
music	音楽
write	書く
ago	前に
reflect	反映する|反射する|よく考える
percent	パーセント|百分率|割合
instance	例|例に引く
join	参加する|加わる|をつなぐ
anyone	だれか
seat	席|を着席させる
military	軍隊の|軍の|陸軍の|軍人の
discussion	議論|討論
beautiful	美しい
soul	精神|魂
industry	産業|取り引き|工業|生産
release	解放する|自由にする|発表する|(ガスなど)を放す|解放|公表
receive	を受け取る
condition	条件|状態|状況|健康状態|社会的地位|身分|調整する|(文法)条件文(節)
directly	直接に|まっすぐに|直ちに|ちょうど
drug	薬|麻酔薬を飲ませる
kiss	軽く触れる|キス(する)|口づけ|軽い接触|砂糖菓子|(風が)軽く～に触れる
science	科学
middle	まん中の|中央の|中程度の|胴|中道|中央に置く
suddenly	突然に
film	フィルム|被膜
reduce	減らす|変える
sample	見本|試供品|抽出標本|の見本をとる|を試食する
hour	時間
dream	夢を見る|夢
center	センター|中心に集まる
horse	ウマ|馬
kill	を殺す
bank	銀行|預ける|(川の)土手
shift	を変える|移す|変化|移動|交替
couple	カップル|夫婦
identity	身元|正体|独自性
modern	現代の|現代的な|現代人
doubt	を疑う(don't believe)|疑い
please	どうぞ|喜ばせる
ship	船積する|船|を輸送する|乗船する
page	ページ|書物|にページを付ける|ページをめくる|ボーイ|給仕(する)
temperature	温度|気温|寒暖|体温|熱|気質
husband	夫|(v)倹約･節約する
brain	脳|中枢部|頭脳
glass	コップ|グラス
breath	息|呼吸
stress	を強調する|緊張|ストレス|強調|強勢(をつける)
sea	海
mine	わたしのもの|鉱山|炭鉱|機雷|地雷
reference	参照|言及
communication	コミュニケーション|意思の伝達
nation	民族|国家|国民|主権国
contact	接触|連絡|連絡をとる
determine	決定する|決心する
final	最後の
color	色|色のついた|色をつける
king	王
fly	飛ぶ|ハエ|フライ
generally	一般に|通例
clearly	明瞭に|はっきりと|明るく
path	小道|通路|細道|散歩道|進路|方針
apply	申し込む|あてはまる|あてはめる|応用する
effective	効果的な|印象的な
separate	切り離す|を引き離す|を区分する|別個の|個々の
officer	役員|将校|警官|船長|役人
manner	方法|態度|行儀|風習|様式|礼儀作法
fit	合う|に適合する|健康な|ひきつけ|けいれん(cramp)
police	警察
oil	石油|油|油を注す|お世辞|賄賂
enjoy	を楽しむ
dog	犬
capital	大文字|資本|首都|資源|元金|主要な|資本の
wear	身につけている
variable	変わりやすい|気まぐれな|可変の|変化するもの
send	送る
earth	地球|土
race	レース|競争|人種
series	シリーズ|連続|一組
onto	〜の上へ
indeed	本当に|実に|全く|実際は|なるほど|いかにも
religious	宗教心のある|宗教上の|宗教に関する|敬謙な|信心深い|神聖な
blue	青い
argument	議論|主張|引き数(=parameter)
phase	局面|相|段階|1つの姿|面|位相|を段階的に計画する
limit	を制限する|限定する|制限|限定
original	独創的な|最初の|原文の|原型|本人
indicate	指し示す|表す
reality	実態|迫真|現実
green	緑の|青々とした
identify	何･誰なのかを確認する|の正体をつきとめる|共感する
completely	完全に
edge	刃先じりじりと追いやる