unilateral	一方的な|一国だけの
cation	陽(正)イオン
repose	静まり返っている|休息|安らぎ|安心|平和|横になる|休息する|頼る
ledge	出っ張り|出っぱり|棚|岩礁
anecdote	逸話|逸事|秘史|秘話
discard	捨てる|解雇する|(不用のものを)処分する|放棄|解雇
advantageous	有利な
pirate	海賊|略奪者|を略奪する|著作権を侵害する
injure	傷つける|けがをさせる
haze	もや|煙霧|かすみ
calamity	不幸な出来事|災難
outlaw	無法者|追放する|禁止する|時効にする
merchandise	商品|を商業化する|売買する|宣伝する
dispatch	急送(する)|発送(する)|片付ける|速達|電報|派遣
complication	厄介な問題|混乱|複雑な状態|合併症|紛糾|複雑
barge	遊覧船|荷船|はしけ
cocaine	コカイン
latch	ラッチ|掛けがね|掛金
vendor	行商人|露店商人
despise	を軽蔑する|look down on
broth	薄いスープ
preventive	予防的な|予防法
irrespective	に関わりない
allele	アレル(対立遺伝子)
crystalline	結晶質
waterfall	どっと押し寄せるもの|滝
triangular	三角形の|三者間の
vaccination	ワクチン注射|種痘|予防接種|種痘の痕跡
wee	ちっぽけな|ちっちゃな
affectionate	愛情深い
confidently	確信して|自信を持って|大胆に
pickup	集めること|便乗者|かりそめの知り合い|好転|実況放送|間に合わせの
interpretive	解釈的な
deem	意見をもつ|思う|判断する
grease	グリースを塗る|脱脂しない生羊毛|油脂|獣脂|グリース|潤滑油|(俗)ダイナマイト|ニトログリセリン
portable	持ち運びのできる|ポータブルな|携帯用の
straighten	をまっすぐにする|まっすぐになる|整える|整備する
teen	10代の|13-19才の
fugitive	変わりやすい|逃亡者|脱走者|亡命者|放浪者|脱走する|逃亡する|さまよう
someday	いつか
lit	火がつく|火をつける
bead	数珠玉|ビーズ|玉|ロザリオ|しずく|玉になる|玉で飾る|数珠つなぎにする
cubic	3次方程式|立方体の
drunken	酔った|酔っぱらった|酔っぱらい
housekeeper	家政婦
cache	貯蔵所|貯蔵物|隠し場|隠してある貴重品
infringement	違反|違背|侵害
genotype	遺伝子型
ether	エーテル
kettle	やかん
aide	(大統領などの)補佐官|側近|スタッフ
hose	ホース|長靴下
uplift	持ち上げる|向上|(精神を)高める|隆起|高揚
everlasting	永久の
microscopic	微視的な|顕微鏡でやっと見えるほどの
hideous	見るも恐ろしい|ぞっとする|忌まわしい|胸が悪くなる
unlock	の錠をあける|を開く|打ち明ける|鍵が開く
inversion	逆にすること|転倒|転置|転換|反転|(文法)倒置(法)
neutron	中性子
bipolar	二極性の|正反対の
syntactic	統語論の,構文の
bracelet	腕輪
zip	ファイルの圧縮と圧縮解除を行うソフト
advisory	助言の|顧問の|諮問の
resultant	結果として起こる
extracellular	細胞外の
pronounce	を発音する|を朗読する|と断言する|を宣言する|を申し渡す|意見を述べる
joyful	とてもうれしい|楽しい
imposition	賦課物|税|負担|詐欺|ぺてん|(印刷)整版
visibly	目に見えて|明らかに
peep	のぞき見(する)|こっそり見る|姿を現す|出現
regularity	規則正しさ|均整|不変|正規
southwest	南西(部)|南西の|南西へ
predecessor	前任者|祖先|先輩|前のもの
cartilage	軟骨|軟骨の
furiously	猛然と
radiant	輝くばかりの|うれしそうな|凛然とした
individuality	個性
consolidate	強固にする|合併整理する|合併する|統一する
alienation	疎遠|疎外|遊離|疎隔|譲渡|遠ざけること
partake	加わる|参加する|の性質が幾分ある
increment	利潤|区切り
correlate	相互に関連がある
compassionate	あわれみ深い|哀れに思う|情け深い|同情的な
precarious	推定的|心許ない|おぼつかない|人頼みの|他人の意志次第の|不安定な|危ない
magnesium	マグネシウム(金属元素)
mentality	心情|知力|知性|心理|思考方法
blockade	封鎖|妨害
homosexual	同性愛の(人)
inlet	入り江
cosmetic	表面的な|化粧品
lumber	木材|不要品|厄介な人･物|を(がらくたで)一杯にする|ふさぐ|(物)を乱雑につみあげる|ドタドタ(のしのし)歩く･進む
hawk	タカ|鷹|タカ派|強硬論者|他人を食い物にする人
famously	有名|著名な
synagogue	ユダヤ教の礼拝堂|《the ~》ユダヤ教徒の集会
negation	否定
wisely	賢く|賢明に|抜け目なく|賢明にも
rotate	回転する
revolver	回転式連発拳銃
invariant	不変の
excel	しのぐ|優る
tricky	扱いにくい|巧妙な|こうかつな|油断のならない
brandy	ブランデー
glacier	氷河
mismatch	不適当に組み合わせる|の組合せを誤る|不釣り合い|不釣合いな縁組
emancipation	奴隷解放|解放|解脱
prairie	(特にミシシッピー川流域の)『大草原』
faithfully	誠実に
inflict	苦しめる|負わせる|打撃を加える|刑罰を課する
superintendent	監督(指揮)する|監督者|最高責任者|監督･指揮する
renounce	要求を正式に放棄する|をやめる|捨てる|を否定する|を拒否する
manhood	成年|成人であること|男子であること|男らしさ
indifferently	無頓着に|冷淡に|良くも悪くもなく
calculus	石|結石|計算法|微積分学
playground	運動場|遊び場|行楽地|活動の場
crunch	困難|危機|ピンチ|ばりばりかむ|ざくざく踏む
awaken	目をさまさせる
pharmacy	薬局
extant	(古文書|記録などがまだ)現存している|現存の|実在の|今なお失われずに残っている
accession	追加|就任|増加|到達|即位|相続|取得
underscore	を強調する|アンダーラインを引く
audible	聞こえる
endogenous	内生の|内生的な|内因性の
cavern	大洞穴|洞穴|洞窟
measurable	測ることのできる|測定できる|適度の|かなり重要な
alphabet	アルファベット|初歩
socket	ソケット|受口|受け口|を受け口(ソケット)にはめ込む
memorandum	備忘録|覚え書き|メモ|摘要|規約|定款
clatter	がたがた(する)
loser	敗北者|負け犬|(野球なら)敗戦投手
innumerable	数えきれない
foresee	予見する
creed	(=credoラテン語)|信条|信念|教義
revert	回顧する
concurrent	同時の|同時に起こる|同意見の|に伴う|兼務の|共同に作用する|協力の(cooperating)
yearly	毎年の|例年の|年1度の|その年だけの|毎年|年1度
victorious	勝利の|勝利を得た|勝った|戦勝の
ovarian	卵巣
gag	の口に詰める|言論統制|冗談|自由な言論の抑圧
showcase	模範|モデル|見本|陳列棚
asymmetry	非対称
expansive	広大な|発展的な|膨張力のある|膨張性の|拡張的な|展開的な
habitual	習慣的な|習慣による|不断の|常習的な|習慣性の
developer	住宅開発業者
experiential	経験に基づく|経験的な
morbidity	不健全|罹病率
hegemony	支配権|主導権|盟主権|覇権|ヘゲモニー
atrial	atrium＞心房の
fiduciary	信用上の|信託の|受託者|被信託者
maze	迷路|当惑する
sociologist	社会学者
allergy	アレルギー
identifiable	身元を確認できる|同一であると証明できる
bestow	与える|授ける|を贈る|利用する
jewel	宝石
homicide	殺人(必ずしも犯罪と限らない殺人|ex|homicide in self‐defense自衛による殺人|cf|murder)
markedly	目に見えて
oblige	強いる|余儀なくさせる
poisonous	毒のある|有毒な|有害な|悪意のある
fragrant	においのよい|芳香性の
pivot	旋回軸|要|中心|を枢軸のうえに置く|旋回する
underline	の下に線を引く|強調する|下線
gardener	植木屋|外野手
sentimental	感情的な|心情的な|感情に影響されやすい
deviate	落ちこぼれ|(進路･常軌･原則などから)それる|離れる|はずれる|偏向する(from)
divert	方向転換する|転換する|転送する|(注意など)をそらす
holiness	神聖なこと|聖下
curl	縮らす|カール|(髪を)カールする
pivotal	中枢の|枢軸の(ような)|中心の|重大な
slippery	つるつるした|つるつる滑る|不安定な|理解しにくい|信頼できない|ずるい
realist	現実主義者|写実主義作家|実在論者
recollect	を思い出す|回想する
abusive	悪用された|口汚くののしって
nickel	ニッケル|元素記号Ni|白銅貨|ニッケル硬貨|(米)5セント
bile	胆汁|かんしゃく|不機嫌
formative	形成した|造形の|構成する|形成･発達(期)の|(文法)接辞|形態素
epilepsy	てんかん,痙攣,発作(=seizure)
etc	その他
dancer	踊る人
eruption	噴火|爆発
genetically	遺伝的に
dictatorship	独裁者の権力|独裁政治|独裁政権
multiplicity	重複|多様性
ale	エール酒|ビール|エール(ビールの一種)
aversion	大嫌い|嫌うこと|嫌悪|反感
suffering	苦しみ
diverge	分岐(する)|(意見などが)異なる|相違|逸脱
chronicle	年代記|記録|年次報告|歳史|書き止める
ascent	上昇|昇進|上り
awkwardly	ぎこちなく|気まずく|怪しい手つきで|不自然に|変に|不適切に
introductory	紹介の
physicist	物理学者
brat	やんちゃ坊主|(俗)ガキ
slate	石板|スレート(でふく)|候補に立てる|予定する(schedule)|酷評する
gloss	つやを出す|光沢|注解|注釈
butler	執事|バトラー
blindness	盲目
elaboration	綿密な仕上げ|精巧さ|推敲|苦心の作
lighten	の色を薄くする|軽くなる|明るくなる|を喜ばせる|楽になる|晴れ晴れする|軽減する|明らかにする
squirrel	リス|リスの毛皮
futile	無益な|無駄な|くだらない|役に立たない
resilient	はね返る|弾力のある|快活な
woodland	森林|森林地帯
glimmer	ほのかに見える|かすかな光|微かな光
spice	スパイス|香辛料|薬味|趣|に香辛料を加える
canyon	峡谷
tighten	締める
epistemology	(哲)認識論
solubility	溶解性
mosaic	モザイク|モザイクの
lithium	リチウム(金属元素)
heroine	英雄的女性|ヒロイン
pointer	助言|アドバイス|指し示す人|指摘者|むち|猟犬
glitter	ぴかぴか光る|きらきら光る|派手である
gram	グラム
enlightenment	啓発|啓蒙|文明開化
limestone	石灰石|(大理石marbleを除く)
cheerfully	機嫌よく|元気よく|明るく
opioid	オピオイド(体に麻薬様の薬効を与える物質)
nitrate	硝酸塩|(肥料として用いられる)硝酸カリ|硝酸ソーダ
derivation	誘導|(文法)派生
rumor	をうわさする|うわさ|風説|流言
rhythmic	リズミカルな|調和した|律動的|(rhythmic gymnastics|新体操)
richness	豊かさ|金持|豊富なこと|高価|濃厚な|こくのある|(色の)鮮やかな|(音の)よく響く|おもしろい|こっけいな|ばかげた
profitability	収益性
afar	遠く(farの方が一般的)
elf	(小)妖精|小人|小妖精
backbone	背骨|中心|勢力|屋台骨
coercion	威圧|強制
skate	(アイス)スケートをする|(アイス)スケート靴|(魚)ガンギエイ
depressive	鬱状態の人|憂鬱な|抑鬱性の|(抑)鬱病の|押し下げる|抑えつけられるような
grapple	握る|つかむ|組打ち
dealer	自動車販売等代理店|ディーラー
pathogen	病原体
irradiation	放射
momentary	瞬間の|瞬間的な|絶え間のない|束の間の
unravel	(疑問が)解明する|明らかになる|(糸･謎)をほぐす
rethink	考え直す|再考
passionately	情熱的に|熱烈に|激しく|激怒して
tidal	潮の(tideの形容詞)|干満のある
snort	強く鼻を鳴らす|荒い鼻息|(馬が)鼻を鳴らす|鼻を鳴らして不満を言う|しゅうしゅう音を立てる
issuer	発行者
confuse	(人)を困らせる|を混乱させる|を混同する
statistic	統計量|統計値
entirety	完全|全体
bolster	強める|支持(する)|長まくら(pillowの下の)
flashlight	懐中電灯
leakage	漏れ|漏電|漏水|漏出
diligence	勤勉
silhouette	シルエット|輪郭|の輪郭を見せる
vernacular	その土地特有の(ことば)
volcanic	激しい|火山(性)の|火山の多い|爆発性の
unlawful	不法の|非合法的な|私生(児)の
vine	つる|ぶどうの木|つる植物|つる草
tertiary	第3の|ひどい
infinity	無限領域
sulfate	(～を)硫酸化する|硫酸塩
tremor	震動|震え|振動
exclaim	叫ぶ|大声で言う
inventor	発明者|創案者
elusive	理解しにくい|わかりにくい|密やかに暮らす
buffalo	野牛|水牛 2|(B-)バッファロー市(ニューヨーク州)
trademark	商標|登録商標
phosphorus	リン|燐(非金属元素)
scalar	段階状の|はしご状の|(数学で)スカラーの|スカラー(空間・平面上の関数)|スカラー量(温度・時間など目盛り上の単位で表される量)
siren	サイレン
charcoal	木炭
reminiscent	暗示する|連想させる|しのばせる
respectfully	うやうやしく
rogue	わくぱく小僧|悪漢|ごろつき|詐欺師|悪党|いたずらっ子
populist	人民党員|人民党の
topical	話題の|論題の|題目の|原則的な|時事問題の|局部的な
sunrise	日の出
incur	負う|被る|を受ける|にぶつかる
motorcycle	オートバイ(和製英語)|バイク|単車で行く
slam	をピシャリと閉める|バタン(と閉まる)
ventricle	(心臓の)心室 (cg|atrium心房)
scowl	顔をしかめる|にらみつける|しかめっ面|渋い顔
industrialization	産業化
pry	てこ|(てこなどで)動かす|覗く
mundane	世俗的な|ありふれた
lecturer	講演者|講師
dummy	ダミー|モデル台
lily	ユリ|百合のような|優美な
elemental	自然の力による|元素状態で存在する|要素の|元素の|原理的な|基本的な|自然力の
paramount	最高(位)の|最高権力者|首長
patriotic	愛国心の強い|愛国的な|半島
proprietary	所有主の|所有の|所有者の|独占の
fiddle	バイオリン|演奏する
spacious	広い範囲の|広々とした|雄大な
anytime	いつでも
outburst	ほとばしり|(感情|ガスの)爆発|突発|噴出
clamp	とめ金|留め金|締め具
chick	ヒヨコ|(俗)女の子|(とくに)魅力的ではつらつとしている女の子
negro	アフリカ系黒人|黒人|皮膚の黒い人
iconic	象徴的な
hobby	道楽|趣味|ホビー
warp	(織物の)縦糸|歪み|ゆがみ|(板など)をそらせる|ひずませる|そる|ゆがむ
unhealthy	不健康な|健康に害のある|不健康そうな
heartily	心から|元気よく|すっかり
molar	分子の|Molar concentration(モル濃度)|濃度の表示形式(1L中の溶質をモル数で表したもの|単位はmol/L) 2|臼歯(の)|かみ砕く
vile	下劣な|ひどく悪い|いやな|堕落した|きたない
honorable	名誉となる|尊敬すべき|名誉ある|恥を知る|高貴な|身分のある
char	炭にする|黒焦げにする
bullshit	嘘|でたらめ|ナンセンス|心にもないことを言う
mustard	カラシ|マスタード|カラシ色|カラシナ
perturbation	心の動揺|ろうばい|混乱|摂動
centrality	求心性|重要な地位|中心たること|中心であること|中心性
attributable	原因を帰しうる
err	誤る(=error)
wonderfully	驚くほど|不思議なほど|素晴らしく
thematic	主題の
manually	手動で
infamous	評判の悪い|悪名の高い|破廉恥な|不正行為
pollen	花粉
exposition	博覧会|解説|公開|開帳|顕示|展示会|展覧会
deformity	障害|不具合|(人格の)欠陥
gamma	(第3ギリシア文字)ガンマ|Γ|γ|第3(のもの)
acidic	酸を出す|(態度･気質が)刺々しい|辛辣な
neuron	ニューロン(神経細胞)|社名 他
duel	果たし合い|決闘|勝負
barley	大麦
spiritually	精神的に|霊的に|宗教的に
delta	(第4ギリシア文字)三角州|デルタ|Δ|δ
remorse	後悔|自責の念|良心の呵責
blackness	黒度|黒いこと|黒さ|暗黒|凶悪|肚黒さ|陰険|陰鬱|険悪
portrayal	描写|肖像(画)
intermittent	断続する|途切れ途切れの
gravitational	重力の
bony	骨の(ような)|骨ばった
symptomatic	微侯となる
immersion	水(液体)に浸すこと|浸礼(全身洗礼)|没頭すること
modernist	現代主義の|近代主義者|現代主義者
naive	あどけない|ばか正直の|無邪気な|世間知らずの|だまされやすい
anatomical	解剖の
ethos	(特定の民族･社会･時代･文化などの)気風|精神|思潮|エトス
salon	サロン|(高級)店|客間|大広間
tuck	差し込む|を押し込む|を隠す|をはさむ|縫い込む|はおる|(袖など)をまくり上げる
madam	奥様|(俗)めかけ
wholesale	卸売する|卸売(の･で)|大規模な|大規模に
prosper	繁栄させる|成功する|繁栄する|繁盛する
pancreatic	膵臓の
subtract	を控除する|引算をする|を引く|減じる|取り去る
bun	(女性の)束髪
permissible	許すことのできる|許される|許された|差支えない
starter	開始者|始動機|始める人(物)|スタート係|競争に出る人|セルモーター(和製英語)
autobiography	自伝|自叙伝
hasty	早まった|急ぎの|軽率な|急いだ|迅速な
crate	わく箱に詰める|木枠|木箱
empirically	経験的に|経験に基づいた
moderately	ほどほどに|控え目に|穏やかに|適度に
malaria	マラリア|(湿地から出る)毒気
plight	苦境|窮地|悪い状態|婚約する|誓約
delicacy	おいしいもの|美味|珍味|ごちそう
applicability	適用性
ho	おーい|おいこら|ホーイ
endorsement	裏書き|賛成|確認|支持|承認
expanse	～の広がり|天空|膨張|拡張|広がり
harmonious	調和の取れた|和声の|協和的な|調子のよい|調和した|仲のよい|むつまじい
neuronal	神経細胞の|ニューロンの|神経型の
fieldwork	フィールドワーク
scoop	すくいあげる|ひとすくい|スコップ|小シャベル|すくいさじ|特ダネ|スクープ
beetle	カブトムシ|甲虫
intravenous	静脈内の|静脈(注射)(の)
repeal	を無効にする|を取り消す|取り消し|廃止(する)|撤廃|無効に(する)
aperture	孔|(光などがもれる)隙間|開口|(レンズなどの)口径|(カメラなどの)絞り
composure	落ち着き|落着き|沈着|平静
checklist	照合簿
respiration	呼吸(作用)|ひと呼吸|ひと息|(artificial respiration人工呼吸)
specialize	専門化する|専攻する|専門にする|特別にする|を特殊化する
rugged	ごつごつした|でこぼこの|ぎざぎざの|岩だらけの|厳しい
violin	バイオリン|バイオリン奏者
upload	アップロード
irresistible	抵抗できない|否応のない|抑え難い|耐えられない|圧倒的な
ballet	バレエ(団･曲)
embark	乗船させる|乗船する|始める|着手する
transgender	性転換の
cabbage	キャベツ
dielectric	誘電体|絶縁体|絶縁の|不伝導性の
stumble	へまをやる|つまずく|よろめく
reversible	逆にできる|裏にできる|両面使える(服)|両面織りの布
transgression	(法|命令などの)違反|逸脱|破戒|(陸地への)海進|犯罪|(宗教･道徳上の)罪
avenge	あだを討つ|復讐する
asymmetric	不均斉の|不釣合いの|非相称の|非対称の
vet	獣医|(動物を)診療する|精査する
smack	ぴしゃりと打つ|の味がする|の気味(がある)|舌打ちする|舌鼓を打つ|平手討ち|まともに|小型帆船
schematic	概要の|図解の|構造図|回路図
unbearable	耐えられない|忍びがたい|我慢できない
doom	(通例悪い)運命|悲運|凶運|運命づける
vaginal	膣の
tort	私犯|不法行為(=legal liability)
holding	続く|保有の
periodical	定期刊行の|周期的な|定期刊行物
quarry	切り出す|獲物|石切り場|採石場|源泉|石を切り出す
inhale	吸い込む
fro	あちらへ
stadium	スタジアム|競技場
bluff	威嚇(する)|ぶっきらぼうな|荒っぽい|率直な|険しい
performer	行為者|役者|行う人|演奏者|俳優|曲芸師
shew	=show
estimator	推定量
slash	スラッシュ|さっと切る|を鞭打つ|一撃|切り傷|大鉈を振るう|大幅値下げする|大改定をする
sneer	(人･物･事を)あざ笑う|軽蔑|冷笑する|軽蔑する|を嘲って言う|冷笑
trope	言葉の比喩的用法
pottery	陶器
manor	(英)(封建制度下の)荘園|manor house邸宅|(英)警察の管区|なじみの場所|所有地
unpack	の梱包を解く
degenerate	退歩する
causality	因果関係
surrogate	代理|代理人|代わりのもの
chromatography	クロマトグラフィー
prefix	電話局番|人名の前に付ける敬称|の前に付ける|接頭辞|接頭語
armchair	ひじ掛け椅子|ひじかけいす|机上空論の
condom	コンドーム
biomedical	生物医学|医療従事者が|薬物|放射線
mathematician	数学者
malignancy	悪性腫瘍
nudge	軽くつつく|(注意を引くために)そっと押す|行動を促す|ひじでつつくこと
proactive	先のことを考えた
anew	再び|新規に
modulate	調節する|調子を変える|詠唱する|転調する
enrichment	豊かにすること|価値を高めること|質を向上させること|富裕|濃縮
annotation	注|注釈
linguistics	言語学
attic	屋根裏(=garret, loft)
memorize	記憶する|暗記する
methane	メタン
nay	《古語》否,いや(no)|《文語》そればかりでなく,それどころか|拒絶|否定|反対投票(者)
tramp	足音高く歩く|激しく踏みつける|重い足取り|徒歩旅行|浮浪人|放浪者
redeem	義務を果たす|を取り戻す|を買い戻す
socialization	社会化
ascend	のぼる|上る
reconsider	を再審議する|を再考する
arrogance	ごう慢|横柄
relentless	容赦のない|冷酷な
southeast	南東|南東部地方|南東に|南東から
novice	初心者
consonant	調和する|一致して|(文法)子音
reed	屋根のふきわら|ヨシ|アシ(の茂み)|リード楽器
creditor	債権者
diesel	ディーゼル機関(船･車)
dealing	分配する
incarnation	化身|権化|人間化|具体化|具体化すること
sludge	泥沼|ぬかるみ|どろどろの泥|ヘドロ
yawn	あくびをする|あくび|退屈な人|大きく口をあける
drown	ずぶ濡れになる|溺れる|を溺れさせる|溺死する|を水浸しにする|を消す
timid	おくびょうな|おずおずした|気の弱い|内気な|臆病な
blot	インクのしみをつける|しみ|汚点をつける|汚れ汚点
vomit	嘔吐する|激しく流出する
illicit	違法の|不法な|無免許の|もぐりの|不義の|禁制の
poultry	家禽類|家禽
intensify	強める
saline	塩分を含んだ|塩からい|塩気のある|マグネシウム(含塩)下剤|生理的食塩水
elucidate	明らかにする|はっきりさせる|解明する|説明する
triumphant	勝ち誇った|勝利を得た|成功した|意気揚々とした
vastly	広々と|広大に|莫大に|大いに|非常に
filtration	ろ過
fractional	分数の
unrest	(社会的な)不安|心配|(社会的･政治的)動揺
allergic	アレルギーの|大嫌いな
coax	うまく説得する|なだめすかす(=persuade)|ご機嫌取り|同軸ケーブル(=coaxial cable)
abolition	廃止|全廃
cylindrical	円筒型の
unworthy	価値がない|価値のない|取るに足らない|に値しない
courtroom	法廷
outweigh	上回る
immortality	不死
parchment	羊皮紙|羊皮紙文書|卒業証書
weld	溶接する|結合する|溶接される|溶接点|溶接|密着
horseback	馬の背|馬に乗って|低い切りたった尾根
frantically	狂ったように
plume	羽を思わせるもの|羽毛|羽(飾り)|を整える|を羽毛で飾る
hillside	丘の中腹
underwater	水中の
statesman	政治家|優れた見識と能力をもつ政治的指導者
anemia	貧血(Anemia of Chronic Disease　慢性疾患性貧血)
individualism	個人主義
sensual	官能的な|好色な
reciprocity	互恵主義|再保険交換(保険用語)
durable	耐久力のある
commotion	動揺|動乱|興奮|騒動
rotor	回転部
aristocracy	貴族政治|貴族政治の国|貴族|貴族社会
capacitor	(電気)コンデンサー|蓄電器
facilitator	進行役
exclamation	絶叫|叫び|感嘆|(文法)感嘆詞
categorical	無条件の|絶対的な|明確な|分類上の|範疇に属する
intruder	侵略者|侵入者
immensely	莫大に|非常に
objectivity	客観性
prestigious	誉れの高い|名声のある
railing	ガードレール|手すり|さく
seminal	精液の|種子の|発生の|生殖の|未発達の|生産的な|独創性に富んだ
outstretch	〈手など〉‘を'伸ばす|広げる|〜‘を'枠(わく)(限界)を越える
phantom	幽霊|幻|幻影|幻像|人体模型|幻の|想像上の
working	働き|作用|仕事|運転|作業場|採掘所|労働に従事する|経営(上)の|実際に役立つ|使用状態の
mama	おかあさん|ママ|母様
subunit	サブユニット
thirsty	のどがかわいた
compatibility	適合性|一致
adore	尊敬する|あこがれる|礼拝する
turbulence	乱気流|騒乱|混乱|社会不安
milieu	(仏語|中間の意)|環境|境遇
junk	がらくた(にする)|麻薬|ジャンク(中国の平底帆船)|破棄する
treason	背信|反逆|大逆|反逆罪(国家転覆を企てた罪)
prostitution	売春|堕落
oblivious	記憶していない|忘れっぽい|気づかないで|忘れさせる
shaky	震える|揺れる|当てにならない|不安定な
envision	心に描く|想像する
redefine	再評価する|定義し直す|問い直す
plow	(馬･牛に引かせる)すき(犂)|耕す|すきで耕す|(=plough)|cf|hoe(鍬|くわ)
treasury	財務|国庫|基金|宝庫|宝物|公庫|資金
inertia	慣性|惰性|不活発|ものぐさ
abyss	深い淵|深淵|底知れない穴|地獄|底無し地獄
retinal	レチナール|ビタミンAアルデヒドでオプシンと共に視物質を形成する
concede	(正当だと)認める|容認する|与える|譲歩する
captivity	捕われの身|監禁|捕らわれ
frail	こわれやすい|もろい|虚弱な|か弱い|意志薄弱な|はかない
skepticism	懐疑論|懐疑主義|懐疑的な態度|無神論
causation	引き起こすこと|因果関係|因果説|原因|原因として働くこと
goodwill	善意|営業権
wizard	名人|魔法の|魔法使い(男)|魔術師
commune	親しく語る|コミューン|人民公社
gulp	盲信する|飲込む
indulgence	ふけること
spectator	見物人|傍観者|観客|傍聴人
pitiful	哀れな|哀れみを誘う|軽蔑に値する
inconvenience	不自由|不便|迷惑
interviewer	面接官|インタビューをする人
magician	魔法使い|奇術師|魔術師
demonic	悪魔的な|魔力をもった
flicker	点滅ライト|点滅する
circus	サーカス
lavish	を浪費する|物惜しみしない|気前のよい|贅沢な|豊富な|ぜいたくな
healer	神霊治療家|治療する人|宗教伝道治療師
clump	群がらせる|かたまり|木立ち
boiler	ボイラー
preoccupation	先入観|先取|気を取られていること|夢中|偏見|先入主
solicit	せがむ|懇請する|請い求める|を求める
gallant	勇ましい|勇敢な|雄々しい
relinquish	を放棄する|をやめる|断念する
etiology	病因(学)|因果関係学
apostle	使徒
ppm	百万分の1単位|parts per millionの頭文字|百万分率
endemic	風土性の|その土地特有の
reassure	再保証する|安心させる
surname	姓|姓名|あだ名をつける|あだ名
poster	ポスター
brew	醸造する|計画する|醸造物|調合する|起ころうとしている
mystic	神秘主義者|秘伝の|神秘的な|秘教の
clergyman	聖職者|牧師
peg	くぎで止める|くぎ|かけくぎ|テントのくい|弦楽器のねじ|洗濯ばさみ
unison	調和|一致|ユニゾン|同音|斉唱
dividend	公債利息|(株の)配当金|配当(金)|分け前
traveller	旅行者|(US英)traveler
awhile	しばらく
clot	凝塊する|塊
knowledgeable	知性のある|よく知っている
discriminatory	差別的な
tangle	をもつれさせる|を紛糾させる|を罠にかける|けんかする|混乱|もつれ|ごたごた
divergent	互いに異なる|分岐する|それている
bounce	はねる|弾む|活気
abscess	膿瘍(のうよう)|生体組織内に|崩壊した好中球由来の分解酵素で化膿性炎症が生じ|膿を持った空洞ができた状態
shrimp	小エビ|ちび|とるに足らない物
recognizable	認識された
eradicate	を全滅させる|を根絶する|しみを取る|撲滅
exhaustive	徹底的な|網羅的な|枯渇させる|消耗的な
misconduct	非行|姦通|まずい経営|職権乱用|管理を誤る|やりそこなう
superb	すばらしい|荘厳な|豪華な|とびきりの
excite	興奮させる|刺激する|エキサイト
squash	カボチャ|つぶれる|押し(踏み)つぶす|ぺちゃんこ|スカッシュ(競技名)
trump	切り札|奥の手
informative	知識(情報)を与える|有益な
enlarge	範囲を広げる|を大きくする|増大させる|広がる|詳細に述べる
carpenter	船大工|大工|木工
modality	様相|法性
stocking	ストッキング|蓄える|靴下
estrogen	ステロイドホルモンの一種
pang	発作|激痛|心の痛み
masterpiece	傑作|名人芸
gust	突風|突然の噴出|一陣の風|にわか雨
competency	有能さ|コンピテンシー
granddaughter	孫娘
squeak	キーキー音を立てる|チューチュー鳴く(声)
cleanse	清潔にする|浄化する
concur	同意する|一致する|協力する
overflow	からあふれる|氾濫する|あふれる|いっぱいになる|氾濫
furthermore	その上|なおその上に
hey	おい!|ちょっと|おい
westward	西向きの|西へ
formality	形式的なこと|堅苦しさ|几帳面さ|手続き|儀礼的行為
ape	サル|尾のない猿|猿の中でも人間に近い類人猿
gasoline	(米語)ガソリン
clarification	明確化
recreational	レクリエーションの|娯楽の|気晴らしの|休養の
mercury	水銀
deepen	深める
dichotomy	二分法|意見の相違|分裂|分すること
pleasantly	楽しく|愉快に|心地好く|愛想よく
zoom	急上昇|急上昇する
tenderly	そっと(gently)|慎重に|鋭敏に|やさしく
unconditional	無条件の
crater	クレーター|噴火口
judiciary	司法の
saliva	唾液|つば
pear	西洋ナシ|西洋梨
vocation	使命|職業|商売|天職|神のお召し
epithelium	上皮
fluorescent	蛍光の|蛍光灯
oracle	神託|神官|賢人
hoarse	しわがれ声の
distort	歪曲する|歪める|曲げる|歪ませる
dopamine	ドーパミン|中枢神経系に存在する神経伝達物質|アドレナリン|ノルアドレナリンの前駆体でもある
pane	窓ガラス|窓枠|鏡板|一抹模様の一目
taxable	課税
vertically	垂直に
oddly	奇異に|はんぱに|奇数に|奇妙に
chalk	チョーク|白亜
plump	どしんと(落ちる)|丸々と太った|ふくらんだ|たくさんの|を太らせる
proverb	ことわざ|諺|格言|通り言葉|たとえ|なぞ
catastrophic	悲劇的な
ammonia	アンモニア
radioactive	放射能の|放射性の
inject	に注射する|注射する
peninsula	半島
quench	をいやす|消す|欲望を抑える|を和らげる|を満足させる|急冷(する)|消火(する)|渇きをいやす|火などを消す
analogue	(=analog主に米)|アナログ(の)|類似(の)|相似(の)|(肉･魚もどきの)合成食品
enjoyable	楽しい
tack	針路|方針|がびょう|仮縫い|をびょうで留める
starvation	薄給の|飢餓|窮乏|飢え|餓死
befall	に起こる|降り掛かる
tactic	順序の|方策
underestimate	過小評価する
selectivity	選択性
subsystem	サブシステム|コンポーネントシステム|下位組織
trustworthy	信頼のあった|信頼に足る
shipment	積出し|発送(品)|船積み(荷)|積み荷
papa	パパ|おとうさん
whisky	ウイスキー
ceremonial	儀式上の|儀式
dude	男|やつ|野郎|(呼び方として使われる)
whiteness	白さ|青白さ|潔白
impetus	勢い|刺激|推進力|起動力|はずみ
concession	利権|特権|許容|免許|特許|譲歩
affliction	苦悩|不幸|悲嘆|苦痛
bunk	(船･列車の)寝だな|寝台|ごまかし|逃亡|ごろ寝する
plough	(馬･牛に引かせる)すき(犂)|北斗七星(The Plough) 耕す|すきで耕す|(=plow) cf|hoe(鍬|くわ)
gig	ジャズ演奏の仕事|競漕用ボート
unfinished	未完成の|荒削りの|(ペンキなど)未仕上げの
guerrilla	ゲリラ兵|不正規兵
stanza	連|節|一ヶ所での興行期間|一区切り
guild	同業組合|商人団体|ギルド|組合
unnoticed	注目されない|気付かれない|無視されている
milestone	マイル標石|画期的事件
endpoint	エンドポイント
patriotism	愛国心
conducive	ためになる|助けになる|のためになる
dew	露|しずく|みずみずしさ
purposely	わざと
nucleotide	ヌクレオチド(化合物)
dialectic	弁証法的な
moth	ガ|蛾|シミ|虫食い
mercenary	傭兵|欲得ずくの|報酬目当ての
mol	モル(物質量の単位)
deletion	欠失|削除|消去
stunt	を妨げる|発育を止める|発育阻害|妙技|離れ業|人気取り
diffraction	回折
eagerness	熱心
saloon	談話室|酒場|広い場所(部屋)|大広間|客室
earl	伯爵
maturation	成熟
remotely	およそ|遠く離れて|関係が薄く|時間が遠く隔たって|間接的に|よそよそしく|冷淡に|これっぽちも
ordeal	厳しい試練|苦しい試練|試罪法|神明裁判
chilly	よそよそしい|寒い|冷たい|寒気がする|冷淡な
adhesive	付着力のある|粘着性の|記憶から消えない
caravan	キャラバン|隊商|幌馬車|移住民の車馬隊|キャンピングカー(和製英語)
equate	等しく扱う|同一視する
reactivity	反応性
suspend	中止する|一時中断する|吊す|延期する
yo	やあ
heterosexual	異性愛の(homosexualに対し)|性の異なる|異性の|正常性癖の
morale	志気|風紀|勤労意欲
prep	準備
inhibitory	抑制する
alight	燃えて|明るく照らされて|車･馬から降りる|偶然発見する
pluck	を引き抜く|(羽を)むしり取る
shrill	鋭い音を出す|鋭い|かん高い
benevolent	慈悲深い
marijuana	マリファナ
confine	閉じ込める|制限する|監禁する|境界
evacuation	撤退|排出|排気
grind	すりつぶす|こすりつける|すり減らす|つらい単調な仕事
redundant	余分の|余剰の|冗長な
overarch	〜‘の'上にアーチをかける|アーチ型になる
paralysis	中風|麻痺(状態)
manure	こやし|肥料|肥料をやる
faction	派閥|党派|党争|実話小説|内紛
lizard	トカゲ
opening	開いている|開始|始め|広場|穴|空き|開始の|すきま|開き
maple	カエデ|楓
rainy	雨の|雨の多い
digestive	消化の|消化を助ける|消化力のある|蒸解の|消化剤|消化薬
regulator	調速器|レギュレータ
nuanced	微妙な
acetate	アセテート
torrent	ほとばしり|急流|激流|奔流|豪雨|土砂ぶり|連発
tentative	試験的な|仮の|試案|仮説
brook	小川
ta	ありがとう(英略式)
rosy	バラのような|楽天的な|有望な|薔薇色の|赤面した
ovary	卵巣|子房
trout	マス|鱒
preferably	むしろ|できれば|なるべく
uniformity	一様(性)|均一(性)|同一性|一律|画一性|一貫性|単調
eg	(ラテン語)「for example」(例えば)の意
artifact	加工品|人工物|工芸品
hearing	審理|公聴会|聴力
dubious	あいまいな|怪しい|心もとない|疑わしい
hydrolysis	加水分解
feudal	封建制度の|封建の
attest	証明する|誓言する|実証する
diner	食事する人|食堂車
anomaly	例外|変則|異常|変則的なもの|異形|偏差
converter	改宗させる人|転炉|(原子力)転換炉|(電気)変換器
perennial	多年生の|絶え間ない|四季を通じての|年中絶えない|永続的な
hostess	女主人(役)|ホステス|女支配人
adrenal	副腎の|副腎|腎臓付近の
receptive	受容性に富む|感受性の強い
multicultural	多文化的な
ethic	道徳律|倫理
cosmos	(秩序と調和ある)宇宙|完全体系|調和|コスモス
chronological	年代順の
cardboard	厚紙|ダンボール|段ボール
suffrage	選挙権|投票|選挙
grit	軋らせる|小砂
fortnight	2週間
rein	手綱|統制|手段|拘束|指揮|制御する
hasten	急いでする|急ぐ|急いで～する|急がせる|せきたてる
multilateral	多数国参加の|多辺の|多国間の
exemplary	模範的な|称賛に値する|見上げた|りっぱな|見せしめの|戒めの
clumsy	無器用な|不格好な|不器用な
adrenaline	アドレナリン|刺激剤|神経伝達物質またはホルモンとして働く
chestnut	クリ|栗
piss	小便(をする|婉曲にはpee)|go on the piss大酒を飲む|(itを主語にし)どしゃ降りである|piss away浪費する|(他)piss off怒らせる|(嫌悪)ちくしょう
narration	ナレーション|叙述|物語ること|話法
drastically	猛烈に|ばっさりと|急激
autoimmune	自己免疫
tedious	たいくつな|退屈な|あきあきする|冗漫な
totality	全体性|完全(性)|全体|皆既食
traction	牽引
supplementary	補充(追加)されたもの|補充の|補足の|補遺の
emulate	と競う|努力する|熱心に見習う|ふりをする
anaerobic	anaerobic(bacteria|digestion|mud|fermentation|decomposition) 嫌気性(菌|消化|泥|はっ酵|分解)
donation	寄付
educator	教育者
courageous	勇気のある|勇敢な
constable	警官 
decorate	勲章を授ける|飾る
diaspora	紀元70年|ユダヤ人の世界離散（ディアスポラディアスポラ(バビロン捕囚後のユダヤ人の離散・四散)|離散した全ユダヤ人|離散した場所|イスラエル以外のユダヤ人居住地
joyous	とてもうれしい
evaporation	蒸発|揮発|気化
climatic	気候の|気候上の
majestic	壮厳な|威厳のある|雄大な
genomic	ゲノムの
survivor	生き残った人|生存者|遺族|遺物|測量士|検査官|鑑定士
mildly	おだやかに|穏やかに|やさしく|少し
iterative	反復の
surfactant	界面活性剤
throughput	処理能力
ante	掛金|割り金
vividly	いきいきと|活発に|あざやかに
compilation	編集|編集物|寄せ集め
disperse	分散させる|散らす|散乱させる|解散させる|分散する
remnant	生存者|残り|面影|残留|売れ残り
yoke	くびき(1組の牛の首を束縛する板)を付ける|くびき|絆|束縛
willow	ヤナギ|柳|やなぎば色
infiltration	他国の破壊活動への秘密理の関与|浸潤|染み込むこと
infarction	梗塞
transistor	トランジスター
diversification	多様化|多様性|多角化|分散投資
psalm	聖歌|賛美歌
whore	売春婦|Attention Whore(俗|見て見て|などの意)
fret	腐食する|むしばむ|苛立たせる|いらだち|苦悩|稲妻模様|(雷文)浮彫り
extravagant	過度の|浪費する|贅沢な|法外な|膨大な
vortex	(pl|vortices)|渦巻|渦
eccentric	普通でない|変人|一風変った|常軌を逸している
corrective	訂正する|訂正の
salvage	残余財産売得金|海難救助|救助|財産救出|救出|を持ち出す|を救い出す|回収|廃物利用|救助する
veto	拒否する|拒否権|拒否権の行使|拒否|禁止
deference	服従|意見に従うこと|敬意
edible	食用になる|食べられる
payoff	賄賂|利益|支払|収益|献金
paw	(肉球のある)手|足|客間|居間|店|診察室|手荒く扱う|前足で叩く|前足で掻く|蹄で掻く
bruise	打撲傷|打ち身|挫傷|傷跡|傷つける|に傷を与える|へこませる|あざをつける
motivational	やる気を起こさせる
examiner	試験官
mantra	マントラ|真理を表す秘密の言葉|呪文|持論|主義|信念|モットー|スローガン
apoptosis	アポトーシス|細胞の寿命死
peacefully	平和に|穏やかに
neonatal	新生児の
satin	サテン(なめらかで光沢のある絹織物)|しゅす(織)
planetary	惑星の|起動を回る
rubbish	ばかげたこと|ナンセンス|くだらないこと|ゴミ|廃物
distributor	代理店|ディストリビューター
suicidal	自殺の
baron	男爵|財界人|大実力者|～王
robotic	ロボットの(ような)|ロボット利用の
cookie	クッキー(焼き菓子)(俗)やつ|魅力的な女
enrollment	登録|入学
palpable	触知できる|容易に知覚できる|明白な|簡単に分かる
ardent	情熱的な|熱心な|熱烈な|燃えている|燃えるように輝く
humankind	人間|人類
voter	投票者|投票権所有者|選挙人
grape	ブドウ|深紫色
indictment	告発|起訴(手続き)|告訴|起訴状|非難|攻撃
widen	広くする|を広くする|広くなる
untouched	触れない|そのままの|未踏の|感動しない
isotope	(物理学)同位元素
burger	ハンバーガー|かすり傷
cosmopolitan	世界主義の|世界的な|世界を家とする|全世界的な|世界人|国際人
unavoidable	避けられない|やむをえない
aviation	航空術|航空学
pluralism	多元論|兼職|複投票|複数制|社会的多元主義
impair	害する|損なう|減じる|弱める|悪くする
symbolism	象徴主義
flutter	はためく|ひらひら舞う|どきどきする|動揺|おののき|パタパタ|ヒラヒラ|はためく音
ominous	不吉な|不気味な|縁起の悪い|前兆となる
adversity	不幸|逆境|困窮|不幸なできごと|災難
preschool	学齢前の|就学前の|幼稚園
bloc	ブロック|団体|圏|議員連合|政治|経済上のブロック(the dollar blocドルブロック|貿易決済がドルで行なわれる地域) (blockは別単語)
censorship	検閲|検閲官の職
revel	大いに楽しむ|享楽する|凝る|酒盛りをする
wrestling	レスリング
pituitary	下垂体(の)
reunion	再結合|再会|親睦(しんぼく)会
synthesize	を統合する|を総合する|を合成する
cessation	中止|停止|休止
freshwater	淡水
wont	習慣|し慣れた
inflow	流入|流入物|流入量|受領される|流入する
decorative	飾りになる|装飾の|装飾的な
thoracic	胸(部)の
malice	悪意|恨み
inseparable	分けられない
hesitant	ちゅうちょする
kinetics	動力学
maxim	格言|ことわざ|金言|行動原理|処世訓
stoop	かがむ|腰が曲がる|を曲げる|品位を落とす|ポーチ
predicament	断定されたもの|窮地|苦境|窮状|状態|境遇|苦しい立場
henceforth	これからは
puncture	パンク|刺すこと|穴を開けること|刺し傷|を刺す|刺す
completeness	完全
marvellous	驚くべき|不思議な|素晴らしい|驚嘆すべき
externally	外部から
fable	寓話(ぐうわ)|作り話|伝説|神話
stainless	ステンレス|奇麗な
hi	やあ|こんにちは
patio	(米語)パティオ(テラス,中庭)
coexist	共存する
agonist	アゴニスト(作動薬)|Autoradiography(放射線写真法)でリガンドの代わりに使う薬物|生体内の特定のreceptor(受容体)に働く
cruiser	クルーザー|巡洋艦
inaccurate	不正確な
strategically	戦略的に
discredit	の信用を落とす|疑う|不名誉
dungeon	地下牢
counteract	の影響を弱める|妨げる
shadowy	影のある|陰になっている|はっきりしない|非現実的な
addict	熱中させる|麻薬中毒者
symbolize	を記号で表す|を象徴する
nationwide	全国的な(に)
concubine	男と同棲する女|内妻|愛人
metastatic	(がんの)転移性の
font	洗礼盤|聖水盤|油壷|フォント(書体)
synonymous	同意語の|同義語の
augment	増す|補強する|増大させる|増加する
observational	観測の
leisurely	ゆっくり(と)|急がない
ordinarily	たいてい|通常|普通は
razor	かみそり
cocoa	ココア
sacrament	神秘|秘跡|聖体
aerobic	好気性の
parity	(量|質など)同等であること|等価|同等|類似|平衡|対応|欄干|パリティ
cherish	を大事にする|かわいがる|いつくしむ|感情を心に抱く
reportedly	伝えるところによると|聞くところによれば
trot	足早に歩く|小走りする|速歩|(馬が)早駆けする
whereabouts	(人･物のおよその)所在|位置|居所|どのあたりに
whine	すすり泣く|ぐちをこぼす|哀れっぽい声|犬の鳴き声
rabbi	ユダヤの律法学者|ユダヤ教の聖職者;その尊称
circulate	循環させる|流通する
tiptoe	爪先|つま先|つま先で歩く
monastic	修道院(僧)の|禁欲的な|隠遁的な
uniqueness	異常|風変わり|無比|唯一
metaphorical	隠喩的な(=fugurative)
provisional	仮の|一時的の|暫定的な
photographic	写真(用)の(ような)|鮮明な
solicitor	懇願者|事務弁護士|勧誘員|個別訪問の販売員
leukemia	白血病
wrench	ねじる|(事実を)曲げる|歪曲する|もぎ取る|レンチ|かなしみ
pelvis	骨盤
filler	filler 詰める人(もの)|(重さ･量などを増すための)混ぜ物|詰め物|充填材|注入器
nuisance	やっかいもの|迷惑な行為|妨害|やっかい物|うるさい人|迷惑|やっかい
dissatisfy	満足させない
knob	ノブを付ける|ノブ|こぶ
bondage	束縛|とらわれの身|奴隷の身分
disparate	異なる|共通点のない|色々な人々|異質
intelligible	理解できる|わかりやすい|知性的な
loom	ぼんやり現れる(こと)|不気味に迫る|織機|織物機械
humorous	ユーモアを解する|滑稽な|ユーモアのある
vapour	蒸発気(湯気|水蒸気など)
compile	を編集する|(資料など)を集める|(財産など)を作り上げる
stately	威厳のあった|威厳のある|堂々と
exhale	吐き出す|発散する|息
vagina	腟
degeneration	退化|退歩
polity	政治形態(組織)|政治的組織体|国家組織
curly	捻れた
alkaline	アルカリ性
grandeur	雄大|壮大
lance	切開する|槍
shotgun	ショットガン|散弾銃
tingle	ずきずきする|ひりひり痛む|うずく|がんがんいう|ぞくぞくする
nationally	全国的に
timeline	タイムライン
obese	でっぷり肥えた|肥満体の|肥満
monograph	研究論文|モノグラフ|専攻論文
needy	貧窮している|非常に貧乏な
recoil	しりごみする|はね返り|後座する|退却する|畏縮する|ひるむ|跳ね返る|反動する
orthogonal	直交する
startup	スタートアップ|開始
fullness	充満|十分|肥満|(音色などの)豊かさ
propriety	礼儀正しさ|礼儀正しいこと|礼儀|礼節|妥当|適当|妥当性
reflexive	再帰動詞(代名詞)|再帰の
incarceration	監禁|投獄|幽閉
indefinite	限界のない|不明瞭な|不正確な|(文法)不定の
bleak	荒涼とした|厳しい|寒々とした|冷たい|わびしい
securely	安全に|しっかりと
commemorate	記念する|を祝う
influx	流入|到来
closeness	密接
motto	モットー|座右の名|標語|題字
coating	コーティング
ozone	(化)オゾン|新鮮な空気
redistribution	再区分|再配分|再分配
enthusiastically	熱心に
somatic	(精神に対し)身体(上)の|肉体の
prominently	顕著に
prosecute	を起訴する|遂げる|を告訴する|を要求する|を遂行する
psychoanalysis	精神分析
ventral	腹の|腹部の|腹面の
salinity	塩分|塩度
memo	覚え書き|メモ|摘要
plurality	多数|過半数|数多性|兼職|複数(であること)|多数の
workout	試験|(スポーツ)練習|トレーニング|運動|骨の折れる仕事
anthropological	人類学(上)の
extinct	希望が絶たれている|廃止された|活動をやめた|生命力が絶えた
nigh	近くに|近い
ingenious	工夫に富んでいる|器用な|精巧な|独創的な
jelly	ゼリー
infringe	侵害する|違反する|(法律などを)犯す|破る
pudding	プディング|プリン|腸詰め|物質的利益|実益
carbohydrate	炭水化物
supervisory	監督上の
insanity	狂気(のさた)|精神異常
erroneous	誤った|誤っている
commencement	開始|学位授与式
demeanor	ふるまい|行ない|態度|物腰|様子|表情
nourish	に栄養分を与える|養う|に滋養物を与える|育てる|助長する
objectively	客観的に
sprout	芽|若者|芽キャベツ|を発芽させる|発芽する
rouse	の感情を高ぶらせる|の目をさまさせる|人を奮起させる|目を覚ます|起きる|覚醒|激励者
environmentally	環境的に
wanna	したい|(=want to 口語)
oblique	斜行進する|間接の|斜めの|遠まわしの
chemist	化学者|薬屋
taboo	禁止された|禁忌|タブー|忌み言葉|禁制|禁止
trance	失神|有頂天|恍惚状態|夢中|昏睡状態
deduct	控除する
inadvertently	うかつに|不注意に
beak	(肉食鳥の)くちばし(=bill|beak|pecker|nib|neb)|(水差しの)飲み口|(カメなどの)口先
commute	取りかえる|切り替える|換算する|通勤･通学する
lifeless	生物のいない|生命のない|活気のない|気絶した
prolong	長くする|延ばす|を延期する|を延長する|長引かせる
delve	調査する
pavilion	大型テント|展示館|パビリオン|観覧席|別棟
curry	カレー|馬ぐしでこする|(なめし革に)油で光沢を付ける
specialization	特殊化|限定
cuisine	料理|料理法|料理場|厨房
reorganization	再編成|改組|改編|(金融)再建|立て直し
shawl	ショール|肩掛け|にショールをかける
bonnet	婦人用の帽子|ボンネット
convoy	護衛する|護送する|護送
deterministic	決定論的な
spotlight	スポットライト
thinker	思想家
sewage	下水|汚水
transmitter	送信器|送る人|伝達者|伝達装置|譲渡者|伝導物|送信機|送話器
congestion	港での船混み|密集|混雑|人口密集|うっ血
drastic	徹底的な|徹底した
immoral	不道徳な