genital	生殖の|性器の
spurt	ほとばしり出る|発芽する|噴出する|疾走する|を噴出させる|をほとばしらせる|スパート
hypocrisy	偽善
synonym	類義語|同意語
allude	ほのめかす|それとなく言う
honeymoon	新婚旅行(をする)|蜜月(期間)
ocular	目の|視覚による|ocular proof 目に見える証拠|接眼鏡
obligatory	義務的な
adequacy	妥当性
uncontrolled	自由な|制御されていない|放置された|抑制されていない
confide	に打ち明ける|委託する|信任する|信頼する
tenor	男性の高音部歌手
manpower	人的資源|人力(工率の単位=1|10馬力)|労働力|動員可能人力
bluntly	無作法に|ぶっきらぼうに|無下に
shortcut	近道
cortisol	副腎皮質ホルモンの一種|炭水化物|脂肪|タンパク代謝を制御する生体に必須のホルモン
swan	白鳥|きわだって美しい人|(俗)美人
humid	湿度の高い|多湿の|むしむしする
thermometer	温度計|寒暖計|検温器
foyer	休憩室|ホワイエ|ロビー|玄関の広間
resistor	(電気の)抵抗器
gluten	グルテン|麩質(ふしつ)
spindle	紡錘|軸|スピンドル
spacecraft	宇宙船
berth	停泊所|寝台|段ベッド|宿|停泊位置
contraceptive	避妊(用)の|避妊薬(具)
lull	(子どもを)寝かしつける|和らげる|心なごむ音|小康状態
wreath	花輪|花|花冠|輪状のもの
unimportant	重要でない|ささいな|取るに足らない
centrally	一元
guru	《しばしばG-》ヒンズー教の教師|導師|尊敬する師(指導者)
photosynthesis	光合成
horrific	恐ろしい
multivariate	多変量の
variously	いろいろに
occult	神秘(の)|超自然的な|隠れる
doorbell	戸口のベル
originality	独創性|オリジナリティー
firstly	まず第一に
precaution	予防|予防策|用心|警戒
fearless	恐れを知らない
amuse	を楽しませる|笑わせる
swipe	大振りで打つ|強打する|盗む|かっぱらう|強打|大振り|がぶ飲み
inadequacy	欠点|不十分|不足|不適当|不備|無能
apprenticeship	見習い
horde	群落になる|大群
felony	重罪(強盗･殺人など)
psychologically	心理的に
intracranial	頭蓋内の
scoundrel	悪党|悪漢
delineate	の輪郭を描く|線引きする|絵で表わす|(詳細に)描写する
psychoanalytic	精神分析の
stupidity	愚かな考え|愚かさ|愚行
hormonal	ホルモンの|ホルモンの影響をうけた
nothingness	無|空|無意義・無価値
heave	力をいれて持ちあげる|あえぎ|胸が波打つこと
asphalt	アスファルト
vertebral	脊椎の
vegan	完全菜食主義者
odour	(UK英)香り|匂い|臭気|芳香|気配
pharmacist	薬剤師
troll	トロール(北欧民話で洞穴に住む巨人･小人)|陽気に歌う|輪唱する|流し釣りする
recur	再び起こる|再発する|思い出される|繰り返される
lipstick	口紅
paranoid	偏執性の|偏執症の(患者)の|偏執(誇大妄想)的な|偏執症患者
grenade	手りゅう弾|手榴弾|催涙弾
metadata	非常に大量のデータ
flinch	しりごみする|たじろぎ|ひるむ
preferential	優先の|特恵の
ghastly	青ざめた|恐ろしい
briskly	きびきびと|活発に
succumb	屈服する|圧倒される|敗ける|死ぬ
radiotherapy	放射線治療
goddamn	こんちくしょう
flexion	曲がること|屈曲(部)|湾曲(部)|屈曲作用|語尾変化
obsessive	つきまとう
po	おまる|しびん|トイレ|便所
ratification	批准|承認
invoice	インボイス|送り状
relocation	(米語)(第二次大戦中の日系人)強制収容|再配置|移転
admiral	司令長官|海軍大将|指令長官
prognostic	予後の
mixer	ミキサー|音量調整係|社交家
rationalize	正当化する|合理化する|理屈づける
vodka	ウォッカ
generality	一般的な考え
fauna	(地方または一時代の)動物群|動物区系|動物相
subvert	くつがえす|(国家などを)打倒する|滅亡させる|堕落させる
spinach	ホウレンソウ
extrinsic	庭の敷石
solute	溶質(解けている物質) cf|solvent溶媒(溶質を溶かしている溶液)
rightful	正当な
musket	マスケット銃
cloudy	雲の|曇った
groin	(解剖学)鼠蹊(そけい)|腿の付け根
drizzle	小雨が降る|霧雨が降る|霧雨
dime	10セント銀貨
prowess	武勇|勇敢
haughty	おうへいな|傲慢な|偉そうに構えた|お高くとまっている
tweet	小鳥がさえずる|チッチッと鳴く|さえずる|呟く|tweetする
iris	(眼球の)虹彩(こうさい)|アヤメ|アイリス
hateful	憎しみに満ちた|憎い|憎むべき|ひどくいやな
horribly	恐ろしく
luncheon	昼食をする|弁当
ghetto	スラム街
coagulation	凝固
orient	東洋|東に向ける|適応する|真珠の光沢
makeshift	仮の|間に合わせの|一時しのぎの
adjunct	付属物|添加物|修飾(付加)語句
barricade	妨害するもの|障害物|バリケード(を築く･で囲む)|戦場
prostitute	金のために売る|売春婦
outperform	より仕事が(能力が)勝っている
benevolence	慈善|慈悲心|博愛|善行|善意|(=charity)
subcutaneous	皮下
pierce	ピアスをする|を刺す|を貫く|に穴を開ける|突き進む
incompetent	不適任な
prima	気難しい女|主役女性歌手|プリマドンナ|主なる|首位の|第一の
anonymity	匿名|無名(の人)
salesperson	セールスマン(nonsexist)
superpower	異常(強大)な力|過力|超出力|超強大国|超大国
forestry	林学|林業
rationally	合理的に
prism	プリズム|分光スペクトル|柱
ambivalent	あいまいな|相反する物･意見･感情を持つ
appellate	上訴(控訴･上告)の|上訴(控訴･上告)を処理する
cystic	嚢胞性の
airborne	空輸の|空挺の|空輸された|空気電送|空中の
interpolation	差し挟むこと|書き加えた語句|書き入れ|書き入れられた語句|改ざん|原文改変|内挿(法)|補間(法)
squarely	四角に|公平に|まともに
insomnia	不眠|不眠症
appease	静める|なだめる|鎮める|和らげる
lyric	竪琴の伴奏にあわせた|叙情的な|叙情の|歌の|叙情詩|歌詞
apocalyptic	黙示録の|終末論的な|将来の不幸を予言する
exemplar	手本|模範|典型|見本|標本|謄本
synergy	相乗効果
moustache	口ひげ
dashboard	泥よけ|ダッシュボード
fisherman	漁師
concussion	衝撃|脳震盪
childbirth	出産|分娩
etiquette	エチケット|礼儀作法
psychotic	精神異常者|精神病の|病性の
proliferate	増殖させる|増殖する|繁殖
secrete	隠匿する|を分泌する
automaton	自動化|ロボット化
disable	身体的障害のある|injured
spade	スペード|踏鋤(すき)|鋤
fictitious	架空の|偽の|創作上の|虚構|虚偽|架空
beep	時報音|ビーッと鳴る|プープー|車のクラクションの音
decisively	断固として
dent	へこみ|へこませる
legality	適法|合法(性)
labyrinth	迷路|迷宮
accomplice	共犯者
corporal	肉体の|身体の|個人的な|(軍隊)伍長(最下位の下士官)
representational	(絵画や芸術様式が)具象主義の;表象の写実的な
plaza	(スペイン語)(都市の)広場|プラザ|市場
hover	空中に舞う|施空する|うろつく|さまよう
chemically	化学的に|化学反応により
deceptive	人をだますような|ごまかしの
polymeric	重合体の
insightful	洞察に満ちた
modernism	現代的思考(精神･特徴)|現代風|近代主義
abstain	慎む|控える|絶つ|やめる|禁酒する
posit	仮定(する)|肯定的に仮定する|置く
endanger	危うくする
dainty	きゃしゃな|優美な|上品な|繊細な|おいしい
runoff	決選投票|(同点者の)決勝戦
mucosal	粘膜の
ballroom	ダンスホール
synaptic	シナプス(接合)の|ソフトウェア名|他
tributary	貢献者|属国|(川の)支流
deviant	外れた|逸脱した|変質者
cartel	企業連合|カルテル|国際的な政治･経済集団
inexplicable	不可解な|説明しがたい
aorta	大動脈
stag	男だけの|雄|雄ジカ|ニワトリの雄|Stag beetle(クワガタムシ)
obscurity	薄暗がり|あいまい|不明瞭|難解|名もない人
rue	後悔する|悲しむ|(植物)ヘンルーダ(薬用)
piston	ピストン
lass	若い女|少女|恋人
wellness	ウエルネス|健康なライフスタイルを追求すること|フィットネスと共に80年代後半から米国で使用される
stony	石だらけの|無感覚な|石の(多い)
imperialist	帝国主義の
historiography	歴史学|史書|(記録された)史実|(厳正な)歴史記述|正史
biologically	生物学的に
freshman	1年生
afterlife	晩年|来世
biosynthesis	生合成
manageable	御しやすい|扱いやすい|従順な|処理しやすい
defiant	挑戦的な|反抗的な|傲慢な
retribution	仕返し|報復|報い
neurotransmitter	神経伝達物質
undisturbed	じゃまされない|乱されない|じゃまのはいらない|平静な
reprimand	叱責(する)(rebuke)|懲戒(する)|戒告
platoon	(歩兵の)小隊|一団|一斉射撃
legitimize	合法化する|適法とする
kindred	血縁の|同類の|血族|親類
sufferer	苦しむ人|被災者|病人
fir	樅(モミ)の木|材
boar	(去勢しない)雄豚|雄豚の肉|イノシシの肉
devastation	荒廃|破壊
baker	パン屋|携帯用小型天火
mistrust	信用しない|不信|信頼しない|疑う|推測する
sire	の種馬となる|を産む|種付けする
chronology	年代学|年代記|年表
benefactor	恩人|恩恵を施す人|保護者|後援者
inexperienced	初心の|至らぬ|至らない|半人前の|不慣れ|駆け出し|未熟|無経験な|不慣れで
sender	送り手
metre	メートル
commonality	共通性
sine	サイン|正弦|なく|なしに
gestation	妊娠|懐胎|妊娠期間|立案|計画を練ること|その期間
hitch	ぐいとうごかすこと|つなぐ|引張る|ひっかける|障害
camouflage	カムフラージュ|迷彩|偽装
woo	に求婚する|口説く|を手に入れる|せがむ
township	郡区|町区
thyself	なんじ自身(を|に|で)
undeniable	否定できない
amenable	素直な|従順な|従う義務のある|影響をうけやすい
punk	パンクファッション(の人)|くだらぬもの|たわごと
spout	とうとうと話す|吹出す|(～を)べらべらしゃべる|噴出する
vigilance	警戒|用心|不眠症|不寝番
dormant	眠っている|休止状態の|不動の|固定的な
nanny	おばあちゃん(=nan, nana, granny, grandma, granma, gran)|ばあや|乳母|子守|雌ヤギ
uneasiness	不安|不愉快|窮屈
particulate	微粒子
gutter	溝|とい|貧民街|とい･溝をつける
substantiate	実証する|立証する
gunshot	銃声|砲撃(音)|着弾距離|射程
coldness	寒さ|寒気|不感|冷ややかさ|冷感|冷静|冷淡
perpetually	永久に|ひっきりなしに
veterinary	獣医の|獣医
aux	auxiliary(補助の)の略
pickle	(通例複数)ピクルス(にする)|キュウリ|困った立場
actuality	現実|実在
suitability	ふさわしいこと|適切なこと|似合うこと
sup	(スープ･流動食)少しずつ口に入れる|夕食を供する
subordination	(〜より)下位に置くこと;(〜への)従属|服従《+to+名》
excretion	排泄|排出
perverse	つむじ曲がりの|ひねくれた(=crooked)|道理に反する|思いどおりにならない
rubric	(印刷物の)朱書き|(本･原稿などの)見出し|注釈|(祈祷書中の)典礼規範|ルブリカ|(手順などの)規程|指示|説明書き|慣例|朱刷りの|赤色で飾る
tentatively	暫定的に
purport	主旨|意味|意図|目的|(であると)称する|主張する|を意味する
hospitalization	入院
obstruct	遮断する|ふさぐ|妨げる
improbable	ありそうもない
tint	薄い色|色合い|気味|色彩|濃淡|淡い色
metropolis	首府|首都|主要な都市|大都市|中心地|本国|首都大司教管区
playfully	ふざけて
argumentation	議論|討論|立論|論証
envious	うらやましそうな
strikingly	際立って|著しく|目立って
referee	(特に決定･解決を)委託された人|調停者|審判|レフェリー
fertilization	受精
speck	小さい点|小粒|小さなしみ|小さな腐りきず|ちり|小片
hydrocarbon	炭化水素
ecstatic	夢中|有頂天の|忘我状態を伴う|忘我状態にさせる|うっとり|夢中の
sophistication	高度な知識|高い教養|品のある趣味|あか抜けた性格(趣味)|機械の精巧さ
masonry	組積造|石工術(職)|石造建築(工事)
senseless	意識を失った|無分別な|無意味な
cornerstone	礎石|肝要なもの|不可欠なもの|土台|基礎|いしずえ
spreadsheet	スプレッドシート|表計算ソフト
hypotension	低血圧(症)
effluent	流れ出る
reappear	再びあらわれる
peculiarly	独特に|特に|奇妙に
convolution	渦巻き|(数学)たたみ込み|(画像処理を実行するとき頻繁に用いられる計算のひとつ)
doctrinal	教義(学説)上の
reimbursement	＜reimburse|弁償
electorate	選挙民|有権者
abundantly	豊富に
pharmacological	薬理学(薬物学)の
anthology	アンソロジー|名詩(名文)選|詩集
sultan	(またはS-)トルコ皇帝|イスラム国王|サルタン|絶対君主|回教徒の君主
fraternity	同業者仲間|共済組合|友愛会|友愛団体|友愛|兄弟愛
eternally	永遠に
ping	おしっこをする|ピーンと音を出す|ピューと飛ぶ
postpone	を延期する|を延ばす|put off|を下位に置く
epidemiology	疫学
faire	放任
lightweight	ライト級|標準体重以下の人(物)|(競技)ライト級の選手|(口)つまらない人
unanimous	満場一致の|一致した|意義のない|合意の|同説の
rift	(地質学)マントル上昇による地表の分裂|割れ目|不和(=discord)
fingerprint	指紋(をとる)
iodine	ヨウ素(元素記号Iの元素あるいは分子式がI₂と表される二原子分子の呼称|ハロゲン元素の一つ|ヨードともいう|常温|常圧で固体で|昇華性がある)
caricature	風刺漫画|風刺|諷刺漫画|諷刺文
disconnect	ばらばらにする|絶つ|の関係(接続)を断つ|分離する|(電話･電源を)切る
mellitus	diabetes mellitus(糖尿病)|糖尿病|甘い
receptionist	受付係
takeover	接収|横取り|(管理･支配･所有などの)乗っ取り
underpin	支える
simplistic	極度に単純化した|簡単に割り切りすぎた
accelerator	(車の)アクセル
postcard	郵便はがき
sepsis	敗血症
bankrupt	支払い不能者|破産者|破綻者|欠如者
splinter	(木･石の)裂片|(木･竹の)とげ|破片|裂く|割る
nourishment	栄養状態|滋養物|食物|助成|育成
brotherhood	兄弟関係|組合|兄弟の間柄|同業者
embroidery	ししゅう|刺繍
conservatism	保守主義
conscientious	良心的な|誠実な
subconsciously	無意識のうちに
bookstore	書店
abduction	誘拐|拉致
apparition	幽霊|幻影|出現|見えてくること|思いがけなく現われる人
aberration	狂い|脱線(行為)|異常|精神異常|(光の)収差
artificially	人工的に
equip	に装備する|仕度を整える|備え付ける
bog	沼にはまる|沼地|沼
apprehend	理解する|感づく|感知する|の意味をとらえる|逮捕する(arrest のほうが一般的)
footman	(制服の)従者
overboard	船外に
ruby	ルビー|ルビー色の|紅玉(7月の誕生石)|深紅色|赤ぶどう酒|真紅の|ルビ(振り仮名用の活字)
theorist	理論家
propel	を推進する|を進ませる
avert	避ける|防ぐ|そらす|背ける
distillation	蒸留
fluency	なだらかさ|流暢
archaic	古風な|すたれた|古風の
multimedia	マルチメディア
structurally	構造的に
crook	ペテン|いかさま師|曲がり|湾曲|曲げる|(crooked ひねくれた|=perverse)
versatile	多方面な|多才な|融通がきく|変わりやすい|八方美人の
chisel	彫刻刀|のみで彫る|彫刻する
dice	さいころ
delicately	きめ細かに
subdue	を征服する|を抑える|鎮圧する|抑制する|緩和する
connector	連結者|コネクタ
minimally	最小限
hoop	たが|輪|帯鋼|(basketballの俗称)
retort	言い返す|しっぺ返しする|加熱蒸留器|レトルト食品
commandment	(神の)おきて|戒律
transducer	(エネルギーの)変換器(マイクロフォン|モーターなど)|変換部|磁気増幅器|送受波器
accrue	生じる|自然増加として生ずる|生ずる
superfluous	必要以上の|十二分の|不必要な|余分な
crave	熱望する|渇望する
avocado	アボカド
parasitic	寄生する
furrow	わだち|溝
flex	(関節など)曲げる|可撓(とう)線|電気コード|融通のきく|適応性ある
vigilant	油断のない|用心深い|眠らずに注意している
preparatory	入学準備の|準備の|予備となる|予備の|進学準備の
compulsive	強制的な
shady	日陰の|陰の多い|陰を作る|疑わしい
speedy	速い|迅速な
expire	満了する|終了する|満期になる|(息を)吐き出す|死ぬ
hilt	柄(え|つか)
unbroken	不屈の|こわれていない|(記録など)破られない
populism	人民主義
yank	ぐいと引っぱる|引っること
retrospect	回顧|追想
lieu	in lieu of ～の代わりに
tempt	を誘惑する|を導く|心を引き付ける
squirm	もじもじする|身悶えする|くねりながら進む
locomotive	移動する|移動力のある|機関車|応援
checkpoint	(通行)検問所|チェックポイント
atonement	償い
esophageal	食道の
ordination	聖職授与式
sarcastic	皮肉な|皮肉の|当てこすりの|皮肉|あてこすり
contagious	移りやすい|伝染性の
astray	邪道に入って|迷って|迷っている
invocation	祈り|発動|呼びかけ|(関数の)呼び出し(＝call)
lore	知識|学問|教え|伝承|伝承による知識
diligently	勤勉に|念入りに
victimization	虐待
preoperative	術前の|手術前の
cockpit	操縦室(席)|操縦席|闘鶏場|コクピット|戦場
counsellor	顧問|相談相手|弁護士|カウンセラー|(大使館の)参事官
nervousness	あがり|緊張感
enmity	敵意|悪意|恨み|憎しみ|反目
sanity	正気|(思想･判断などの)健全さ
leopard	ヒョウ|豹
relativity	相対性物理学|相対論|相対性原理
obstructive	じゃまな|閉塞性の
permutation	順列
platinum	プラチナ(色･金属元素)
unfavorable	都合の悪い|不運な|不利な|逆の|好意的でない|好ましくない
git	(ギット)|プログラムのソースコードなどの変更履歴を記録・追跡するためのバージョン管理システム
strut	気取って歩く(こと)|つっぱり|もったいぶって歩く|反り返って歩く
intoxication	陶酔|酔い
annuity	年金
nigger	(軽蔑的)黒人
refractive	屈折の
incorrectly	間違って
blackmail	脅迫|恐喝|ゆすり|武力による脅し
inconvenient	不都合な|不便な|不利な|迷惑な|厄介な
splendour	輝き
simplification	簡単にしたもの
bulky	かさばった
oblivion	忘却
replenish	再び満たす|補充する|満たす
strait	(複数形で)難局|困難|海峡
beginner	初心者
sporadic	ときどき起こる|孤立した|散発性の|散発的な|散在する
lexicon	辞書(特にギリシア語・ヘブライ語・ラテン語などの古典語辞典)　(特定分野の)語彙用語集　語彙目録
overestimate	過大評価する|買いかぶる
aloft	上方へ
dizziness	めまい|立ちくらみ
unconventional	慣例にとらわれない|自由な|(服装など)略式の
unwelcome	歓迎されない|もてない|ありがたくない
euro	ユーロ|EUの通貨
buggy	虫だらけの|1頭立ての|2輪馬車|自動車|バギー|うば車|(俗)気が狂った
havoc	(自然などの)大破壊|大混乱
dysfunctional	機能不全の
prostrate	ひれ伏した|屈服した|疲れはてた|倒す|屈服する
consortium	協会|組合|コンソーシアム
redesign	新しいデザイン|デザインを改める
whither	そこへ|何処へ
hydroxide	水酸化物
miserably	みじめに|貧弱に|みすぼらしく|みじめなほど
meridian	子午線|絶頂|放物線|経線の|正午の|頂点の
superstitious	迷信的な|迷信の
instrumentation	計測(器)
rebirth	再生|復活|新生(面)
phonological	音韻論の|音韻体系の|音韻的な
modifier	変更する人･物|修飾語句
interchange	置き換える
ulcer	アルサー|潰瘍(かいよう)
praxis	習慣|慣列|実習|練習
quarterly	年4回の|季刊誌
rapport	調和|調和する
thermodynamic	熱力学的な
maternity	母性|母であること|妊産婦のための|出産用の
durability	耐久力
coolly	よそよそしく|涼しく|冷たく|冷静に|冷淡に
steroid	ステロイドとは|分子中にステロイド核という構造をもつ有機化合物の総称|ほとんどの動植物で生合成され|コレステロール|ビタミンＤ|ステロイドホルモン等が代表例
attacker	アタッカー|攻撃する人|襲撃者|攻撃機
eerie	不気味な|薄気味の悪い|異常な
appalling	ぞっとするような|すさまじい|(口)ひどい|あきれるほどの|はなはだしい
escalation	段階的拡大|エスカレーション
annihilation	(ənὰɪəléɪʃən)|全滅|崩壊|無効化|消滅
diaper	おむつ|ひし形模様(のある布)
omen	前兆|予感|予言
foreman	作業長|職長|現場主任|現場監督者
undocumented	文書化されていない
silvery	銀の(ような)|銀を含む
proficient	熟練した|堪能な|敏腕な|塾達した|熟達した
doc	先生|医師または名前のわからない一般人に対する呼びかけ
withhold	与えないでおく|保留する|を抑える|控える|差し控える
biographer	伝記作家
porn	ポルノ
inefficiency	非効率
bathe	水浴させる|入浴する
blight	障害|(植物を)枯らす|虫害|害虫|破滅の原因|荒廃|胴枯れ病|焼き枯れ病
wager	を賭ける|請け合う|賭け|賭事|賭け金
mechanic	機械工|名人
recombination	組み換え
outdated	時代遅れの
hydration	水和
unleash	解放する|革紐を外す|発散する
reiterate	繰り返す
souvenir	記念品|土産|おみやげ
keyword	キーワード|主要語|見出語
tofu	豆腐
shameless	恥知らずな|恥知らずの|不謹慎な
pew	ベンチ形信者席|座席|信者席
mustache	口髭|口ひげ
aspirin	アスピリン|代表的な消炎鎮痛剤のひとつ|非ステロイド性抗炎症薬の代表的な医薬品
viscous	粘着性の|粘りけのある
remake	リメイク|再編集し作り直した映画等
kinda	いくぶん|ちょっと|(類似語sorta)
loft	屋根裏(=attic, garret)|ハト小屋|屋根裏に貯蔵する|打ち上げる
zest	風味|熱意|熱心|強い興味|レモンの皮|趣を与える
solace	慰め|慰安|慰める
sympathize	に同情する|共鳴する|共感する
recombinant	組換え型の(個体)|遺伝子組み替えの
perilous	危険の多い|危険な
stylistic	文体の
clang	カラーン|ガランと鳴る音|金属がぶつかる音
comma	コンマ
spa	湯治場|温泉
audition	試聴|オーディション
garnish	飾り|(料理の)つま|差押える|装飾|装飾物|飾り物|付け合わせ|ソース|修飾|あや
proportionality	比例
culinary	台所の|料理の
desolation	荒らすこと|荒廃|荒涼とした場所|荒地|廃墟|荒涼|荒すこと
wrongdoing	悪事
rigor	厳格さ|厳しさ|厳格|厳密|精密|正確|苦しさ|悪寒|寒気|硬直
brochure	(営業用)パンフレット|小冊子
ignite	点火する
stairway	階段
incessant	絶え間なく続く
borderline	境界線
ending	終わり
remuneration	報酬|給料
interdependent	互いに依存する
killing	殺す|致死の|枯らす|死にそうな|骨の折れる
unsatisfactory	不満足な|満足できない|十分でない|中途半端な
lighthouse	灯台|燈台
pendulum	(時計などの)振り子|動揺するもの|心の定まらない人|麻痺させる|無効にする
picket	くいを打つ|(～に)ピケを張る|くい|くいで囲う|杭|見張り|ピケ|デモ参加者
torpedo	魚雷(で破壊する)|地雷|(鉄道)発雷信号機|シビレエイ|デンキナマズ|(ギャングの)用心棒|殺し屋
witty	機知に富んだ|機知のある|気のきいた
seawater	海水
vinyl	ビニール
diligent	勤勉な
herald	告知する|予告する|報道者|先駆者|先触れ
walkway	散歩道|歩道|通路
arbitrarily	任意に
brilliance	ブリリアンス(高域の再生度)|(頭の･腕の)冴え|華|明敏さ|すぐれた才能|音の輝かしさ|光輝
compress	要約する|圧縮する|押し込む|押しつける|縮む
adventurous	冒険好きな
triad	三つ組|3人組|三和音|三価元素
destitute	貧困な|欠乏した|無一文の
landfill	埋め立てごみ処理(地)|ごみの埋め立て処理場
semblance	外見|うわべ|見せかけ|類似
meningitis	髄(脳)膜炎
modular	＜module|モジュールの|＜modulus|モジュラス(係数|率|標準)の
functionally	機能的に
delirium	精神錯乱|せん妄
cheque	小切手(英)|=check(米)
muffin	マフィン(パンや焼き菓子の種類)
excise	切り取る|消費税|物品税
slander	悪口|中傷|を中傷する|名誉毀損
amiss	間違って
ponytail	ポニーテール
counterfeit	にせもの|にせ札|偽造品|偽造する
lumen	ルーメン|(1candelaの点光源が立体角1steradianに放出する光束強度)
lodging	に下宿する|宿泊|下宿屋
resolutely	堅く決心して|断固として|堅く心に決めて
aluminium	アルミニウム
hemoglobin	ヘモグロビン|血色素
progenitor	祖先|親|先駆者|創始者
plexus	(神経･血管･リンパ管の)叢(そう)|網状組織|企業名
steed	馬|軍馬
verbally	言語で|に関して
concealment	隠匿|潜伏(場所)
crescent	三日月
lunatic	精神異常者の|狂気の|精神異常者|愚人
oscillation	(ὰsəléɪʃən)振動|振幅|変動|車体動揺|(心などの)動揺|ためらい
walker	散歩する人|歩く人|歩行器|歩く鳥
consort	配偶者|仲間にする|を連合させる
stud	ちりばめる|びょう|埋め込みボルト|飾り釘|飾りボタン|プレーボーイ
rearrangement	再配列
firsthand	直仕入れの|直接の|直接に
rampant	流行する|猛烈な|奔放な|手に負えない|蔓延した
coincidental	偶然一致する
granular	粒の|顆粒状の|ざらざらした
discord	不一致
shoreline	海岸線|湖岸線|(=coastline)
migraine	偏頭痛
tornado	(陸上の)竜巻|旋風
col	コル|鞍部|気圧の谷|鞍形等圧線
racially	人種的に
router	ルーター
placenta	胎盤
interconnection	相互接続
protease	プロテアーゼ(Protease)|ペプチド結合加水分解酵素の総称
creepy	むずむずする|はう|はい回る
hopelessly	望みを失って|絶望して
graveyard	墓地
uncomfortably	気詰まりで|心地悪く
alternately	交互に|一つおきに|互い違い|ちゃんぽん|交互
rapture	有頂天|恍惚|大喜び|狂喜|歓喜
menstrual	メンスの|月経の|毎月の|月経(=period)
autopsy	検死(する)|(死因究明のための)検死解剖|詳細な批判分析
technician	専門家|技術家
subversive	破壊する|転覆を企てる
teller	窓口係
assortment	品揃え|仕分け|分類|類別|詰合せ
necessitate	強いて～させる|必要とする(させる)|要請する|～することを余儀なくさせる
restitution	賠償|返却|返還|損害賠償
electrostatic	静電(気)の
effusion	流出
profane	神聖を汚す|不敬な|世俗的な|異教の
negativity	陰性
chili	アメリカ産トウガラシ
weariness	疲労|飽き|退屈|倦怠
leftist	左翼の人|急進派の人
fluent	ゆったりとした|流れる|流暢な|雄弁な|文章のうまい|ゆるやかな|流れるような
cooker	料理用の|調理道具|調理用のくだもの
budgetary	予算の
pea	エンドウ豆|豆粒大の(もの)
hindrance	妨害|障害|邪魔|妨げ
apologetic	わびて|謝って
smelt	(smellの過去･過去分詞)匂った|(鉱石を溶解し)製錬する|(金属を)溶解する|smelt copper銅を製錬する|キュウリウオ(ワカサギの類)
outpost	居留地|前哨地点
coke	コカコーラ|コークス|コカイン
cinematic	映画の
meticulous	細心の|非常に注意深い|(仕事などが)非常に正確な|小心な|几帳面
reliant	(人･物に)頼っている|を当てにしている|確信･信用している
coexistence	共存
pretence	見せかけ
generational	世代間の
crocodile	ワニ|鰐 
internship	インターンシップ
jeopardize	危うくする|危険にさらす|脅かす
abbey	修道院|僧院
brilliantly	あかあかと|あざやかに|キラキラと|すばらしく|水際だって
cipher	アラビア数字|暗号(にする)|数字の零
unease	不安
monotonous	単調な|一本調子の
decency	礼儀正しいこと
inhalation	吸入
augmentation	増加|増大|increase
cork	コルク製品|コルク
gem	宝石|逸品|珠玉|〜を飾る
madame	奥様|夫人
hamper	妨げる|邪魔する|障害|詰め篭
excision	切除術
eddy	小さい渦巻き|渦巻く|旋風
further	さらにずっと|さらに先に|一層遠く|その上|更に
attractiveness	魅力的であること
sparrow	スズメ
engender	を生じさせる|発生させる|生ずる|産む|引き起こす|生じる
cancellation	取り消し
hazy	もやのかかった|ぼんやりした|かすんだ
negligent	怠慢な|無頓着な|不注意な
assailant	攻撃者
aptitude	適性|才能|素質
colossal	巨大な|素晴らしい|途方もない
conceptually	概念的
suburb	郊外|近郊
detriment	損害
feeder	飼養する者|食べる人|餌入れ|ほ乳瓶|原料供給装置|給電線|支線
fluffy	けばの
grievance	苦情(の種)|不平
shatter	を粉々にする|を打ち砕く|を台無しにする
stash	を隠す|(俗)置く|かくまう
improvisation	即興|即席|即席に作ったもの
radiance	さん然|輝き|光輝
inpatient	入院患者
flurry	あわてさせる|一時的混乱|突風|一時的な小雨･小雪
compiler	コンパイラー|編集者|編者|編纂者
downfall	大降り|失脚|滅亡|没落|落下
prosthesis	人工的補助物(義足等)
grate	すりつぶす|火格子|火床|暖炉
nonhuman	ヒト以外の
palsy	麻痺|しびれ|中風|麻痺状態
seminary	学校|神学校
decompose	分解する|腐敗させる
ax	おの|斧|解任する|dismiss
homestead	家屋敷|農家|自作農場
mango	マンゴー(の実)
prolific	子をたくさん産む|多産の|子を産む|実を結ぶ|を多く出す
pesticide	農薬|殺虫剤
disproportionately	偏って
synchronous	同時(性)の|同時に起こる|同位相の|同期の
sonnet	十四行詩･ソネット
ornamental	飾りの|装飾的な|装飾品
alternatively	二者択一的に|代りになるべき物として
indescribable	言語に絶する|言い表せない|漠然とした
valet	近侍|従者(男)|近侍として(人に)仕える|世話をする
dermatitis	皮膚炎
unheard	聞こえない
gall	心痛|すりむく|いらだたせる|植物のこぶ(昆虫(gallfly)による虫こぶや|菌類の寄生によるコブ)
slut	だらしのない女|身持ちの悪い女
intrusive	押し入る|でしゃばりの
pleasurable	愉快な
apparel	衣服|衣料
reactionary	反動の|反動主義者|反動政治家
ionization	イオン化
scenic	景色の|風景の|眺めがよい|情景描写の|舞台(上)の|舞台装置の|劇の|風景画
remit	怒りを和らげる|を送る|税を免じる|軽減する|支払う
agility	機敏さ
residency	専門医学実習生の身分(期間)|居住
consummate	完成する|完全な|まったくの|有能な|無上の|極点に達せしめる
vous	(仏)あなた|の意
inferiority	劣等
shopkeeper	店主
graciously	優雅に
unconstitutional	憲法に反する
pertain	に関係がある|属する|ふさわしい
fascism	ファシズム
refund	払戻し
hugely	大いに|非常に
sickly	病弱な|健康に悪い|吐き気を催させる
morbid	ゆううつな|病気の|病的な|憂うつな|恐ろしい|不健全な
malnutrition	栄養失調
illegally	不法に
preexist	〈人が〉別界に先在する|〈魂が〉肉体と合体する以前に存在する
tumult	動揺|騒動|混乱|大騒ぎ|わめき声|騒々しさ|暴動
saw	seeの過去形|のこぎり(で切る)
astronomical	天文の|(数字など)(数が)天文学的な|天文学(上)の|膨大な
providence	神の導き|摂理|神意|倹約|神業|先見
venom	悪意|毒|毒液|うらみ|に毒を注ぐ|悪意で満たす
discernible	認識できる|識別し得る
oscillator	発振器
informant	通知者|情報提供者|密告者|(文法)資料提供者
apical	頂点の
vibe	雰囲気
dispersal	散乱|分散|離散|伝播
acronym	頭字語|文字略語|頭文字語
avatar	権化|化身|具体化
stiffly	堅く
gambler	ばくち打ち|やくざ
peroxide	過酸化物
misguide	間違った方へ導く|間違って指導する
usable	使用できる
conformation	一致|均整のとれた配列|形態|構造|整合|組織|適合|配座|配置|立体配座
disintegration	分解|崩壊|分裂|分散
electronically	電子的に
greasy	グリースを塗った
prehistoric	有史以前の|先史時代の
printer	プリンター
fluctuate	動揺する|変動する|揺動する
heartless	思いやりのない|熱意のない|薄情な|無情な|冷酷な|つれない|元気のない
heroism	勇気|英雄的行為
extinguish	生物を絶滅させる|償却する|消す|火を消す|情熱を失わせる|廃止する
celery	セロリ
orb	球|球体|天体|宝珠|目|眼球|円|を球形にする
symposium	シンポジウム
greeting	挨拶|あいさつ
nocturnal	夜の|夜行われる
conductive	(熱・電気などを伝える)伝導性の
millionaire	百万長者|大富豪
undertaking	仕事|引き受けた事|請け負った仕事|企業|約束
carve	切り分ける|刻む|彫刻する
mane	たてがみ|ふさふさした髪
beget	こしらえる|生じさせる|きたす
caretaker	留守番|管理人
innovate	取り入れる
holster	ホルスター(ピストルの革ケース)
handbag	ハンドバッグ|旅行かばん
slant	傾斜|傾向|斜めになる|偏る
garb	服装
pantry	食料品室|食器室
steadfast	しっかりした|確固とした|忠実な
throttle	スロットル|絞り弁|窒息させる|抑圧する|減速する
overrun	侵略する|はびこる|越える|超過する
erode	腐食する|侵食する|腐る|浸食
tempest	あらし|嵐|大嵐|暴風雨|大荒れ
comet	(天体)すい星|彗星|ほうき星
aquifer	帯水層
visitation	訪問|公式訪問
stagnation	よどみ
vicar	(英国国教会の)教区牧師|(教皇･司祭の)代理|代理者
biofilm	バイオフィルム|菌膜とも呼ばれる|微生物により形成される構造体である
calculator	計算機
alkali	アルカリとは|水に溶解して塩基性(水素イオン指数(pHが7より大きい)を示し|酸と中和する物質の総称
practicable	実行可能な|通行できる|実際的な|実用的な|使用できる
lymphatic	リンパ管
brighten	明るくなる|輝かせる|輝く
til	〜まで
snuff	くんくん嗅ぐ|を吸い込む|(=sniff)
antibacterial	抗菌
prenatal	誕生前の
whereupon	するとすぐ
biotechnology	生命工学|生物工学|バイオテクノロジー|人間工学|ergonomics
aerosol	スプレー|噴霧器
sentinel	歩哨|を見張りに立てせる
literate	読み書きできる|文学通の|文献
presuppose	～することを前提とする|仮定する
wry	ゆがんだ|皮肉たっぷりな|こじつけた|曲がった
incidentally	ついでながら|ところで
epigenetic	エピジェネティックな|後天的な 
jewellery	宝石類
sorrowful	悲しい|悲しんでいる|悲しげな
martyrdom	殉死|殉教|受難|苦痛
flea	ノミ|蚤のように跳ぶ小虫|くだらない奴|こうるさい奴
insurrection	暴動|反乱
usability	ユーザビリティ
caveat	予告記載|警告|手続停止申請|誤解を招かないようにするための警告･注
unsteady	不安定な|しっかりしていない|不規則な
yr	yearの略語
rumour	噂|うわさ
elective	(米語)選挙で選ばれた|選択科目
cutoff	切断|遮断|決算日
multifaceted	多面
magnification	倍率|拡大したもの
mournful	悲しみに沈んだ|死者を悼む|陰気な
tuna	マグロ|鮪
overturn	覆す|ひっくり返す|打倒|転覆
irresponsible	無責任な
feud	敵意|不和(になる)|論争(=dispute)|(封建時代の)領地
compensatory	償いの|賠償的な|報酬の
phosphorylation	リン酸化反応
putative	推定(推測)(上)の|うわさの
advertise	広告する|通知する
saga	英雄伝|冒険談
bayonet	銃剣(で刺す)|バヨネット(銃器に銃剣を装着する装置)
unruly	手に負えない|荒れ狂う
ornate	飾りたてた|華麗な
anthropologist	人類学者
polymerase	DNAポリメラーゼ(DNA polymerase)は1本鎖の核酸を鋳型とし|それに相補的な塩基配列を持つDNA 鎖を合成する酵素の総称
overtly	明白に|公然と
antagonistic	拮抗的|対立する
naught	完全な失敗|ゼロ(=nought|主にUK)|無価値|滅びた
mountainous	山の多い|山地の|山のような
entice	誘惑する|誘う
seaweed	海草|海藻
predatory	略奪する|肉食(性)の
tutorial	家庭教師の
brothel	売春宿
hardy	ずうずうしい|大胆な|我慢強い|丈夫な|耐寒性の
blender	ミキサー
slug	ナメクジ|怠け者|金属の小塊|詰め物をする|なまける|ぐずぐず過ごす
stimulant	刺激性の|興奮剤
detour	迂回
mite	ダニ|ごく小さいもの|(かわいそうな)子供|(少額)寄付
squamous	扁平な|鱗片状|落屑性の|鱗屑状の
archetype	原型|典型
adversarial	対立する|敵対する|反対の|反対者の
childcare	保育(の)|育児(の)
singularly	際立って|とくに
hippocampus	(脳)海馬(かいば)状隆起
liberate	を自由にする|を遊離する|を作用させる|開放する|遊離させる
intuitively	直観的に
ruling	支配する|統治する|決定|判決|有力な|一般の|主たる|目下の
drawback	戻し税|欠点|障害
recitation	暗唱|朗読
karma	カルマ|業|因縁|宿命
homogeneity	均一性|同次性|同種|同質|一様性|等質性|均質性|均等性|均質
saucer	皿|茶碗の受け皿|小皿|空飛ぶ円盤
precede	に先行する|先行する|先立つ|の先に立つ|前方を行く|に先んじる|の上位につく|の前に置く
rectal	直腸の
bunker	船の燃料庫
idolatry	偶像(邪神)崇拝|盲目的崇拝|心酔
edict	命令|勅令|布告
truce	中止|中断|休戦|停戦|停戦協定
swine	(野生の)ブタ|豚|(pigはより家畜的)
saying	ことわざ|格言
uncontrollable	制御できない|手にあまる
cowardly	臆病な
unhappiness	惨めさ|悲哀|不運|不幸
symphony	シンフォニー|交響曲
downside	下(底)側(の)|(株価など)下がる傾向(の)|不利な(否定的な)面
indistinguishable	見分けのつかない
cyclical	周期的な(に起る)|循環する|循環株
purposefully	意図的に
wharf	波止場|埠頭|を波止場につなぐ|波止場に停泊する
longtime	積年の|長い間の|長年の
undress	の着物を脱がせる|の衣服をとる|飾りをとる|脱衣する
respite	猶与する|延期|休止期間
archbishop	(カトリックの)大司教|(プロテスタントの)大監督
strenuous	精力的な|懸命の|奮闘的な
annum	年
rapidity	迅速|速度
soundly	堅実に|ぐっすりと|激しく
morphine	モルヒネ
tart	ぴりっとした|酸っぱい|痛烈な|辛辣な
neuropathy	神経障害
alias	別名|偽名|別名は|またの名|～こと
analgesic	痛みを感じない|無感覚の|鎮痛剤
sequel	続篇|結果|後編|続き
dialysis	透析
figurative	比喩的な(=metaphorical)
thickly	濃く|厚く|太く|密に|密集して|濃密に
crossover	(鉄道)渡り線|交差路|歩道橋|支持政党をかえる選挙人|異花受粉|クロスオーバー
coroner	検死官
courier	急使|(旅行の)ガイド
restroom	トイレ
werewolf	狼人間|狼男
occupancy	占有|占拠|領有|居住|使用
colourful	colorfulの英式綴り
deterrent	妨げる|引き止める|妨害物|核兵器|制止する|戦争抑止の|故障
eminence	高位
particularity	特別|特殊性|詳細|入念|気むずかしさ
recapture	取返す
concave	凹(おう)面の|くぼんだ|へこませる
glaze	ガラスをはめる|つや出し
erratic	一定しない|不安定な|突飛な
potentiality	〈U〉潜在状態|〈C〉《通例複数形で》可能性;発展の見込み|将来性
frock	(frάk)|(農夫･労働者のゆったりした)仕事着|(そでが広くすそたけの長い)修道士の服|僧服|フロック(婦人･子供用のワンピースのドレス)|男性用フロックコート
orphanage	孤児院|孤児
ministerial	閣僚の|大臣の|内閣の|行政の
prefrontal	前頭葉前部の
hybridization	ハイブリダイゼーション|雑種形成|かけ合わせ
cub	(ライオン･クマ･キツネなどの)子|未熟な若者|新米
heck	(俗)地獄|ひどいこと
condo	分譲マンション
invincible	無敗の|征服されない|克服しがたい|無敵の
aloof	離れて|遠く離れて|遠ざかって|風上の方に
nymph	ニンフ(神話)|少女の姿の妖精|トンボやバッタなど不完全変態をする昆虫の幼虫(成虫がそのまま小さくなった姿形)
storey	階
fluctuation	変動|動揺
chlorine	塩素(非金属元素)|元素記号Cl
precinct	境内|周囲|区域|管区|選挙区|境界|周辺|付近|地区|地域
citrus	柑橘類(の)
possessive	所有の|所有欲の強い|所有格の|所有格|所有代名詞(形容詞)
downright	徹底的な|全くの|純然な|素直な|全く|率直な|完全な(に)
arduous	骨の折れる|困難な|根気強い
pictorial	絵の|絵画の(ような)|画家の|絵入新聞|絵入り雑誌
blacksmith	かじ屋|鍛冶屋
farmland	農地
tidings	便り|情報|ニュース
tyrannical	専制的な
invalidate	無効にする
irritable	おこりっぽい
unwillingness	気が進まない
restorative	回復する|気付け薬
bum	のらくら者|浮浪人(tramp)|なまけ者|ルンペン|飲んだくれ|くだらない|値打ちのない
chasm	深い割れ目|隙間|みぞ|隔たり|欠陥
lactate	乳酸塩|乳を分泌する|乳汁を分泌する
vigour	力|活力|元気|活気|迫力|勢い|(植物などの)生長力
bookseller	本屋
estuary	広い河口|河口域|入江
subtlety	微妙な考え|微妙|希薄|巧妙
ensue	続く|あとで起こる|あとに続く|結果として起こる
restart	再開|を再始動する|～を再起動する
nitric	硝酸
veranda	ベランダ|縁側
ranger	歩き回る人|放浪者|監視人|遊撃隊員
waistcoat	チョッキ|ベスト
stair	階段の|段|1段|階段
rehearse	リハーサルをする|習熟させる|繰り返して言う
arsenal	武器庫|貯蔵兵器|軍需物資|集積
barber	理髪師
relocate	移転させる|立ち退かせる
unpopular	人気のない|不評判の|はやらない
dishonest	不正直な
condense	要約する|集光する|濃縮する|液化させる|凝結させる
inhuman	冷酷な
vista	展望|眺望|ながめ|見通し|予想
rascal	いたずらな人|悪党|ごろつき|卑しい
ethically	倫理的に
crotch	(人体･ズボンの)股|(樹木の)叉(fork)|二股
sectarian	宗派の|派閥の
immaterial	重要でない|非物質的な|実体のない
marathon	マラソン|長時間続く
implicate	(人を犯罪などに)関係があるとする|巻き込む|もつれさせる
unprepared	準備なしの|準備がされていない|即席の|不意の
bot	検索ロボット|借りる|たかる
diploma	卒業証書|公文書
curator	後見人|(博物館などの)館長|(大学の)理事|管理人|保護者
sponsorship	後援|資金提供|助成金|保証人であること
corporeal	実体のある
geology	地質学|地質
jumble	ごたまぜにする|よせ集め|がらくた|ごちゃまぜにする
uproar	大騒ぎ|騒動|混乱|騒音
perceptible	認知できる|知覚(認知)できる|かなりの
shipwreck	難破(船)|挫折|難破する
smug	一人よがりの|さっぱりした|自己満足した
ascetic	禁欲主義の|苦行の|苦行者の|禁欲的な|修行僧|修道僧|禁欲者|隠者
giver	与える人|贈与者|寄贈者
mandible	(哺(ほ)乳動物・魚の)あご;(特に)下顎骨(かがっこつ)(下あごの骨)|(鳥の)下くちばし;《複数形で》両くちばし|(昆虫の)大あご
dynamical	動力学的な|力学的な
admittedly	明らかに|正直なところ
abbot	修道院長
ay	はい|aye|yes
flyer	ビラ|チラシ|小冊子
beset	包囲する|取り巻く
calmness	静かさ|沈着|平穏|冷静
mod	(服装など)流行の最先端をいく|大胆な|前衛的な
birch	バーチ(家具用材)|カバの木
veritable	ほんとうの|真の|本物の
rudimentary	初歩の|基本の|未発達の
thankfully	ありがたいことに|感謝して
percentile	百分率|百分位数|百分順位|パーセンタイル値
thwart	妨げる|に反対する|邪魔をする|ボートの漕ぎ座
valiant	勇敢な|勇ましい|果敢な|雄々しい|優れた|価値ある
attentively	注意深く|気配りよく
turret	(建物の角の|主に装飾用の)小塔|タレット
crib	ちっぽけな家|盗用|カンニングペーパー|カンニングする(和製英語)
enroll	登録する|名簿に記載する|会員にする|enrol
wrongful	不法の|悪い|不当な|不法な
madly	気が狂ったように|狂ったかのように
unofficial	非公式の|非公認の
helix	らせん|らせん形のもの
husky	殻の(多い)|しゃがれ声の|(声が)ハスキーな|がっしりした(人)|ハスキー犬(Siberian husky)
frivolous	浅はかな|軽率な|つまらない
landslide	山くずれ|地滑り|(地滑り的な)大勝利
unthinkable	全く考えられない
colorectal	結腸直腸の
nascent	初期の
foreseeable	予知できる
cloister	修道院|回廊|引きこもる|修道院生活|隠遁生活|静かな隠れた場所
twine	より合わせる|編む|より糸|麻糸|からまり|もつれ
grouping	集める|集まる
lee	残りかす|保護|物陰|風下の|風下
mechanistic	機構的な
tee	はじめる|の準備をする|ティー|T
translucent	半透明の
backlash	バックラシュ|跳ね返り|非難|反発
shuffle	(足)をひきずって歩く|を移し替える
passageway	廊下
leafy	葉に覆われた|葉の多い|葉のような
persistently	しつこく|永続的に
timeless	永遠の|永久の|いつでも有効な|時間を超越した|時代を超えた|時ならぬ|時期尚早の
quod	刑務所|Ex|He is in prison-in jail-in quod-for doing evil|悪いことをして監獄へ入っている
stipulation	契約条項|規約
mysteriously	神秘的に|不思議に|わけがありそうな様子で
scepticism	(英式綴)懐疑論|懐疑的な見方(米はskepticism)
stiffen	堅くする|をこわばらせる|固くなる|強ばる
normalize	正常化する|正規どおりにする
sceptical	=skeptical
sunflower	ヒマワリ
physique	体格|体形
unreal	実存しない|虚偽の|真実性のない|幻想的な|空想的な
subside	静まる|沈む
affectionately	愛情をこめて
feverish	熱のある|熱病の(多い)|熱狂的な
mirth	陽気|歓楽|歓喜
talisman	護符|お守り|不思議な力のあるもの
exchanger	交換器
countess	伯爵婦人
tolerable	我慢できる|耐えられる|かなり良い|相当の|悪くはない|かなりの
cholera	コレラ
ammonium	アンモニウム
sedation	鎮静状態
windshield	風よけ|防風キャップ|フロントガラス(和製英語)
servitude	奴隷状態|苦役|奴隷の境遇|隷属
hindsight	あと知恵|(銃の)後部照尺
nightly	夜な夜なの|毎夜の|毎夜|夜に
downhill	下の方へ|くだり坂(の)|落ち目の|容易な|(スキー)滑降競技|(反|uphill)
eunuch	去勢された男(特に東洋の宦官)
adorn	飾る|decorate