lavish	を浪費する|物惜しみしない|気前のよい|贅沢な|豊富な|ぜいたくな
paraphrase	説明|言い替え|意訳|他の語で言いかえる|を言いかえる
azure	空色(の)|淡青色|藍色|青空 (an azure sky 紺碧の空)
ensign	旗|国旗
ashtray	灰皿
unattached	結合されていない
negligent	怠慢な|無頓着な|不注意な
arson	放火(犯)
woe	悲痛|苦悩|悲哀|災難|悩みの種
hasten	急いでする|急ぐ|急いで～する|急がせる|せきたてる
tranquility	静けさ|静かなこと|平和|平静|安寧
outing	外出|お出かけ|遠足
snipe	狙撃する|狙撃|政治ポスター|シギ(鳥)
pathogenesis	病因
botox	ボトックス(神経毒の名称)
lilo	空気ベッド(プラスチック製で海岸などで用いる)
pixie	妖精|小鬼|いたずら好きな
bereavement	肉親に先立たれること|死別
vehicular	運搬具の|乗り物の|媒体
actuary	保険数理士
penicillin	ペニシリン|(penəˈsilin)|1928年にイギリスのアレクサンダー･フレミングによって発見された世界初の抗生物質
commenter	評者
celsius	摂氏|(=centigrade)
recognizable	認識された
babysit	子守
racquetball	ラケットボール|壁に囲まれたコートでボールを壁にはね返らせるスカッシュに似た球技
glycol	グリコール
sinner	罪人|罪を犯した人
ergo	(ラテン語)(それ)ゆえに
payback	資本回収
conduction	伝導
countess	伯爵婦人
crafty	狡猾な
dill	ディル|ヒメウイキョウ(セリ科の植物で|実と葉はピクルスなどの香味料)
fella	fellow|ヤツ
gritty	ほこり(砂)だらけの|砂のような|砂利の入ったような
coronation	戴冠式
toil	骨折り|苦しい仕事|労苦|労役|骨折る|精を出して働く
adder	毒蛇|マムシ|クサリヘビ(有毒)
cowgirl	カウガール(牧場で働く|カウボーイの服装をした女性)
dermatitis	皮膚炎
reluctance	気が向かないこと|いや気|不承不承|不本意
inconsistency	不調和|無定見|矛盾
fecal	糞便の
atoll	環礁|環状サンゴ島
apostolic	使徒の|使徒的な|apostle＞
hairdresser	美容院(~s)|美容師|理容師
underpin	支える
anguish	悲痛|苦悩|苦痛|苦悶|に苦悩を与える
nighttime	夜間
proximal	近位
rosebud	バラのつぼみ|美少女|ばらのつぼみ
skylight	天窓|明り取り|明かり取り
hiss	シューと音を出す|しっと言う|シーと言って表す
saucepan	(柄･ふた付きの)シチューなべ|ソースパン
suitably	ぴったり合って|似合って|適当に|うまく|適切に
amphetamine	アンフェタミン(覚醒剤)
recliner	リクライニング
enormously	非常に|途方もなく|莫大に
sarge	=sergeant
battleship	戦艦
backlash	バックラシュ|跳ね返り|非難|反発
drapery	(ひだのついた)掛け布|織物|生地
cappuccino	泡立てクリームをのせたエスプレッソコーヒー
humid	湿度の高い|多湿の|むしむしする
domicile	住居|居所|居住地|家|住所|定住させる
stint	仕事を割り当てる|を制限する|出し惜しみ|制限|割当|ハマシギ(鳥)
coroner	検死官
guile	ずるい策略|狡猾さ|陰険さ|策略
wag	ひょうきんもの|振る|頭を振る|揺れ動く
strategist	戦略家|ブレイン
thermoplastic	熱可塑形の|熱可塑性物質(合成樹脂)
depressive	鬱状態の人|憂鬱な|抑鬱性の|(抑)鬱病の|押し下げる|抑えつけられるような
revel	大いに楽しむ|享楽する|凝る|酒盛りをする
omen	前兆|予感|予言
combinatorial	組み合わせの
therefor	そのために|その代わりに
unintended	意図的でない
piranha	ピラニア|ピラニヤ
smog	スモッグ|煙霧
unattended	付き添いのない
inauguration	就任式|開始|開会|就任(式)
monsieur	様
alder	ハンノキ|(カバノキ科の広葉樹)|家具材に使用
dissipation	浪費|消散|放蕩|道楽
executor	指定遺言執行者|執行者
culprit	犯人|被告|容疑者
magnifier	虫めがね|拡大鏡|物事を誇張する人
atheism	神の存在の否定|無神論|不敬さ|反宗教性
caterer	(宴会)料理の仕出し屋|サービス係
praxis	習慣|慣列|実習|練習
grouping	集める|集まる
angler	(特に趣味で)魚を釣る人|釣り師|太公望
cosy	こじんまりとした|ここちよい|(=cozy)
overturn	覆す|ひっくり返す|打倒|転覆
laureate	栄誉のある
marketer	マーケティング担当者
shudder	震える|身震いする|(建物･船などが)揺れる
resend	再送する
baffle	まごつかせる|挫折|調節板|挫折させる|迷わせる|くじく
masthead	マストの先|マストの先の見張人|マストヘッド|新聞名|発行人欄
gelatin	ゼラチン
adenosine	アデノシン(RNAを構成するヌクレオシドで|神経伝達物質)
dissection	切開|解剖|分析|解体
eucalyptus	ユーカリ|ユーカリ油
conservatism	保守主義
backdoor	裏口|勝手口|尻の穴|裏口の|内密の
disclaim	〈責任・関係など〉‘を'否認する(deny)|〈法律上の権利など〉‘を'放棄する
snapper	鯛|フエダイ類
sealer	〈C〉アザラシ猟師(猟船)|〈U〉密封材(パテ・防水・ペンキなど)
sideline	副業
diversify	多様化する|多様化させる|多角化する
smackdown	(米俗)激しく叱責する|お仕置きする
horrific	恐ろしい
ere	で|において|前|以前
abacus	そろばん
richly	十分に
fowl	(fάʊl)|ニワトリ|鶏
chilli	トウガラシ|唐辛子|(薬味の)チリ (国名のチリはChile)
resentment	憤慨|恨み|憤り|立腹
priori	先験的な
vaguely	漠然と|あいまいに|ぼんやりと
breadcrumb	パンの中の部分
spontaneously	自発的に
savory	薬味のよく効いた|味がよい
bobble	ふらつく|よろめく|へまをする|(野球)打球をとり損なう|ファンブルする
unavoidable	避けられない|やむをえない
ruthless	容赦ない|残忍な|無情な|冷酷な|無慈悲な
chao	(=ciao)チャオ|イタリア語の挨拶
candidacy	立候補
seniority	年上|先輩であること|先任順位
equator	赤道
blatant	あからさまな|騒々しい|ずうずうしい|けばけばしい
squish	つぶすこと|つぶれたもの|ビシャビシャという音|傾いて|グシャッとつぶす|ぬかるみに入れる
crepe	(仏語)ちりめん|クレープ(料理･布)
modulate	調節する|調子を変える|詠唱する|転調する
midwifery	産婆術|助産術
bloke	奴
restorative	回復する|気付け薬
profanity	不敬
bathe	水浴させる|入浴する
puberty	思春期|reach(the age of)puberty思春期に達する|年ごろになる
comin	来るべき|次の(=coming)
gatekeeper	門番|踏切番
thoroughbred	サラブレッド|純血種の|サラブレッド種の|育ちの良い
propel	を推進する|を進ませる
sublet	転貸する
fireball	火の玉|(核爆発で生じる)火球|精力家|(野球)速球
hologram	ホログラム|レーザー写真
unison	調和|一致|ユニゾン|同音|斉唱
tabular	卓状の|表にした|表計算した|表の|表を用いた|平たい|平板状の|平板状の層から成る
amir	(アラビアの)首長|王族|預言者ムハンマド(Muhammad)の子孫の尊称|emir
dormant	眠っている|休止状態の|不動の|固定的な
ecumenical	普遍的な
charismatic	カリスマの
placid	穏やかな|平静な|落着いた|おとなしい
napkin	ハンカチ|ナプキン|おしめ
forearm	前腕(ひじから手首まで)|あらかじめ武装する|備える
contagious	移りやすい|伝染性の
downturn	(景気･物価などの)下降|沈滞|悪化
inaccessible	近づきにくい
conspicuous	人目につく|著名な|異彩をはなつ|目立つ
ferrous	鉄の|鉄分を含む
passe	古めかしい|往年の|盛りを過ぎた|パセ
anvil	金床(かなとこ)
intrusive	押し入る|でしゃばりの
crumble	粉々になる|砕ける|滅びる|perish|崩壊する|decay
crock	壷|瓶
parasitic	寄生する
prawn	クルマエビ|クルマエビを捕える
receptive	受容性に富む|感受性の強い
bedrock	床岩|根底|根本|基礎的事実
scribble	走り書きする|走り書き|なぐり書きする
codon	コドン|核酸の塩基配列がタンパク質を構成するアミノ酸配列へ生体内で翻訳されるときの|各アミノ酸に対応する3つの塩基配列のこと
vile	下劣な|ひどく悪い|いやな|堕落した|きたない
foursome	四人|フォーサム(各2人組の2チームで戦う)|4人組
interlude	合間(の出来事)
whim	気まぐれ|気まぐれな思いつき|巻き上げ機
appetizer	食前酒
generality	一般的な考え
azimuth	(æzəməθ)|(天文)方位角|方位|発射方位|アジマス
telemetry	テレメーター法(遠隔測定法)
fodder	まぐさ(馬草)|にまぐさを与える
consumable	消耗品|消費できる
bran	ぬか|ふすま
touche	一本あり|参った!|うまい!
boardroom	役員室
veal	子牛の肉
creatively	創造的に
tremendously	途方もなく
geeky	おかしな
primrose	サクラソウ|淡緑黄色
oscillation	(ὰsəléɪʃən)振動|振幅|変動|車体動揺|(心などの)動揺|ためらい
interfaith	異宗派間の
thunderstorm	雷雨
flutter	はためく|ひらひら舞う|どきどきする|動揺|おののき|パタパタ|ヒラヒラ|はためく音
payer	支払人|(pl|payers)
retrospect	回顧|追想
conjure	魔法で呼び出す
miraculous	奇跡的|奇跡的な|素晴らしい|奇跡を起こす力のある
standardize	標準化する|を規格化する
narration	ナレーション|叙述|物語ること|話法
reborn	生まれ変わる
impeach	非難する|告発する|起訴する|に疑いを投げかける|疑問視する
abrasion	すりへり
circumvent	出しぬく|だます|取り囲む|迂回する|回避する
bebop	ビバップジャズ|1940年代のモダンジャズの一形式
training	トレーニング|訓練する|訓練|教育|しつけ
nonresident	(ある一定の場所に)住んでいない|居住してない|非居住者
botanic	植物の
bronco	ブロンコ|北米の半野生馬|イギリス人|新米ホモ
exceedingly	非常に|甚だしく
repentance	後悔
unprotected	保護(者)のない|無防備の
amplify	拡大する|増幅する|敷衍する|大げさに言う
streptococcus	連鎖球菌
reshape	再形成する
quarrel	四角い鏃の付いた矢|紛争|口論|反目|不和|争う
oncogene	ガン遺伝子
murine	ネズミ･ハツカネズミなど|長く毛のはえていない尾のある齧歯(げっし)類
entomology	昆虫学
regularity	規則正しさ|均整|不変|正規
violently	激しく|猛烈に|乱暴に|不法に|猛烈|どたばた|むずと|ひどく
untouched	触れない|そのままの|未踏の|感動しない
consolation	慰める人|慰め|慰安|敗者戦
duffel	ダッフル|けば立てた厚地粗製毛布
corduroy	コールテン|コー​​デュロイ
leech	ヒル|吸血鬼|高利貸し|まとわりつく
kerosene	灯油|paraffin
gait	足並み|歩きぶり|足取り|歩調|歩行|歩様|進行
peacefully	平和に|穏やかに
patriarch	家長|イスラエル民族の祖先|長老|創始者
stature	身長(be of short stature|背が低い|(heightが一般的))|成長|卓越|偉大さ
postmaster	郵便局長
cleave	道を切り進む|(材木など)を切り裂く|執着する|割る|突き進む|割れる
toothpaste	歯磨き粉|ねり歯磨き
sever	断絶する|を切る|切断する
skit	短い風刺文
posh	豪華な|第1級の|優雅な|素晴らしい|ぜいたくな
mastermind	黒幕|背後から操る
forecaster	予報
brine	the brine(文語)海水|海|塩水|鹹(かん)水|不凍液|ブライン|(普通に塩水という場合はsaltwater)|塩水につける
insulator	絶縁体|断熱(防音)材
fiddler	バイオリンひき|(俗)詐欺師
woodwork	木製品|(家の)木造部
deterrent	妨げる|引き止める|妨害物|核兵器|制止する|戦争抑止の|故障
jester	おどけ者|道化師(特に中世王侯･貴族おかかえの)
painkiller	鎮痛剤|猥褻な|反道徳的な
infestation	侵入
formative	形成した|造形の|構成する|形成･発達(期)の|(文法)接辞|形態素
sniffer	くんくんかぐ人(動物)|におい探知器
hermit	世捨て人|隠者|隠遁者|世捨人
corso	大通り
wrongly	不正に|誤って|間違って|不当に
quantification	定量化
falsely	偽って
adultery	不倫|姦通|密通
parkland	風致地区
brainstorm	突然思い浮かぶ妙案(インスピレーション)|ブレインストーム
midwestern	中西部の
charisma	カリスマ(性)(神授の力)|権威|人々を信服させる教祖的な指導力
patronage	後援|(ペｲﾄｩﾛﾆｯｼﾞ)(顧客の)ひいき|愛顧|保護|いばった態度|商店へのひいき
tern	三つ揃い|三つ組|3数の組み合わせによるくじ|3本マストのスクーナー|アジサシ(鳥)|インターン|実習医
misfortune	不運|不幸な|災難
impetus	勢い|刺激|推進力|起動力|はずみ
gripe	絶えず不平を言う|腹痛をおこす|(俗)不平|怒り
malnutrition	栄養失調
intercultural	異文化間の
superfamily	生物上科(科の上)
functionally	機能的に
rabies	狂犬病
readability	読みやすさ;おもしろく読めること|判読できること
assemblage	(仏語)隣接物件のまとめ買い|一括遺物|アッサンブラージュ|寄せ集め構成(の抽象画)|寄せ集め作品
transatlantic	大西洋の向うの|大西洋横断の
glutathione	グルタチオン|3つのアミノ酸から成るトリペプチド|抗酸化物質の1つ
multiplicity	重複|多様性
ebb	引き潮|衰退|干潮|減退|衰退期
angina	狭心症
manatee	マナティー|海牛(水生ほ乳動物)
cayenne	(粉)トウガラシ|トウガラシの実
centrifuge	遠心機|遠心分離機|を遠心分離機で分離する|遠心分離機にかける
nightingale	ナイチンゲール|さよなきどり(夜歌う鳥)|美声の女性
detour	迂回
balboa	バルボア(パナマ共和国の貨幣単位)
quadrangle	四角形|中庭|陸地区画
hoof	ひづめ|足
wainwright	荷車製造
microchip	極小チップ|マイクロチップ
brilliantly	あかあかと|あざやかに|キラキラと|すばらしく|水際だって
ionization	イオン化
succumb	屈服する|圧倒される|敗ける|死ぬ
annexation	付加(物)|併合(領土)
congregational	集合の|集団の
waterfowl	(集合的に)水鳥|(fowl にわとり)
bongo	ボンゴ(大小2つの片面太鼓をつなぎ合わせた打楽器|bongo drum)
likeness	類似|画像|肖像|外見
physique	体格|体形
pullover	(頭からかぶる)プルオーバー
winger	ウィングの選手
madras	マドラス木綿(インド原産;しまやチェックあや織りで|シャツやドレス用)
feud	敵意|不和(になる)|論争(=dispute)|(封建時代の)領地
faro	銀行|賭けトランプの一種
calibrate	に目盛りをつける|較正する|目盛りを決める
skepticism	懐疑論|懐疑主義|懐疑的な態度|無神論
reliever	救済者
ratify	(条約)を批准する
simplistic	極度に単純化した|簡単に割り切りすぎた
psychotic	精神異常者|精神病の|病性の
individuality	個性
eggplant	ナス(=aubergine)
freehold	(不動産などの)自由保有権|自由保有不動産
wince	いやな顔をする|たじろぐ|ひるむ|たじろぎ|怯む
casket	小箱|棺|かんおけ|ひつぎ(coffinの遠回し語)
alp	高山|高峰
agar	テングサ|寒天(培養基)
energize	元気づける|活動させる
sarcoma	肉腫|(非上皮性組織由来の悪性腫瘍)
fascia	帯状のもの|バンド|ひも|包帯|(店頭上部の)看板|筋膜(筋肉や内臓を包む膜)
pate	頭|脳天|Pâté(仏)|料理名パテ(すりつぶした肉やレバーを調味した料理)
polycarbonate	ポリカーボネート樹脂
placer	砂鉱床
cartoonist	漫画家
reprise	(主題などの)反復|繰り返す
consonant	調和する|一致して|(文法)子音
irritable	おこりっぽい
scum	浮きかす|屑|灰汁(あく)|かすが浮かぶ|の浮きかすをすくう|くず|かす|泡|温めた牛乳に張る膜
cunning	抜け目のない|ずるい
mouthpiece	マウスピース|送話口|口金|代弁者
associative	連合の|連想の|結合の
aeon	永劫|エオン(時間の単位=10億年)
subfamily	亜科
tribulation	苦悩|苦難
anthropologist	人類学者
westside	ウェストサイド物語(映画名)
mogul	モーグル(スキー競技名)|(M-)ムガール人(16 世紀にインドを征服したモンゴル族と子孫)|重要人物|権力者
fag	(俗)男性同性愛者|ゲイ|ホモ|あくせく働く
occidental	西洋(人)の
vigor	元気|力|活力|活気|迫力|勢い|(植物などの)生長力
warlock	魔法使い(男)|占い師|手品師|魔術師
evasion	言い逃れ|回避|くぐりぬけ|脱税
matrimonial	結婚の|夫婦の
tween	トゥイーン(MS Windowsで作動するTwitterのアプリケーション)
hydraulics	水力学|水理学
boucher	バウチャー|証書
prostitute	金のために売る|売春婦
denounce	公然と非難する|告発する|糾弾する|訴える
warmer	暖める人|加湿器
homemaker	主婦
halftime	ハーフタイム
giro	郵便振替
tenderness	柔らかさ|もろさ|敏感|愛情
convent	修道院
ocular	目の|視覚による|ocular proof 目に見える証拠|接眼鏡
sandman	睡魔
pizzeria	ピッツェリア|ピザパイを売る店
dung	肥料(manure)|糞
conclusive	結論的な|決定的な|最終的な
curtail	切り詰める|短縮する|省略する|削減する
fling	放り投げる|(軍隊など)を投入する|急に～する|情事
guerilla	ゲリラ(兵)|不正規兵
breakup	解散|崩壊
peri	ペリ|イラン神話|翼があり魔法を使う妖精|男は威厳があり女は美しく|火から生まれ麝香(じゃこう)やシタンの香りを食べる|ペリの女性が人間の男と結婚する事もある
brutality	横暴さ
plentiful	たくさんの|豊富な|多くの|豊富の|たっぷりの
massively	大規模
stately	威厳のあった|威厳のある|堂々と
lunchtime	昼食の時間
aeronautical	航空の
resonate	鳴り響く
linguist	諸外国語に通じた人|言語学者
circumcision	割礼(ユダヤ教などで宗教的儀式として男性の陰茎包皮を切り取ること)|《Circumcision》(カトリックで)キリスト割礼の祝日|(聖公会で)受割礼日(1月1日)
neuter	中性(の)
jest	しゃれ|冗談|戯れ|からかい|物笑い(の種)
exhibitionism	自己宣伝癖|露出症
redux	戻ってきた
compensatory	償いの|賠償的な|報酬の
guardianship	後見人の身分(役目|期間)
whisk	をさっと払う|をさっと動かす|を泡立てる|すばやい動き|泡立て器
agate	めのう(瑪瑙)
normalize	正常化する|正規どおりにする
fawn	じゃれつく|子鹿
recapture	取返す
disjoint	の関節を外す|脱臼させる|バラバラにほぐす|支離滅裂にする|交わらない|解体する|ちぐはぐにする
binge	ばか騒ぎ|どんちゃん騒ぎ(spree)|過剰な飲食
rayon	レーヨン|絹に似せて作った繊維|人絹(人造絹糸)や|ステープル･ファイバーからスフと呼ばれていた|Rayonは光線(ray)と綿 (cotton) の合成語
hacienda	(中･南米で住宅のある)農園|(農園･牧場の)住居
granddaughter	孫娘
thump	強い打撃|を打つ|にぶつかる|ゴツン|げんこつの音
pervert	変質者|を悪用する|を誤解する
spectre	可視光|紫外線|赤外線などを分光器で分解し|波長の順に並べたもの|幽霊(UK英)
cutout	切り抜き|安全器
anode	(電気の)陽極(positive pole)
anesthetic	麻酔剤|麻酔の|感覚が麻痺した|無感覚な|鈍感な
concurrence	一致
gully	谷川|峡谷|溝|下水
categorization	カテゴリー化
lunatic	精神異常者の|狂気の|精神異常者|愚人
troublesome	やっかいな|骨の折れる
freedman	(奴隷から解放された)自由民
eucharist	聖餐(式)|聖餐用のパンとブドウ酒
interceptor	妨害者(物)|(軍)迎撃機
objectivity	客観性
retard	遅らせる|送らせるもの|遅延|阻害|抑制剤
blacksmith	かじ屋|鍛冶屋
coffeehouse	コーヒー店
hereto	これに|この点(場所|事)へ
magnetism	磁力|魅力|磁気|人を引きつける力|磁気学
inventive	発明の才のある
clinician	臨床医
eyeball	眼球
further	さらにずっと|さらに先に|一層遠く|その上|更に
shorty	ちび|短い服|背の低い人|丈の短い
chromosomal	染色体の
velour	ベロア|ビロード布の一種|ソフトな感じの布|ぬいぐるみの人形などに使われる|ベロアの帽子
ostrich	ダチョウ|駝鳥|現実逃避者
tuba	チューバ(低音金管楽器)
elixir	霊薬|特効薬(イリクサ)|万能薬|不老不死の薬
cutting	割って入る
cyclical	周期的な(に起る)|循環する|循環株
lurker	潜んでいる人
mechanically	機械で|無意識的に
dike	みぞ|ditch|水路|堤防|土手道|堤防を築く|溝|土手
wiener	ウィンナソーセージ(語源|Vienna|Austria)|フランクフルト|ホットドッグ
fantasia	幻想曲|fantasy
troubleshoot	機械の故障を発見して修理する|紛争を解決する|〜‘の'故障を発見して修理する|〜‘の'紛争を解決(仲裁)する
marmot	マーモット
neoplasm	(体内にできる)新生物|腫瘍
crackdown	(違法行為の)取り締まり|弾圧|手入れ|断固たる処置
sharpener	とぐ人|削る道具
bonfire	焚火
calumet	カルメット(北米インディアンが和解の印としてタバコを回し吸いする長い飾りパイプ)
doggie	(幼児語)わんちゃん
lymphocyte	リンパ球
futile	無益な|無駄な|くだらない|役に立たない
preheat	予熱する
paddock	小牧地|パドック
elliptic	=elliptical
experimentally	実験的に
testis	睾丸
humanist	人間主義者|人文主義
cysteine	システイン|アミノ酸の1つ
musculoskeletal	筋骨格系の
cocker	甘やかす|大事にする
bequest	遺贈|遺産|伝わったもの|遺贈物|形見
affluent	豊富な|よどみなく流れる|裕福な|流れ込む
lonesome	寂しい|人里離れた
lifespan	寿命
unconventional	慣例にとらわれない|自由な|(服装など)略式の
determinant	決定力のある|決定する原因
solubility	溶解性
jacquard	《しばしばJ-》ジャガード織り(一種の紋織り物)
hangar	飛行機の格納庫
heartfelt	心からの
gallop	ギャロップ|馬の駆け足(4足とも宙に浮く全力走行)
inflate	膨張させる(反)deflate
heresy	異教|異端|異説|反論
telluride	テルル化物
victorious	勝利の|勝利を得た|勝った|戦勝の
mocha	コーヒー色|チョコレート色|モカ|上等のコーヒー|モカ革|モカ風味のケーキ|暗褐色|手袋用なめし革
sylvan	樹木の茂った|森の|森に住む
trawl	トロール網で魚を取る|トロール網 troll(輪唱する|流し釣りする) cf|troll(北欧民話の巨人)
unnatural	不自然な|不思議な|人情にそむく|異常な
alphabetic	アルファベット順の
groundwork	基礎|土台
thrombosis	血栓症
bursary	(大学などの)会計課|奨学金(scholarship)
tabernacle	仮の住まい|テント小屋|住み家
symphonic	音の類似した|交響曲の|調和した
nae	=no|not|=no
modernity	現代性|現代的なもの
relinquish	を放棄する|をやめる|断念する
reaffirm	再確認する|であると再び断言する
slime	どろどろした物|ねば土|ヘドロ|粘液|を泥で覆う
gangsta	ギャングスタ(テレビアニメ名)
luscious	(味･香りが)よい|おいしい|甘い
slipper	スリッパ(かかとの付いた靴)|(日本で言うスリッパはmule|scuff)|部屋履き|スリッパでひっぱたく
ethos	(特定の民族･社会･時代･文化などの)気風|精神|思潮|エトス
bil	billionの略|10億
argyle	(対照的な色を用いた)ひし形編み模様|ひし形模様編みの短靴下
prophetic	予言的な
bouncer	(俗)酒場|ナイトクラブなどの用心棒
consequent	当然の|結果
neutrality	(国家の)中立|中立政策|中立･不偏不党の状態
ovulation	排卵
euthanasia	安楽死|安死術|安らかな死
liter	リットル(1000cc)
fume	蒸発する|煙|蒸気|煙霧|熱気|怒気|煙を出す|をいぶす
unitarian	ユニテリアン派(プロテスタントの一派|三位一体の教義(The doctrine of the Trinity|父と子と聖霊)を排して唯一の神格を主張し|キリストを神としない)クリスチャン
lowercase	小文字
goldfish	金魚
irreversible	逆にできない|逆転できない|取り消しできない
baa	メー(ヒツジの鳴き声)[擬声語]|〈ヒツジが〉メーと鳴く
woofer	ウーファー|低音スピーカー|低いうなり声を出す人･動物
understanding	物わかりのよい|理解|知力|思慮|相互の理解|一致
seaport	海港
mallet	木づち
loophole	(窓などにあけた)小窓|(法律などの)抜け道|抜け穴|に小窓を付ける
postpartum	分娩後の
connective	(文法)連結詞
cheater	眼鏡|サングラス|(バスト)パッド
dove	ハト|ハト派
landowner	土地所有者
furl	〈旗・帆など〉‘を'巻く;〈傘・扇子・翼など〉‘を'畳む|巻かれる|畳まれる
proofread	校正する
glib	口の軽い|口の達者な|ベラベラしゃべる|口のうまい|行き当たりばったりの
plunder	略奪|略奪品|利益|を略奪する|をこっそり盗む
speck	小さい点|小粒|小さなしみ|小さな腐りきず|ちり|小片
downfall	大降り|失脚|滅亡|没落|落下
fictitious	架空の|偽の|創作上の|虚構|虚偽|架空
immortality	不死
saffron	サフラン|鮮黄色(の)
connoisseur	鑑定家|目きき|くろうと
peerless	無比の|無類の
improbable	ありそうもない
inefficiency	非効率
hornet	スズメバチ|すずめばち(=wasp)
atypical	異常な
excessively	過度に
slumber	無為に過す|眠り|うとうとする|活動を休止している
ogre	オーガ(オーグル|オグレ)|伝承や神話に登場する人食い鬼|女性はオーガス|動物や物に姿を変える|スカンジナビア半島ではオーガはトロールtrollと関連して出てくる
devoid	欠けていて
extraordinarily	異常に|並外れて|異例に|特別に|法外に
jogger	ジョギングする人
fielder	(野球)野手
shunt	変える|他へ向ける(こと)|血液を別の路へ流す
suture	(頭蓋の)縫合線|傷の縫い合わせ|縫合|縫合糸
revamp	を刷新する|改造する|修理する|を改良する|を改訂する|を繕う
apprehension	気づかい|不安|理解|逮捕
dishonest	不正直な
mailbag	郵便袋;郵便かばん(《英》postbag)
inert	(人など)のろい|生気のない|鈍い|不活性の
favorably	好意を持って|好意的に|好都合に|順調に|都合よく|有望に|有利に
discontent	不満な|不満
beehive	ミツバチの巣(箱)|盛り上げた女性の髪型|人込み
postwar	戦後の
yogi	ヨガの行者
implantation	移植
epistle	(形式ばった)書簡|手紙
unfavorable	都合の悪い|不運な|不利な|逆の|好意的でない|好ましくない
forgery	偽造|偽物|捏造|いんちき|偽造罪
anomalous	異常な|変則の|例外的な
jitter	(〜についての)神経過敏《+『about』+『名』》|いらいらする
commonplace	普通の|平凡な(こと)|陳腐な(ことば)
generalize	一般的に扱う
feminization	女性化
frugal	節約する|倹約な|質素な|つましい
extremist	過激派
starry	星の多い|星のように輝いた|星形の
dislocation	脱臼|混乱
elaboration	綿密な仕上げ|精巧さ|推敲|苦心の作
multipurpose	多目的の
cohesive	(日常などに)密接した|粘着性のある|結合性のある|密着する
corral	家畜囲い
tonne	メートルトン
caster	投げる人|配役係|鋳造者|(ピアノ|いすなどの)足車|キャスター|news casters(=news anchors)ニュース番組司会
medial	中間の|平均の|並みの|(文法)語中の
colossal	巨大な|素晴らしい|途方もない
conversational	会話の
battleground	戦場
brio	活気|元気
scaffold	足場を設ける|(建築場の)足場|絞首台|処刑台|(野外の)組立て舞台
screener	審査官|しゃへい装置|スクリーナー
hanukkah	ハヌカー(ユダヤ教の祭り)
adsorption	吸着|吸着量
travail	骨折り|苦痛|辛苦|苦労する|骨折る
dissatisfaction	不平|不満
cumbersome	扱いにくい|邪魔な|やっかいな
refresher	飲食物|元気を回復させる人
mousse	ムース|卵とクリームで作られるクリーミーなデザート
pancake	パンケーキ
transmembrane	膜貫通
jumble	ごたまぜにする|よせ集め|がらくた|ごちゃまぜにする
scarab	スカラベ|フンコロガシ|コガネムシ
firth	河口|入り江|湾
leapfrog	馬跳び(をする)
incision	切込み
undated	日付のない
alternately	交互に|一つおきに|互い違い|ちゃんぽん|交互
technologically	技術的に
gracefully	優雅に|淑やかに
anaerobic	anaerobic(bacteria|digestion|mud|fermentation|decomposition) 嫌気性(菌|消化|泥|はっ酵|分解)
antagonist	アンタゴニスト(拮抗薬)|Autoradiography(放射線写真法)で生体内の特定のレセプター(receptor|受容体)に作用し受容体の活動を抑制する薬剤
scorn	軽蔑する|あなどる|(軽蔑して)拒絶する|嘲笑|あざけり
ballerina	(イタリア語)バレリーナ|バレエの女性踊り手
waterman	漕ぎ手|船頭|漁師|こぎ手
propensity	傾向|性向
patiently	辛抱して|根気よく|辛抱強く
vomit	嘔吐する|激しく流出する
bromide	臭化物|臭化カリ|陳腐な考え|平凡な人
hefty	大きな|圧倒的な|かなりの
calamity	不幸な出来事|災難
exclamation	絶叫|叫び|感嘆|(文法)感嘆詞
artificially	人工的に
pubic	陰部の|恥骨の
extravaganza	派手なもの|(豪華な)ミュージカル映画
nitrous	硝石の|窒素の
elegantly	エレガントに
rosy	バラのような|楽天的な|有望な|薔薇色の|赤面した
airspace	領空
workable	運転できる
seminal	精液の|種子の|発生の|生殖の|未発達の|生産的な|独創性に富んだ
surfactant	界面活性剤
relevancy	関連(性)|適合性|検索能力
creeper	はうもの|(特に)はう昆虫|爬虫類|木に登る鳥(特に)キバシリ|つる草
bluebird	ルリコマドリ|ブルーバード(米国産の青い鳴鳥)|警官|ポリ公
comer	将来有望な人(物)
hernia	ヘルニア|脱腸
choreography	(バレエなどの)舞踊術(法)|振りつけ(法)
realistically	現実的に
bristle	(動物|特に豚の)剛毛|(ブラシなどの)毛|(複数形)ひげそり後に伸びた剛毛のひげ|(v)(毛髪などが)逆立つ|(動物が)毛を逆立てる|(怒りで)いらだつ|密生する
hula	フラダンス(の音楽)|フラダンスを踊る
grudge	恨みを持つ|恨み|出し渋る|悪意
scarcity	不足|稀少|まれなこと
abrupt	不意の|険しい|突然の
fastener	ファスナー
foxy	ずるい|こうかつな
liqueur	リキュール
superpower	異常(強大)な力|過力|超出力|超強大国|超大国
turret	(建物の角の|主に装飾用の)小塔|タレット
offbeat	風変りな|突飛な
enquirer	(=inquirer) 尋ねる人|質問者
landau	ランドー|ランドー型自動車|ランドー馬車
disappoint	を失望させる
libel	誹謗する|名誉毀損
swami	ヒンズー教の学者(聖職者)(の尊称)
colonization	植民地化|入植
agitation	動揺
lactation	乳の分泌|授乳期間
deflection	ゆがみ|かたより|それ|歪み|偏向|偏差|転向角
boldly	大胆に|太く
stonewall	(UK英)議事妨害する|情報などの公表を控え回答を拒否する
pulpit	説教壇
typography	活版印刷
unopened	開かれ(て)ない|未開封の
shorthand	速記
subspace	部分空間
boarder	下宿人
mantis	かまきり(強欲|残酷の象徴)
rosette	バラ結び(飾り)|(建)円花飾り
vicar	(英国国教会の)教区牧師|(教皇･司祭の)代理|代理者
hideaway	隠れ場所|閑静な場所|小さな町|人目につかない場所|折り畳み式ベッド|隠れた|人目を避けた
clove	裂けた|ちょうじ
tweeter	ツイーター|高音用スピーカー
marketable	市場向きの|売れる
periphery	(円･曲線などの)周囲|円周|(物体の)表面|周辺
grasshopper	バッタ
presto	(イタリア語)きわめて速く|速い|するとたちまち|プレストの(で)
contemplation	熟考|意図|熟視|熟慮
telex	テレックス
raunchy	だらしない|みすぼらしい|不潔な|みだらな|調子が悪い|病気で
shale	頁岩(けつ岩)|泥板岩|shale gasの産出で知られる
detoxification	解毒|無害化
whimsical	気まぐれな|風変わりな|変な|気まぐれ
nigger	(軽蔑的)黒人
matchmaker	世話人|斡旋者|仲人|結婚斡旋業者|競技の組合せをする人
aureus	黄色ブドウ球菌
tabulation	一覧表にすること
cannibal	人肉を食う|人食いの|(名詞)人を食う人間|(形容詞)人を食う|共食い動物|食肉類
antiquarian	古物収集家|古物商|古物研究の|好古趣味の|古書売買の
hump	こぶ|ラクダのこぶ|丘
beltway	環状道路(《英》ring road)
broil	焼ける|焼く
warmly	熱心に|暖かく|心から
ramble	四方八方に広がる|ぶらつく|散歩する|探求する|散歩|いつもの定まった道や計画からはずれて目的もなく気ままにぶらつく
sporadic	ときどき起こる|孤立した|散発性の|散発的な|散在する
eyebrow	眉
autistic	自閉症の
unnecessarily	不必要に|無用に|余計に|無駄に
reverence	尊敬|崇敬|崇拝
painless	痛みのない|痛み(苦痛)がない|簡単にできる|努力を要しない
replenish	再び満たす|補充する|満たす
stampede	殺到(する)|総崩れ|家畜などが驚いて集団暴走する(こと)
follicle	小嚢(しようのう)|卵胞|濾胞|(ovarian follicle|卵巣にある|卵子を含んだ球状の細胞の集合)
hydroxy	ヒドロキシ|ハイドロキシ|水酸化(である状態)
primo	最高級の
uneasy	心許ない|不安な|心配な|楽でない|窮屈な
infidel	信心しない|異教徒の
shalom	シャローム(ユダヤ人のあいさつ･別れの言葉)
dynamo	ダイナモ|発電機|精力的な人
shipwreck	難破(船)|挫折|難破する
truce	中止|中断|休戦|停戦|停戦協定
buyout	買い占め
taunt	あざける|なじる
spew	吐く|噴出する|にじみ出る|反吐(ヘド)
defamation	中傷|名誉毀損|悪口
daredevil	がむしゃらな人|向こう見ずの人|命知らず|向こう見ずな|命知らずの|無謀な
sampler	見本集|選書|取り合わせたもの
fiend	悪魔(=devil|daemon|Satan|fiend)
numerically	数値的に
decoy	おとり|囮
sexton	寺男|会堂管理人|墓掘り男|(ユダヤ教)堂守
coercion	威圧|強制
expend	金銭を使い果たす|使い果たす|消費する|時間を費やす|労力を浪費する
zona	ゾーン|地帯
mindful	気をつけて|忘れないで
hitherto	これまで(は)|いままで
arboretum	植物園|樹木園|森林公園
goalkeeper	ゴールキーパー
armament	軍備
circumference	周囲|円周|境界線
responsibly	責任を持って
downright	徹底的な|全くの|純然な|素直な|全く|率直な|完全な(に)
flatten	たいらになる|打ちひしぐ
inexperienced	初心の|至らぬ|至らない|半人前の|不慣れ|駆け出し|未熟|無経験な|不慣れで
caprice	気まぐれ|きまぐれ|むら気|気まま
futurama	フューチュラマ|31世紀の地球を舞台にしたジオラマ|1939年ニューヨーク万博に展示され人気を博す|テレビアニメとして1999以降放送された
frosty	凍りつくような
centerfold	(雑誌などの)2ページ見開き|折込みページ
placenta	胎盤
marinade	マリネ|マリネに漬けた肉･魚|マリネに漬ける
prosthesis	人工的補助物(義足等)
spammer	大量の迷惑メールを送りつける人
quiver	おののく|震え|矢筒|揺れる|震える|を震わせる
echelon	段階|レベル
maturation	成熟
letterman	学校スポーツにおいてレター表彰を受ける運動選手
refractive	屈折の
contentious	議論好きな|論争的な|異論のある|係争の
fairytale	童話
intercollegiate	大学間の|大学対抗の
dispel	追い散らす|追払う|払い去る|晴らす
emancipation	奴隷解放|解放|解脱
duchess	公爵夫人|女公爵|公妃
incite	刺激する|励ます|煽る|扇動する|引き起こす
disperse	分散させる|散らす|散乱させる|解散させる|分散する
captivity	捕われの身|監禁|捕らわれ
haw	サンザシ(の実)
distrust	信用しない|疑惑|疑う|不信
bravery	勇敢|勇気
hilltop	丘の頂上
sincerity	誠実|率直さ
hairless	毛のない
unchecked	チェックしない
regionally	地域的に
trample	踏みつけること|を踏む|踏みにじる
symbolize	を記号で表す|を象徴する
tradeoff	同時に満たしえない幾つかの条件の取捨についての考量|トレードオフ|交換条件|見返り
liturgical	礼拝式の
vino	ブドウ酒|ワイン
exogenous	外因性の|外来栄養の
daydream	白昼夢
twinkle	きらきら輝く|きらめき|閃光|キラキラ|星などが光る様子
fluency	なだらかさ|流暢
heretic	異端者
conceivable	考えられる
growl	腹立ち声でと言う|犬がうなる
epithelium	上皮
parlour	応接室
banter	からかい|ふざけ|ひやかし|(悪意のない)冗談
flashpoint	一発触発の危機|引火点
breakaway	離脱(した)|分離(的な)
oneness	(思想・信念・目的などが)一つであること;同一性|単一性
glimmer	ほのかに見える|かすかな光|微かな光
renounce	要求を正式に放棄する|をやめる|捨てる|を否定する|を拒否する
incompatibility	両立しがたい(相反する)こと|性格の不一致
climber	登山者|はい登る植物(ツタなど)|出世主義者
recoverable	取り戻せる|元に戻せる|(体が)回復できる|全快できる
headband	ヘッドバンド
intellectually	知的に
fiche	=microfiche
wort	麦芽汁(ビールの原料)
lactose	ラクトース|乳糖
competitively	競争的に
microcomputer	マイコン|超小型コンピュータ
spreader	バターナイフ|散布機
feral	野生の|野にいる|野生化した|野獣のような|凶暴な
guise	ふり|見せかけ|服装|変装
impatient	せっかちな|しきりに～したがる|～に耐えきれない
aquamarine	藍緑色|藍玉(緑柱石の一種|3月の誕生石)
aforesaid	前述の
readout	(コンピューターなどから)読みだした情報
sou	スー(フランスの5サンチームまたは10サンチーム銅貨)|つまらないもの
fright	恐怖|驚き
confine	閉じ込める|制限する|監禁する|境界
physiotherapy	=physical therapy
laird	地主|人名
parka	パーカ|毛皮ジャケット
objectively	客観的に
petal	花弁|花びら
banger	爆竹|雷薬|音は大きいがきれいではない花火|(俗)ソーセージ
calla	(サトイモ科)カラ|ミズイモ
tablecloth	テーブルクロス
pare	の皮をむく|(爪)を切る|を削り取る|を削減する
hoard	貯蔵(する)|買いだめ(する)
deflect	(思考など)をゆがめる|そらせる
arrhythmia	不整脈
cervix	頚部
barrister	バリスター(法廷弁護士) 
cremation	火葬|焼却
rapist	強姦犯人|レイプ犯人
sewerage	下水設備;下水処理|=sewage
culvert	(道路･鉄道などの下を通る)カルバート|排水溝
sterilization	不妊にすること|断種(手術)|殺菌|消毒
intron	(遺伝学)イントロン|介在配列|転写はされるが最終的にスプライシング反応によって除去される塩基配列|(スプライシングによって除去されず残る部位はエクソン)
ovation	熱烈な歓迎|大かっさい
carpal	手根骨の|腕骨の|腕骨
avenger	復讐者
undocumented	文書化されていない
poncho	ポンチョ|ポンチョ風のレインコート
gloomy	憂うつな|暗い|薄暗い|悲観的な|うっとうしい
encapsulate	カプセルに包む|(事実･情報などを)要約する
evacuate	避難する|撤退する|疎開する|立ち退かせる|明け渡す|避難|退去|撤退
complexion	形勢|外観
nutritious	栄養の
marguerite	マーガレット(花の名|白菊)|人名
cautiously	慎重に
dressage	(馬の)調教|調馬
phylogenetic	系統発生の
staphylococcus	ブドウ球菌
morbid	ゆううつな|病気の|病的な|憂うつな|恐ろしい|不健全な
emitter	放射体|エミッタ(トランジスターの電極)
muff	落球|へま
rubble	破片|瓦礫
cheeky	頬のよく発達した|生意気な
proponent	提案者|弁護者|擁護者|支持者
barricade	妨害するもの|障害物|バリケード(を築く･で囲む)|戦場
truthful	誠実な|正直な|本当の
bioethics	生命倫理学|生命に関する倫理的問題を扱う分野|動植物など全生命体を対象とするが|医学面が強調されることが多い
talisman	護符|お守り|不思議な力のあるもの
rehearse	リハーサルをする|習熟させる|繰り返して言う
rps	revolutions per second毎秒回転数
pseudomonas	シュードモナス属|グラム陰性で好気性桿菌の属|in vitro(試験管内)での培養が容易で|ゲノム配列数の増幅が可能な点で|学術的研究で重要視される
avionics	航空電子工学
roadrunner	ミチバシリ(北米産のホトトギス科の鳥;地上をよく走る)
minimization	最小化
linearly	直線的に
incarceration	監禁|投獄|幽閉
poignant	感動させる|するどい|痛烈な|心が痛む
troupe	一座|一団
punishable	罰すべき
transpose	置き換える
salient	顕著な|突き出た|噴出する
selectivity	選択性
projectile	発射する
fluff	(ラシャなどの)けば|綿毛|ふわふわしたもの
fission	分裂|核分裂|(fission核分裂|fusion核融合)
worldview	世界観
nth	n倍の|何番目か分からないほどの|最も新しい
prologue	プロローグ|前口上|序幕|序言
mammography	マンモグラフィ|乳房X線撮影法|撮影装置
scavenger	死肉をあさる動物|清掃動物|くず拾い|掃除人
ordeal	厳しい試練|苦しい試練|試罪法|神明裁判
hydroxide	水酸化物
communicable	伝達可能な
enzymatic	酵素による
melanogaster	キイロショウジョウバエ
anew	再び|新規に
commandment	(神の)おきて|戒律
undetermined	未決定
yah	Yes|やあ-い
cochin	コーチン|アジア産の肉用の鶏
disproportionate	不つりあいな
bally	(UK英)ひどい
sawmill	製材工場|製材所|大型製材のこぎり
grout	(石の接合に用いる)うすとろ|セメント糊(のり)
wither	しおれさせる|しぼむ|枯れる|衰退する|弱る
carving	彫刻物|彫刻(術)
gallant	勇ましい|勇敢な|雄々しい
exponentially	急激に|幾何学級数的に
recoil	しりごみする|はね返り|後座する|退却する|畏縮する|ひるむ|跳ね返る|反動する
boomerang	ブーメラン|やぶへびの議論(攻撃)|投げた人の所へ戻る
meow	ネコが鳴く|ニャー|猫の鳴き声
canteen	食堂|売店|食品売店
serenade	セレナーデ(を奏する･歌う･演奏する)
familiarize	親しませる|慣れる
terrier	テリヤ(犬種)
hysterectomy	子宮切除
biologically	生物学的に
prepay	前払いする
venerable	尊敬に値する|神聖な|いわれのある
federalist	北部連盟支持者|連邦主義者|連邦主義
admirable	賞賛すべき|立派な
octane	オクタン(石油に含まれる炭化水素の一つ)
alb	アルバ(司祭がミサで着る祭服)
formalism	極端な形式主義|形式主義|形式論|形態心理学
brittle	壊れやすい|堅いがもろい|傷つきやすい|砕けやすい
girly	女の子らしい|(girlieは性的|蔑称的)
rationality	純理性|合理性
politely	ていねいに|礼儀正しく|丁寧に
soapbox	石鹸を詰める木箱|(街頭演説のための)演壇用の箱
ingenious	工夫に富んでいる|器用な|精巧な|独創的な
insole	靴の敷き皮
mascara	マスカラ|まつげ染め
artichoke	朝鮮アザミ|アーティチョーク(食用)
elongation	延長|延長線|伸び|伸長|離角|離隔
torsion	ねじれ
madman	気違い|狂人
blunder	不注意な失敗|大失敗(する)|つまずく|やり損なう
albumin	(ælbjúːmən)アルブミン|可溶性たんぱく質の総称|血清アルブミン|卵アルブミン|乳アルブミンがある|グロブリンと共に2種の血漿タンパクの1つ|アルブミン濃度は肝機能の指標
banshee	家族に死人のでることを泣いて予告する女の幽霊
sari	サリー|インド･ネパール･スリランカ･バングラデシュ･パキスタンなど南アジア地域の女性が着用する民族衣装
somatic	(精神に対し)身体(上)の|肉体の
summation	合計(すること)|要約
blemish	傷つける|欠点|汚点|にきび|吹き出物
whirl	ぐるぐる回る･回す(こと)|疾走する|めまい(がする)|急に向きを変える|騒動
mycobacterium	マイコバクテリウム属|グラム陽性細菌に分類される真正細菌の一属
antiviral	抗ウイルス薬
absorbent	吸収できる
hiatus	(空間の)隔たり|(時間の)空白|隙間|切れ目|割れ目|ひび|中断|休止|欠落
publicize	を公表する|宣伝する
spurious	偽の|私生児の|もっともらしい
gloom	薄暗くなる|暗がり|薄暗がり|陰気|沈んだ様子
dap	餌を水面に浮き沈みさせて釣りをする
angelic	天使のような
astrological	占星術の
nobility	高貴の生まれ|高潔さ|貴族
noncompliance	違反
ashore	岸に|浜に|陸上に
swimmer	泳ぐ人
raccoon	アライグマ
linotype	ライノタイプ(タイプライター式に活字を打ち出す機械;商標名)
marge	マーガリン|(人名)Margaretの省略形
goliath	移動式大起重機|ゴリアテ(Davidに殺されたペリシテ族の巨人)|巨人|力持ち
thrush	鵝口瘡(がこうそう|カンジダという真菌により舌やほおの粘膜に白い斑点ができる病気)|ツグミ(鳥)
legislate	法律を制定する
stringer	(鉄道の)まくら木|縦げた
deliverable	配送品|配達可能な|到達可能な
badness	正しくないこと|悪いこと|正常でないこと|不正確なこと
vulgate	(the V～)(4世紀末翻訳されたラテン語訳聖書)ウルガタ(の)|(v～)定本|(the v～)俗語|非標準語
westerly	西の|西方への|西からの
baritone	バリトン(歌手)|男声中音|(次の順に高くなる|bass|baritone|tenor|alto(女声)|treble(女声soprano)
wok	中華鍋
sorcery	魔法 
edema	水腫|浮腫
confidently	確信して|自信を持って|大胆に
blackbird	ブラックバード
reunite	再び結合する|仲直りさせる(する)
restrain	抑制する|を押さえる|を制止する|防止する
dangerously	危険なほど
carotid	頚動脈
scraper	どろかき|こする人|スクレーパ
childish	子供らしい
janitor	(学校や施設の)用務員|管理人|門番
priesthood	司祭職
nara	奈良(日本の古都)
aster	キク科のシオン属の植物|星状体
dispersal	散乱|分散|離散|伝播
overt	明白な|公然の|あからさまの|表立った
verbally	言語で|に関して
chenille	シュニール|シュニール糸|シュニール織物|(芋虫から紡いだ毛虫糸)
dehydration	脱水症状
undeclared	(課税対象物品が)税関未申告の|(戦争など)宣戦布告なしに
mow	刈る|干し草の山
burrito	ブリトー(肉・チーズなどを小麦粉のトルティーヤで包んだメキシコ料理)
cliche	(陳腐な)決まり文句|月並みな考え
dearly	愛情を込めて
suggestive	思わせぶりな|示唆的な
sedimentation	沈降
optometry	検眼|視力測定
attendee	出席者
gypsum	石膏|硫酸カルシウム(CaSO4)|(=plaster)
baroness	男爵夫人;男爵にあたる女性の爵位
winning	決勝の|勝利|勝った
transponder	トランスポンダー(特殊信号を受け|自動的に返信するように設計された電気機器)
imaginable	想像できる|考えられる
kingfisher	カワセミ 
predatory	略奪する|肉食(性)の
descendant	子孫|後裔
instalment	=installment
dupe	だます|かつぐ
dismal	気味の悪い|陰気な|陰欝な|暗い|憂欝な
kilometer	キロメートル
topple	倒れる|ぐらつく|倒す|よろけて倒れる
progeny	結果|子供たち(children)|子孫(offspring)|後継者|直系の人(the immediate descendants of a person)
ellipse	長円形|楕円(だえん)
corrosive	腐食させる|腐食性の|皮肉たっぷりの|腐食剤
dammit	くそ|こんちくしょう
rollback	統制による物価･賃金･利率引き下げ政策
choker	首飾り|カラー|短いネックレス
jazzy	ジャズ的な|ジャズ風の|狂騒的な|活気のある|はでな
cantor	主唱者|先詠者|先唱者|独唱者|朗詠者
boron	硼素(ほうそ)(非金属元素;化学記号は『B』)
reluctantly	しぶしぶ|いやいや
stoop	かがむ|腰が曲がる|を曲げる|品位を落とす|ポーチ
jetty	突堤|防波堤|桟橋|pier|漆黒の
superfund	スーパーファンド
saute	(仏語)ソテー(にした･する)(にする)|少量の油で強火でいためること･またはその料理
centrifugal	遠心性の|遠心的な
authorship	著述業
piercing	ピアスをする|つんざく|大声の|甲高い|骨身にこたえる|洞察力のある
mallard	マガモ(の肉)
craving	渇望|切望|have a craving for chocolate(欲しくてしかたがない)
decidedly	明らかに|議論の余地なく
apathy	無感動|感情鈍麻|無関心|冷淡
mercantile	商業の|商人の|重商主義の
orphanage	孤児院|孤児
rectifier	整流器
islet	小島|非常に小さい島|隔絶されたもの･場所
carney	見せ物|carney complexカーニー複合(遺伝子関連用語)|異なる遺伝子の突然変異により発生する
freakin	freaking(熱狂的な|変わった)の省略形
cobble	(靴を)修繕する|急いで作り上げる|丸石(を敷く)
greasy	グリースを塗った
tactile	触覚の|触覚を有する
cinematography	映画撮影術|映画撮影法
carnage	大虐殺|殺戮
skier	スキーヤー
ingenuity	発明の才|創意|独創性
histone	真核生物のクロマチン(染色体)を構成する主要なタンパク質
snug	(場所･人が)暖かく心地よい|気持ちのいい|快適な|こざっぱりした|こぎれいな|ぴったりあった|(収入が)ささやかながら不自由しないだけの
diverge	分岐(する)|(意見などが)異なる|相違|逸脱