burg	(独語他に由来)|市|町|(地名接尾辞の一種|単語のあとにつけ場所を表す)
astray	邪道に入って|迷って|迷っている
infirmary	診療所|小病院
reschedule	を繰り延べる|の予定を変更する
firebox	(蒸気・ボイラーなどの)火室
sanctity	神聖さ|神聖|神聖な義務
modus	(ラテン語)様式|方法
pedantic	学者ぶる
diarrhoea	下痢
notoriously	悪名が知れわたるほどに|悪名高く
jib	船首の三角帆|ジブ|(起重機の)腕|ジブ
deadwood	枯枝|枯木|無用な人々(もの)
commonsense	『常識』|良識|分別
streetcar	路面電車
infidelity	不信心|不誠実|(夫婦間の)不貞|背信|無信仰|不信|不義
phrasebook	熟語集|(海外旅行用などの)慣用俵現集
reconfiguration	再構成
parochial	地方的|教区の
ketone	ケトン|有機化合物群|除光液として用いられるアセトンなど
tenement	保有財産|住宅|家屋|アパート|借地|借家
pall	ひつぎ|棺衣|大司教用肩衣
disqualify	無資格にする|資格を奪う|失格させる
comprehensively	総合的に
deference	服従|意見に従うこと|敬意
smock	スモック|作業服|上っ張り
crossbow	石弓
limelight	ライムライト|石灰光(石灰=lime製の棒を酸水素炎に当てた時生じる強烈な照明光)|注目の的
artful	巧妙な|ずるい|人工の|人為的な
ideograph	表意文字(漢字や古代エジプトの象形文字)
masculinity	男らしさ
cloister	修道院|回廊|引きこもる|修道院生活|隠遁生活|静かな隠れた場所
audacity	大胆不敵|boldness|厚かましさ
unmet	満たされていない
compositional	組成の
trig	粋な|こぎれいな|健康な|輪止め|こぎれいにする|着飾る|楔で留める|三角関数trigonometric
downwards	=downward
gleam	かすかに光る|微光|かすかな光|ひらめき|(暗い中で)光る|輝く
inasmuch	だけれども
weatherproof	(ぬに衣服が)風雨に耐える|〈生地〉‘を'風雨に耐えられるようにする
mauve	ふじ色|モーブ色(の)|フジ色|藤色
splatter	バチャバチャいう(音)|ベチャクチャしゃべる
impromptu	即座に|用意なしに|即興に|にわか作りで|即興の
hazy	もやのかかった|ぼんやりした|かすんだ
intimidate	怖がらせる|脅かす
carport	カーポート|差しかけ屋根のみの簡易車庫(garageとは異なる)
biennium	2年間
irritant	刺激する|刺激性の|刺激剤|刺激物
sketchbook	写生帳|スケッチ(随筆)作品集
biodegradable	生分解性の
protege	被保護者|子分|子飼いの部下
spore	胞子|芽胞|胚種(はいしゆ)|種子
reactionary	反動の|反動主義者|反動政治家
hunch	(背を)弓なりに曲げる|(背を)丸くする|He sat hunched at the table|(背を丸めて座っていた)|こぶ|厚切れ|かたまり|(口)予感|直感|こぶ(hump)
truncate	先端を切取る|切り捨てる
nucleoside	ヌクレオシド|塩基と糖が結合した化合物|アデノシン|チミジン|グアノシン|シチジン|ウリジンが主なヌクレオシド|リン酸と結合しデオキシリボ核酸(DNA)やリボ核酸(RNA)を作るヌクレオチドとなる
myosin	ミオシン|タンパク質の一種|ATPase活性を持ち|ATPを加水分解しながらアクチンフィラメント上を移動するモータータンパク質
fibrous	繊維の|繊維質の|繊維性の|繊維状の|強い|強靭な
epilogue	結びのことば|納め口上 
erg	(広大な砂丘列)エルグ
acetone	アセトン(揮発・可燃性液体;ペンキなどの溶剤として用いる)
alanine	アラニン|非必須アミノ酸のひとつ|グリシンについで2番目に小さなアミノ酸でほとんどすべての蛋白質に見られる
manipulator	ごまかし屋|手で巧みに扱う人|操る人|操縦者
backfire	裏目|逆効果|さか火|裏目に出る|失敗に終わる
lordship	支配権
blitzkrieg	(一気に水を制圧する)電撃戦
infrequently	まれに|たまに
rout	敗走(させる)|大敗北|捜し回る|野次馬|暴徒|群れ
cour	裁判所
exemplar	手本|模範|典型|見本|標本|謄本
perforation	穿孔
persevere	我慢する|辛抱する|耐える|やり抜く
yelp	悲鳴|ほえたてる|(犬が)キャンキャン鳴く
bloodstream	血液循環
nevermind	語源は心配するな|→同名の音楽アルバムで大ヒット
thunderbolt	落雷
bombardier	爆撃手
cytotoxic	細胞毒性の
frag	(手投げ弾で)〈気にくわぬ上官〉‘を'粉々にしてやる|襲う
debacle	鉄砲水|大災害|大事故|大失敗|(市場の)暴落|崩壊|瓦解
ceasefire	停戦
incarnate	肉体を持つ|具体化した|人の姿をした|肉体を与える
colophon	出版社の標識マーク|奥付
necktie	ネクタイ|絞首づな
hatter	帽子屋;帽子製造人
urinal	小便器
yew	イチイ(木の名前|その材木)
unannotated	注釈なしの
headstone	かなめ石|笠石|隅石|墓石
nervousness	あがり|緊張感
patchy	寄せ集めの
chasm	深い割れ目|隙間|みぞ|隔たり|欠陥
pathophysiology	病態生理学
masque	仮面劇(16‐17世紀ごろ英国貴族間に流行した一種の無言劇)|仮装舞踏会
transitive	他動詞の|推移的|移行する
chowder	寄せ鍋
idealism	理想を抱くこと|理想主義
septum	隔膜･隔壁
separable	分かちうる|分離できる|引き離せて
metallurgical	冶金(やきん)学の
molybdenum	モリブデン(金属元素;化学記号は『Mo』)
hexagonal	六角形の
refraction	屈折(作用)
peony	牡丹|ボタン|シャクヤク
incoherent	一貫しない|つじつまの合わない|矛盾した|支離滅裂の
intrude	はいり込む|侵入する|を無理に押し入れる|押し込む|を強いる
upheaval	(社会的な)大変動|持ち上がること|(地殻の)隆起|動乱|激動|激変
hardball	硬球を投げる|強気に出る
devout	信心深い|faithful|pious|religious|worshipful
unfurnished	家具の備えてない
cosmetology	美容術|化粧法
firehouse	消防署
shooting	発射する
contig	DNA配列断片を重ね合わせて (アライメントして) できる配列断片群を指す|単語「contiguous」に由来
lifeboat	救命艇
changeover	転換|切り替え|変更
springboard	出発点|跳躍板
oilfield	油田
breathless	息を切らした
devolution	権限譲渡|(財産･権利などの)移転
reunification	再統一
caenorhabditis	線虫(特に土壌中の線虫は農業に被害を与える)
berserk	狂暴な
purgatory	(カトリック)煉獄|苦行|苦難(の場)
unsaturated	不飽和の
violinist	バイオリニスト|バイオリン奏者
tillage	耕作|耕作地
minstrel	吟遊詩人|詩人|旅芸人
nonexistent	存在しない
unearth	発掘する|発見する
headland	岬(=promontory)
biophysical	生物物理学の
lasagna	(ｲﾀﾘｱ語)ラザーニャ|イタリアのパスタ料理の一種
supermodel	スーパーモデル
toughness	粘り強さ
backwater	戻り水|逆流|よどみ
airlift	空輸(する)
indeterminate	不確定の
refreshment	気分をさわやかにする|休養|元気を回復させる物|気分をさわやかにするもの
momentarily	ちょっとの間|すぐに|絶えず
anemone	アネモネ|イソギンチャク
predicament	断定されたもの|窮地|苦境|窮状|状態|境遇|苦しい立場
changeable	変わりやすい
tragically	悲劇的に
coexistence	共存
mutilation	骨抜き|(手足などの)切断|切除
justifiable	正当と認められる|筋の通った|尤もな|当たり前の
twofold	2倍の(重)の(に)|2要素のある|2部分|2倍(重)に|二重|2要素をもつ
grotesque	グロテスクな|グロテスク|奇怪なもの
starve	飢えさせる|餓死する|飢える|を餓死させる
prospector	採掘者|試掘者|試堀者
unearned	労せずして得た|不労所得の
chanson	シャンソン|歌
redox	酸化還元反応
clad	服を着せる|おおう
cobbler	靴直し(店)|パスポートや偽札を作る人
tricycle	三輪車
fistula	瘻孔(ろうこう)|体内と体外|または管腔臓器間に生じる管状の欠損
bombshell	爆弾|砲弾|突発事件
meticulously	細心の注意を払って
convalescent	回復期の|病気上がりの
mackerel	サバ|鯖
going	進行状態|進行速度|行くこと|出発|死去|道路の状態|コンディション
provident	将来に備える|節約の|つましい
leprosy	ハンセン病|ハンセン氏病|らい病
marmalade	マーマレード
chutney	チャツネ|チヤットニ(Indian relish)|果物の漬物(酢に砂糖|生姜|スパイスの)
throng	に群がる|群がる|群集|人だかり|雑踏|多数|集合
nonviolent	非暴力の
defraud	から詐取する|だましとる
cantilever	片持ち梁(ばり)|張出し梁
splendour	輝き
moustache	口ひげ
tritium	トリチウム(水素の同位元素;化学記号はT)
effector	エフェクター|効果機器(入力信号に反響などの効果を与える装置)
escalator	エスカレーター
snooze	うたた寝する|居眠り|居眠りする
retake	奪い返す
turtleneck	タートルネック|とっくりセーター
sprinter	短距離走者
zircon	ジルコン|風信子石(鉱物の一種)
honeycomb	ハチの巣
yardage	ヤード法で測った長さ
neve	万年雪に覆われた雪原|粒状万年雪
ecologist	生態学者
whereof	～の|そのうち
electrolysis	電気分解|電解|電気分解法(腫瘍・毛根などを電気で破壊すること)
gruesome	気味の悪い|身の毛のよだつ
wetsuit	(保温用の|ぴったりした)潜水服
peroxidase	有害物質を酸化的に切断して2つのヒドロキシル基に分解し|無害化する酵素
pleading	(弁護側の)弁論
sloth	(動物)ナマケモノ|なまけもの|怠惰
snarl	ウーッ|犬のうなり声|鳴き声|がみがみ言う
neurologic	神経学
faraday	ファラデー(電気分解に用いられる電気量の単位)
oblong	長楕円形|長方形
macabre	背筋の凍るような|ぞっとする
neurontin	ニューロンチン|てんかんの治療で発作をおさえる抗痙攣薬(商標名)
bookie	(競馬の)賭元
declarative	宣言の|明らかにする|説明する|意見を表明する
sexist	(女性に対する)性差別主義的な|性差別をするもの･人
attainable	到達できる|遂げられる
puree	(仏語)ピューレ(野菜･肉を煮て裏ごししたスープ)
hearsay	噂|風聞
rawhide	生皮|生皮のむち(で打つ)
knickers	婦人用ブルマー|半ズボン
angioplasty	血管形成術
fanboy	おたく|物事に異常に熱中する人(fanboyは男性のオタク|fangirlは女性のオタク)
kilogram	キログラム
bystander	傍観者|見物人
bifurcation	分岐
lasso	投げ縄|投げ縄で捕らえる
soot	スス|すすだらけになる
yonder	あそこに|あそこの|向こうに見える|反対側の(=yon)
virulence	辛辣さ|ひどい悪意|憎悪|毒々しさ|(病)毒性
vigilante	自警団員
comparability	比較可能性
lowly	みすぼらしい|質素な|謙遜して
industrialization	産業化
comical	おもしろい|こっけいな
blurry	しみだらけの|ぼやけた
hydrant	消火栓|消化栓|水道栓
accumulator	蓄財家|ためる人|《英》蓄電池(storage battery)|(電子計算機の)累算器
unfunded	未積立
antineoplastic	腫瘍(しゅよう)の成長を防止する
amputation	(手術などの)切断
whiz	専門家|名人|達人|びゅー(ピュー)と飛ぶ|さっと片づける|さっと動かす|ビュー(という音)|(口)風を切って飛ぶ
strapless	ストラップレス|肩吊りひもなしの衣服|strapのついていない|肩ひもなしの
qualitatively	定性的に
dodgy	(dάdʒi) (物事が)危っかしい|危険な|困難な|(器具など)安全でない|(人が)ずるい|油断のならない
thymus	胸腺
handlebar	ハンドルバー|(二輪車の)ハンドル|操作レバー
lesbianism	(女性間の)同性愛
angrily	怒って
croquet	(kroʊkéɪ)クロケット(芝生の上で木槌|mallet)で木製ボールを打って鉄の門(hoop)を通し|ゴールのポールにあてるゲーム
soundness	健全なこと
generational	世代間の
marquise	(英国以外の)侯爵夫人|侯爵未亡人
coriander	コエンドロ|コリエンダー(セリ科|香味料) cf|cilantro
plunger	プランジャー|飛び込む人|潜水者|突入者
bonjour	ボンジュール(こんにちは|仏語)
sojourner	逗留者|滞在者|旅人|ソジャーナー
manipulative	整体の
entitle	に題名をつける|資格(権利)を与える
backer	後援者
evocative	呼び起こす|喚起する
undeniable	否定できない
riverboat	川船
perforce	いやおうなしに|必然的に
tangy	ぴりっとする
distillery	醸造所
edict	命令|勅令|布告
boundless	限りない
hopelessly	望みを失って|絶望して
sceptre	=scepter
amphibian	両生類(の)|水陸両用の|水陸両用飛行機･戦車|両生動物
grandchild	孫
ribosome	リボソーム(リボゾーム)|あらゆる生物の細胞内に存在する構造|mRNAの遺伝情報を読み取ってタンパク質へと変換する翻訳が行われる場である
indignation	憤り|義憤|憤慨|悲憤
pusher	麻薬の密売人
menstruation	月経
antichrist	反キリスト
wane	衰弱|減少|(月の)欠け|終わりに近づく|衰える|弱まる|(月が)欠ける
subcutaneous	皮下
creatinine	クレアチニン(筋肉に多くエネルギー代謝に関与する化合物)
bookkeeper	帳簿係
coney	=cony
degas	〜‘から'ガスを抜く
presidio	米国南西部にスペイン人によって設置された要塞|砦|囚人植民地
transfection	トランスフェクション|人為的にDNAやウイルスなどを細胞に取り込ませる手法
roux	ルー(小麦粉をバターでいためたもので|スープやソースにとろみをつけるのに用いる)
windward	風上の|風上へ|(反|Lee風下へ|風下の)
delirium	精神錯乱|せん妄
collaborator	協力者|共編者|敵国協力者
unfounded	根拠のない|理由のない
heroism	勇気|英雄的行為
xenopus	アフリカツメガエル
headliner	主役スター
reactivate	再活性化する|現役復帰させる|再開する
veranda	ベランダ|縁側
assertive	断定的な|独断的な
weirdness	凄味|奇異さ|不気味さ
glycogen	グリコーゲン
detainee	(外国人)抑留者|(特に政治的理由に基づく)被抑留(拘留)者
befall	に起こる|降り掛かる
bobbin	ボビン･糸巻き
toluene	トルエン
jinx	不幸をもたらす|運を悪くする|ジンクス
amalgam	アマルガム(水銀と他の金属との合金)|合成物|混合物
humanoid	ヒト類似の生物|ヒューマノイド|人型ロボット|ヒトそっくりの
tonneau	トンノー(昔の自動車の後部座席)
cynicism	皮肉
bombardment	爆撃
transgendered	性転換の
polity	政治形態(組織)|政治的組織体|国家組織
considerate	思いやりのある
extraneous	異質の|無関係な|外来の|外側の|無関係の
amalgamation	合併|融合|アマルガム化|合同|混合物|合同体
platypus	カモノハシ
thereunder	その下に|それ以下に
pacifier	調停者|(赤ん坊用)ゴム乳首|おしゃぶり
mohair	アンゴラヤギから作られる織物
basso	〈C〉低音歌手|〈V〉低音
chore	家庭での雑用|雑用|雑役
crockery	陶器類
preemptive	先制の|先買の|先買権のある先制の
bulldozer	ブルドーザー|脅迫者
counterterrorism	テロ対策
taskforce	(特殊任務を帯びた)軍の機動部隊|(一般に)対策本部|対策委員会
astrophysical	天体物理学の
pairwise	対で起きる
ogle	女性に色目を使う|例He was not in the habit of ogling women
shortcake	《米》いちご・甘く味付けした果物などをあしらったケーキ|《英》厚手の
fondly	優しく
whither	そこへ|何処へ
outfitter	装身具製造業者
immunological	免疫学的な
preservative	保存の|予防法
famously	有名|著名な
controllable	制御可能な
prescriptive	慣例による|規定する|規範的な|指令を与える|時効取得された
salaried	給料を受けている
southward	南へ(の)
taxicab	タクシー
intolerant	耐えられない|狭量(偏狭)な|(宗教上)異説をいれない
manhole	マンホール|集合場所|肛門
orthodontic	歯列矯正の
snub	けんつく|ひじ鉄砲|を鼻であしらう|冷遇|厳しい叱責
lithography	石版刷り
cashew	カシュー(熱帯アメリカ産ウルシ科植物)
chipper	元気のよい
subheading	(新聞などの)小見出し
schizophrenic	統合失調症の
knitter	編む人|編み機
suburbia	郊外|郊外居住者(住民)
propellant	(ロケットの)推進燃料|高圧ガス|推進薬|発射火薬|発射薬
optimally	最適に
embryology	発生学|胎生学
styrene	スチレン|スチロール(合成ゴムの原料)
inducible	誘導性
misconception	誤解
rudimentary	初歩の|基本の|未発達の
riesling	リースリング(ドイツの白ワイン)|リースリング用ブドウ
settler	入植者|移民者
rabble	野次馬|やじうま
skirmish	小ぜりあい(をする)
allergen	アレルゲン(ドイツ語)とは|アレルギー疾患を持っている人の抗体と特異的に反応する抗原のこと|一般にそのアレルギー症状を引き起こす原因となるアレルギー物質を言う
overseer	監督者
insurgent	反乱を起こした|反政府の|暴徒|反乱者|反政府運動家|反対分子
crystallography	結晶学
rightfully	当然
gallbladder	胆嚢(胆汁をたくわえる)
nightwear	寝巻
sconce	(壁などの)突き出し燭台(しょくだい)
shutout	締め出し
stagnant	よどんだ|活気のない|停滞した|不景気な
lactic	乳の
cleanly	きれい好きな|清潔に
unclean	汚れた
molasses	糖液|糖蜜
squeal	キーキー鳴く|キーキーいう|金切り声をあげる|キーッ|車が急停車する音
numbness	しびれ感
murky	暗い|陰気な|曇っている|理解しにくい
acetylcholine	アセチルコリン|神経伝達物質の名称|コリン(choline)の誘導物である
magnetometer	磁力計(地球の磁場の強さを測定する計器)
wop	《禁句》|外人としてのイタリア人|イタリア系外人
forsake	をやめる|捨てる|を放棄する
sliver	細長く裂く|縦に長く切る
tinnitus	耳鳴り
batsman	(クリケットの)打者(batter)
collusion	共謀|なれ合い|野合|通謀詐害(両当事者の間に対立がないのに双方の合意のうえで訴訟を起こすこと)
downer	(俗)鎮静剤|(特に)バルビツール剤|気の滅入るような場面|経験|退屈な人物
burl	節|試してみること|やってみること|トライ
sequestration	隔離|隠蔽|仮差押え|没収
oxidant	酸化体|オキシダント(光化学スモッグの主要原因で過酸化物質の総称)
rigorously	厳密に
erroneously	誤って
especial	特別な|特別の
multipoint	マルチポイントの
placard	プラカード
huckleberry	ハックルベリー|コケモモという低木の青黒い実
reminisce	思い出を語る|追憶する|追憶にふける|の思い出を語る
girth	取巻く|周囲の寸法|腹帯|帯げた|胴差し|胴まわり
restatement	修正再表示
grouper	共同出資で別荘などを借りる若者
argh	なんてこった
planting	植林
purposeful	目的のある|意味深長の
fete	祭|にぎやかな催し|祝典|祝宴|祭日|祝う|celebrate
hydrangea	(pl|hydrangeas)|アジサイ|あじさい|紫陽花
procrastination	優柔不断
gauze	ガーゼ
bronchial	気管支の
perishable	だめになりやすい|腐りやすい|滅びやすい|(複数形で)腐りやすい食品
calorimeter	熱量計
nanoscale	ナノスケール
forceful	力のある|力強い
unilaterally	一方的に
hypoglycemia	低血糖症|血糖減少症
sodomy	男色|獣姦 
populist	人民党員|人民党の
beaker	ゴブレット|ビーカー
conditionally	条件付きで
dulcimer	ダルシマー|小さなハンマー(槌)で打って発振する台形の弦楽器
acyl	アシル基(Acyl group)|有機化学でカルボン酸(カルボキシ基(−COOH)を有する有機酸)からOHを抜いた|R-CO-という形の基を指す
subterranean	地下で働く人|地下の|隠れた
quibble	へりくつを言う|ごまかす|言抜ける
disconnection	切断|分離|断絶;(電気・電話の)断線
truncation	打切り|切断すること
untimely	早すぎる|季節外れの|時ならぬ|折りの悪い
riyal	riyal(rialも使う)|複数の中東諸国の通貨単位|語源はスペインの旧通貨やブラジルの通貨レアルreal|語源はスペイン語|ポルトガル語のreal(王の)|英語のロイヤルroyal
reflexive	再帰動詞(代名詞)|再帰の
idiom	慣用語法|慣用法|熟語|成句|イディオム
legitimately	合法的に
rah	フレー|がんばれ
saggy	たるんだ
unwelcome	歓迎されない|もてない|ありがたくない
puss	(俗)ねこちゃん|女の子|(Puss in Boots|長ぐつをはいた猫|17C末からヨーロッパに伝わる民話)
northbound	北方行きの
confederacy	同盟国|連合
midweek	週の真ん中
rialto	リアルト|劇場街|市場|取引所
fallback	いざという時の頼り|撤退
gamut	全領域|全範囲|全音階
unedited	未編集の
dainty	きゃしゃな|優美な|上品な|繊細な|おいしい
amphibious	水陸両生の
congregate	集まる|集める
marigold	キンセンカ|センジュギク属
eyesight	視力
parson	教区牧師|牧師|聖職者
forgo	を差し控える|～なしで済ませる|do without|をやめる
sojourn	短期間滞在する|(一時的に)滞在(する)
amphitheatre	円形競技場
citywide	市全域の
franchisee	(製造主から)一手販売権を与えられた人
slinky	しなやかな|セクシーな|腰をくねらす|内緒の|コソコソした
precarious	推定的|心許ない|おぼつかない|人頼みの|他人の意志次第の|不安定な|危ない
entanglement	もつれること
arbiter	(運命などの)決定者|(趣味･作法などの)権威者|調停者
postmenopausal	閉経後
topographical	地理的
dreary	荒涼とした|わびしい
declination	傾き|衰退|辞退|赤緯|(物理)磁気偏差
horrid	ひどくいやな|恐ろしい
dryness	乾燥
wreckage	漂着物|残骸|脱落者|難破|破壊|難破船|大破|挫折
arty	芸術家ぶった(気取りの)|芸術品まがいの|こりすぎた
avenge	あだを討つ|復讐する
multifunctional	多機能の
ingest	摂取する
overlord	大君主
transfected	遺伝子導入された|形質移入された
unprepared	準備なしの|準備がされていない|即席の|不意の
compo	=composition5
treacherous	信用を裏切る|信頼できない|当てにならない|(安全そうで)危険な
carnal	肉体の|肉感的な|肉欲的な|現世的な|浮世の
larceny	窃盗罪|盗み
furlong	ハロン(長さの単位=1|8 mi)
polymorphic	多形の
snappy	コントラストの強い|快活な|活発な|しゃれた|パチパチ音がする
bandera	旗
washroom	手洗所
youngster	若者|子供
enigmatic	謎めいた|不可解な|謎の
herbarium	植物標本集|植物標本室
chirp	チッチッと鳴く|チュッチュッ|チーチー|鳥の鳴き声
woodman	木樵|きこり|(=woodsman)
kestrel	チョウゲンボウ(ハヤブサの一種の鳥)
climatology	気候学
accede	同意する|(職など)に就く|加盟する|後を継ぐ
chamomile	=camomile
expel	(害虫を)駆除する|駆逐する|を追い出す|を追放する|を放出する|発射する
supplant	に取って代わる
triangulation	三角測量
methylation	メチル化
frighten	をおびえさせる|ぞっとさせる
prostatic	前立腺の
cabal	(政治的な)秘密結社|陰謀|徒党|同人グループ
rubella	=German measles
constitutive	構成的な
cooperatively	協調的に
inseam	(ズボンのすその折り返し|靴などの)内側の縫い目
jobless	失業中の|失業者の
disgruntle	不機嫌にする|不満を持たせる
watchful	用心深い|用心した
parlay	賭の元金と配当もさらに賭けていく
disintegration	分解|崩壊|分裂|分散
democratization	民主化
cilantro	セリ科の一年草(英語でcoriander)のスペイン語名|スープやサルサなどに広く用いられる
savant	(専門分野)学識豊富な人|学者
gunshot	銃声|砲撃(音)|着弾距離|射程
terracotta	(堅い耐火煉瓦)テラコッタ(製品)|濃い茶色
glob	(液体の)小滴|一滴|(クリームなどの)丸いかたまり
idyllic	田園詩(風)の|牧歌的な|すばらしい|美しい
publicist	国際法学者|宣伝係|政治評論家
contributory	寄与する|貢献して|あずかって|寄付の
wail	不平を言う|嘆き悲しむ|泣き叫ぶ|嘆き悲しみ
medalist	メダリスト|メダル獲得者|メダル製作家
crucifixion	十字架
softener	ソフナー|軟化剤|洗濯用柔軟剤|柔らかくする人|和らげる人|軟化装置
madly	気が狂ったように|狂ったかのように
pyruvate	ピルビン酸塩|ピルビン酸(Pyruvic acid)の誘導体は|抗がん剤として研究されている
logger	木こり|ロガー|丸太を積み込む機械|丸太運搬トラクター|自記計測器|自動記録器|重い|太った|鈍い
whew	ひゃぁ!|ヒャア|ヘエッ
rater	評価者
conformational	立体配座の
impressionism	印象派
thereupon	その後ただちに|その結果|それゆえに
archer	弓の射手
steamer	蒸し器|蒸気機関
subdomain	サブドメイン
alabaster	雪花石膏|白くなめらかな
abnormality	普通でないこと･もの|異常|奇形|(体の)変調|障害
varicose	静脈瘤(りゅう)の|静脈怒張の(特に足の血管が異常にふくれること)
coercive	強制的な
romanticism	ロマン主義|空想的気分
misrepresent	誤り伝える
cautionary	警戒的な
spotter	即座の
outcry	声高な叫び|抗議|怒号
epitaph	墓碑銘|墓誌|碑文
siphon	サイフォン|吸い上げる
unthinkable	全く考えられない
antisocial	社交ぎらいの
sundown	日没
scant	わずかな|乏しい|不十分な|狭い
doorbell	戸口のベル
sorely	痛ましく|痛ましいほど|ひどく
hamstring	骨抜きにする
infuse	注入する|(思想など)を吹き込む|奮い立たせる
glee	喜び|大喜び|(他人の失敗･不幸を見て)ほくそ笑むこと|グリー|三声またはそれ以上の無伴奏声歌曲
ejaculate	急に叫ぶ|射出する|射精する
obtainable	獲得可能な
carcinogenic	発癌性の
reformer	改質装置
epidural	硬膜外麻酔
solemnly	厳粛に|まじめに
brasserie	ビールと食事の店|ビヤホール|醸造所
liberally	気前よく|豊富に|寛大に
exorcist	悪魔払い師
wattage	ワット量
timescale	タイムスケール
concentric	同心の|同軸の
unwarranted	保証されていない
terminally	末端
untouchable	触れてはならない|ヒンズー教のカースト制度の最下層民
kale	ケール|緑葉カンラン|ハゴロモカンラン|(米俗) 金(かね)
monastic	修道院(僧)の|禁欲的な|隠遁的な
permeable	浸透できる
bate	減らす|弱める|取り去る|鈍らせる|激怒する|逃げようとする
napalm	ナパーム弾(Napalm bomb)|主燃焼材のナフサにナパーム剤と呼ばれる増粘剤を添加した油脂焼夷弾|米軍が開発|極高温(900-1|300度)で燃焼し|広範囲を焼尽する
biweekly	隔週の|週2回の
adoration	敬愛|あこがれ|礼拝
amity	親善(関係)|友好|親睦|友交
cusp	イバラ|とがった先|カスプ|心臓弁膜尖|尖頭
shortness	短いこと
vanquish	を征服する|を克服する|勝つ
martingale	むながい(馬の頭を安定する馬具)・（船）第2斜檣(しゃしょう)を固定する支索
seashell	貝|貝殻
insurrection	暴動|反乱
abomination	嫌悪|憎悪
predominate	一世を風びする|支配する|優勢である|卓越する
dolomite	ドロマイト|苦灰石(くかいせき)|炭酸塩鉱物の一種|別称白雲石
paraphernalia	妻の所有品|道具一式
heretofore	これまで|以前は
skimpy	乏しい
aldehyde	アルデヒド|カルボニル炭素に水素原子が一つ置換した構造を持つ有機化合物|一般式はR-CHOで表される
speedup	速力増加|生産能率の促進
scapegoat	身代り
masterful	横柄な|巧妙な
defrost	解凍する
insoluble	水に不溶性・難溶性の|問題が解けない
sepsis	敗血症
yearn	あこがれる|恋しく思う|切望する|同情する
postnatal	生後
repressive	鎮圧の|抑圧的な
ballpoint	ボールペン
headgear	ヘッドギアー|かぶりもの
ducky	かわいい|すてきな|素晴らしい
cleaver	包丁|肉切り包丁
willfully	故意に
divisor	除数
podiatry	足病学(足の病気の研究)
truffle	トリュフ|フランスしょうろの類の植物
meteorologist	気象学者
stupendous	途方もない|巨大な|並外れた
acumen	鋭さ|眼識|明敏|鋭い洞察力
hallo	もしもし|ハロー(Hello)
abo	《オーストラリア英語》《俗・禁句》原住民(aborigine)
skylark	ヒバリ|ばか騒ぎする
gauche	いたらない|未熟な|気のきかない|不器用な|洗練されない|無骨な|粗雑な
prowl	うろつく
chlorinate	(特に殺菌のために)〜'を'塩素で処理する
upbringing	養育|育て方|躾(しつけ)
widower	男やもめ
zonal	帯の;地域(地区)に分けられた
unsustainable	支持できない
interdependent	互いに依存する
maw	胃(stomach)|(鳥の)そ嚢
civics	公民学|公民科;市政学|市政論
unanticipated	予期せぬ
nuance	(仏語)ニュアンス(微妙な差違|陰影|色合い)
rowdy	騒々しい|乱暴な
pretrial	公判前手続き
bodega	ワイン貯蔵室(庫)|ワインショップ|バー|(スペイン語系米人の)食料雑貨店
toffee	キャンディー|キャラメル cf|lollipop
rotator	回旋筋|回転するもの|回転装置|回転炉|交代するもの|交代する人|自転する惑星|ターンテーブル
classmate	級友
octagon	八角形
driftwood	流木|漂流木
thermos	(もと商標)魔法瓶|サーモス
anaesthetic	麻酔の|general anaesthetic全身麻痺|local anaesthetic局部麻酔
mythological	神話の
puller	引くもの|プーラー
horseman	騎手|乗馬者|馬術家
nervously	いらいらと|神経質に
amphitheater	円形競技場|階段教室
hypertensive	高血圧の
chaparral	(低木や灌木の)茂み|密集
gryphon	=griffin
tadpole	オタマジャクシ
prise	=prize
fennel	ウイキョウ(小さな黄色の花が咲き|葉と種は香料に用いる)
solidly	堅固に|満場一致して|連続して
bathrobe	バスローブ
bonny	かわいい|健康そうな
fallow	休閑(地)|作付けしてない|休閑中の|未開墾の|(土地)を休ませる|休閑地|耕したがまだ作付していない土地
wilt	(草花)しぼむ|しぼませる|弱らせる|衰えさせる|しおれる|しょげる|しょげさせる|立ち枯れ病
tabby	とら猫
bicarbonate	重炭酸塩
fixing	器具|固定
kickboxing	キックボクシング
wasteful	むだづかいの多い|浪費的した|浪費的な|荒廃をもたらす|破滅的な
oligonucleotide	オリゴヌクレオチドは20塩基対かそれ以下の短いヌクレオチド(DNAまたはRNA)の配列
substandard	低水準の|標準以下の
baboon	ヒヒ|ひひ
inaudible	聞き取れない
frantically	狂ったように
pippin	素晴らしい人･もの|美人|生食用リンゴの一種|種子
epidemiologic	疫学的な
dragoon	竜騎兵(重装備をした昔の騎兵)|〈人〉‘に'むりやり(〜)させる《+『名』〈人〉+『into』 do『ing』》
wombat	ウォンバット|カンガルー目ウォンバット科の哺乳類|アボリジニ(オーストラリアの原住民)の言葉で「平たい鼻」の意
theologian	神学者
individualism	個人主義
starboard	右舷(の)|((反)port|左舷)
burdensome	やっかいな
signing	ディスプレー|看板|信号|信号系
renown	有名|名声|声望
tacky	みすぼらしい|粘る|安っぽい
truthfully	本当は|正直に|正直に言えば|誠実に|本当のところは
spud	小さい鋤(すき)
hematopoietic	造血薬|抗貧血薬|造血性
inflationary	インフレの
nanometer	ナノメートル
beggar	物もらい|乞食こじき|悪漢
reassess	を再評価する|再び割り当てる
pard	仲間|相棒(partner)
quantitatively	適量で
abundantly	豊富に
currant	小粒の干し葡萄|(種なし)干しブドウ|スグリ
checkup	検査|監査|照合|点検
peepshow	ピープショー(のぞき穴を通して見せる見せ物)
doer	実行者|実行家
divest	(服)を脱がせる|奪う
mucous	粘液を分泌する|粘液を含む|粘液質の|粘膜
cumulus	積雲
cakewalk	ステップダンスの一種|(ケーキを賞品とするアメリカ黒人の)歩きぶり競技|朝飯前
subculture	継代培養
artiste	芸能人|名人
inoculation	予防注射|予防接種|(ワクチン接種はvaccinationともいう)
tantrum	かんしゃく|むかっ腹を立てる
glycemic	血糖
temperance	節制|節度|自制|禁酒|克己
operable	実施可能の
lodger	下宿人|間借り人
earthy	土の|土壌性の|土のような|世俗的な|現実的な|粗野な|素朴な|気取らない
balsam	ホウセンカ(Touch me notの別名)|バルサム|芳香樹脂|鎮痛剤
aggrieve	〈人〉'を'不当に苦しめる|しいたげる|(法律用語で)〈人〉‘の'権利(名誉)を侵害する
actuality	現実|実在
photojournalism	グラフ雑誌[編集];報道写真関係の仕事
goof	まぬけ|(俗)とんま(な人)|へま
headmaster	校長
alveolar	(ælvíːəlɚ)|歯槽(しそう)の|alveolar consonants(歯茎音t|n|l|sなど|舌先を上歯茎に近づけて発音する子音)
accomplice	共犯者
anecdote	逸話|逸事|秘史|秘話
resistive	抵抗する|抵抗力のある|抵抗性の
snob	紳士気取りの俗物|俗物|スノッブ
strikingly	際立って|著しく|目立って
copycat	模倣者|もの真似をする人|人まねをする子供|何から何まで人まねをするやつ
firepower	火力
unmodified	変更されていない
orchestration	管弦楽|管弦楽組曲|編成|組織化|統合
slugger	強打者|拳闘選手
rancher	牧場経営者;牧場労働者;カウボーイ
conceit	自負心|うぬぼれ|想像する
knead	こねる|もむ|(練り粉)を練る
jackal	ジャッカル|お先棒|下働き
cornet	コルネット(管楽器の一種)|《英》(アイスクリームの)コーン
rangefinder	(大砲などの)距離測定器;(カメラの)距離計
panache	見事なやり方|手ぎわ|貫禄(かんろく)
hallelujah	ハレルヤ|主をたたえる歌･叫び|alleluia
morn	朝|明日
gubernatorial	知事の|地方長官の|行政の
cutlass	短剣(昔船乗りが武器にした)|カトラス
sparky	スパーキー (エネルギッシュな，生き生きとした)
rescind	(法律･決定･契約など)を無効にする|撤回する
adverb	副詞
polymeric	重合体の
salivary	唾液の
balk	妨げる|驚いて飛びのく|ためらう|しりごみする|失策|(=obstruct|resist)|(野球)ボーク(投球動作を中断する反則)
circadian	(sɚkéɪdiən)(生理)24時間周期の|日周性の
siesta	(スペイン･南米などで日中の暑い盛りにとる)昼寝|シエスタ
satirical	風刺の
phenotypic	表現型の
pelagic	遠洋の|外洋に住む(で行う)
agronomy	作物学|農学(土壌管理と作物生産に関する科学)
bodice	女性用胴着
amenable	素直な|従順な|従う義務のある|影響をうけやすい
indexer	索引作成者
egret	シラサギ(の羽毛)|羽飾り|冠毛
sass	生意気|に生意気な口を利く|口答えする
pus	膿(うみ)
phonological	音韻論の|音韻体系の|音韻的な
hinterland	後背地|奥地|田舎
hypocritical	偽善的な
courtship	(女性への)求愛|求婚
irritate	をいらだたせる|を怒らせる|を刺激する
tolerable	我慢できる|耐えられる|かなり良い|相当の|悪くはない|かなりの
spelling	字を綴ること|綴り|つづり|語の綴り方
desolation	荒らすこと|荒廃|荒涼とした場所|荒地|廃墟|荒涼|荒すこと
chrysanthemum	キク|菊
perversion	こじつけ|悪用|転倒
sneeze	くしゃみ(をする)|ばかにする
expeditionary	遠征の|探検の
humanistic	人道主義者|人道主義の
travelogue	旅行談|紀行映画
hindrance	妨害|障害|邪魔|妨げ
cinch	(俗)確かなこと|朝飯前のこと|確実なこと|やさしいこと
merci	（フランス語）ありがとう
handicapper	(競馬の)予想屋
demented	発狂した|痴呆になった
upkeep	維持費
clump	群がらせる|かたまり|木立ち
biliary	胆管|胆汁|胆管の
universalist	普遍主義者|《Universalist》ユニバーサリスト(万人救済説(Universalism)を信じるキリスト教の一派の信者)
swath	ひと刈り分の牧草(麦など)|ひと刈りの幅
jaundice	黄疸(おうだん)|ひがみ|偏見
implicate	(人を犯罪などに)関係があるとする|巻き込む|もつれさせる
japonica	日本産植物(ツバキ|ボケなど)|日本の文化資料
megabyte	メガバイト
toothpick	つまようじ
walrus	セイウチ
oust	追放する|立ち退かせる|(場所･地位などから)追い出す
periodicity	周期性
greenery	青葉
proverbial	ことわざの|有名な
timesheet	timecard
histological	組織学的な
tranquillity	平静|安寧
psychotherapist	精神分析医
etcetera	がらくた|雑品|種々のもの
mouser	(ネズミを捕る)ネコ|ネズミをとる動物
conjugation	共役|(動詞の)活用
impediment	妨害|障害|故障|身体障害|言語障害
rattlesnake	ガラガラヘビ
exclaim	叫ぶ|大声で言う
desperado	無法者|命知らず
perilous	危険の多い|危険な
stipulate	規定する|を明記する|を保証する|契約する
preoperative	術前の|手術前の
nether	下の|地下の
wheelbase	(車の)ホイールベイス|軸距(前後の車軸間の距離)
quartile	(統計)四分位数(母集団を昇順に並べた4分の1|3にあたる数値)|四分の数値
preoccupation	先入観|先取|気を取られていること|夢中|偏見|先入主
geodetic	測地学の;測地線の
commonality	共通性
consensual	(契約など)合意の上の
turnip	カブ(植物)
idiotic	馬鹿な|ばかげた
ascorbic	ascorbic acidアスコルビン酸|ビタミンC として働く有機化合物の一種|食品添加物の酸化防止剤として広く使用される
covalent	共有結合性の
tarpon	Atlantic tarponターポン|カライワシ目イセゴイ科の魚|体長は250cmを記録|太古よりほとんど形状を変えず現代まで生き延びてきた古代魚
herewith	これとともに|同封して|この機会に|これによって
orthologous	オーソロガス(種分岐相同性の)　参：パラロガス(paralogous|遺伝子重複相同性の)
grist	製粉用の穀物
decry	非難する
subside	静まる|沈む
fizz	しゅーという音|フィズ
pronoun	代名詞
colloid	コロイド|極微細な粒子が液体･気体･固体などの媒体中に分散している状態(colloidal dispersion)|分散している粒子を分散質|媒体を分散媒という|膠質ともいう
ukulele	ウクレレ
plankton	プランクトン
watercourse	水流|川|小川|運河
steely	はがねの|頑固な
airframe	(航空機・ロケットの)機体
nourishment	栄養状態|滋養物|食物|助成|育成
gravitation	引力|引力作用|ひきよせられること
antiwar	反戦の
whaler	浮浪者|並外れたもの|メジロザメ|捕鯨船|捕鯨船員
menopausal	閉経期
retrograde	後もどりの|後退する|退化する
shadowy	影のある|陰になっている|はっきりしない|非現実的な
reproducibility	再現性
abalone	アワビ
primordial	原始の|原生の|根本的な|根本(原理)
yip	キャンキャン吠える|大きな声で不満を言う
divan	背のない低いソファー|寝いす|ソファーベッド
gob	汚い塊|(ねばねばした)かたまり
lumberjack	木こり|木材伐採人夫|材木切出し人
sully	(名声|功績など)に傷をつける|泥を塗る
gingham	ギンガム(棒じまなどの綿布)
lampoon	激しく風刺する|風刺文
gossamer	(gάsəmɚ)くもの巣|流れ糸(空中や茂みの小グモの糸)|薄物(紗など)|はかない物|the gossamer of youth's dreams青春の儚い夢
gurney	台車付き担架
consumerism	消費者優先主義
crankshaft	クランク軸(側方に突き出たクランクの回転軸)
boneless	骨のない
impurity	汚れ|不潔|不純物
intracranial	頭蓋内の
tupperware	タッパーウェア
mumps	流行性耳下腺炎|おたふく風邪|おたふくかぜ
subjectivity	主観(性)|主観的なこと
haggis	ハギス(羊や子牛の内臓･脂･オートミール･玉葱のミンチを家畜の胃袋に詰めてボイルするスコットランドのプリン)
mycoplasma	マイコプラズマ
fpm	feet per minute
greenish	緑がかった
hermaphrodite	雌雄同体(動植物)|両性動物|両性花|男女両性者
selfishness	身勝手さ
adenoma	アデノーマ|腺腫
mote	ほこり|微片
reassessment	再評価
earnestly	まじめに
carbine	カービン銃|騎銃|騎兵銃
frolic	浮かれ騒ぎ|陽気に騒ぐ|陽気|ふざけ戯れること|大浮かれ|歓楽|浮かれ騒ぎの宴会|陽気な集まり
monologue	独白劇|独白(の場面)|(会議などでの)一人の長広舌
apparition	幽霊|幻影|出現|見えてくること|思いがけなく現われる人
rotisserie	(仏)焼肉料理店|回転式くし焼き器
communique	(仏語)公式声明|公式発表
acutely	鋭く|鋭敏に|激しく
organist	オルガン奏者
warfarin	ワルファリン(無色の有毒な粉末でねずみ取りの薬剤)
allegory	寓意|物語|寓意物語|風喩|象徴
deluge	氾濫させる|大洪水|氾濫|豪雨|土砂降り
fleshy	肥満の
fib	罪のないうそ(をつく)|めった打ち
desirability	好ましさ|望ましさ
bodybuilder	ボディビルダー
poss	poss|(略語) possession|possessive|possible|possibly 2|洗濯棒で洗う
ravel	〈編み物・ロープなど〉‘を'解く|ほどく(unravel)《+『out』+『名』|+『名』+『out』》|〜‘を'もつれさせる|からませる;〜‘を'混乱させる|解ける|ほどける|(編み物などから)ほどけた糸の端;ほどけた部分
canvass	遊説|(投票などを)依頼する|勧誘して回る
persistently	しつこく|永続的に
meander	(miˈændɚ)|蛇行(する)|あてどなく歩く|曲りくねった道|曲がりくねって流れる
rusk	ラスク(ビスケットの一種)
bola	2個以上の鉄玉付きの投げなわ;(おもに南米南部で|獣の脚に投げつけ|からませて捕える道具)
rhododendron	シャクナゲ|ツツジ
horrendous	恐ろしい|ものすごい
eyeglass	めがねのレンズ
cyberpunk	サイバーパンク|サイバーパンク作家
waterside	水辺
nucleon	核子(かくし|陽子および中性子をいう)
antifungal	抗真菌剤
grime	不潔
extortion	無理強い|強奪|揺すり|強要|ゆすり
scrooge	守銭奴
colorless	生気のない|青ざめた
idealistic	理想主義者|理想家|理想主義的な|観念論的な
earphone	イヤホーン
illiteracy	無知|文盲|無学|無筆
juggle	ジャグリング|やりくりする
sublimation	昇華(ドライアイスのように|固体から液体を経ず直接気体に変わること)|純化|理想化
preponderance	優越|優勢|勝ること
cowardly	臆病な
pretentious	うぬぼれた|気取った|もったいぶった|偽りの
agitator	扇動者|かきまぜ機
gusto	おいしさ|趣味|好み|嗜好|喜び|あふれる活気
adenovirus	アデノウイルス|二重鎖DNAウイルス|ライノウイルス等とともに「風邪症候群」を起こす主要病原ウイルス
pullout	移動|撤退|折り込み(ページ)
headway	前進|進歩
humbly	恐れ入って|謙遜して|卑しく
gastronomy	美食(法)|料理法
langue	言語(抽象的言語体系)
outcrop	露出
stoker	火夫|機関員|機関助士|(自動)給炭機
unworthy	価値がない|価値のない|取るに足らない|に値しない
bacteriophage	バクテリオファージ|(細菌を食べるの意)|細菌に寄生して増殖し|菌体を溶かす一群のウイルス|細菌ウイルス
expectant	期待した|期待者
middleman	仲買人
miter	留め継ぎ(2つの材木のつなぎ方)
joinery	建具職|《集合的に》建具類
maggot	ウジ|風変わりな考え
fruition	達成|結実|実現|成果
metabolite	代謝産物
boll	(bóʊl)|(綿・亜麻の種子の入った)丸い莢(さや)
honk	(警笛)を鳴らす|ガンが鳴く|(警笛)が鳴る
correspondingly	それに対応して
principled	原則に基づいた
herder	家畜の番人|牧夫|家畜の飼い主
trusty	信頼できる人|信頼できた|信頼できる|当てになる
subtropical	亜熱帯の
gratuitous	理由のない|根拠のない|よけいな|無料の|無報酬の|好意からの|篤志の
fatally	致命的に|運命的に
ephemeral	一日の命の|一日限りの|短命な|束の間の|はかない
radium	ラジウム(放射性元素)|元素記号Ra
dissimilar	異なる|似ていない
bijou	宝石|小さくかわいらしい物(場所)
centrist	中間政党の(党員)|中道主義者
algal	藻類の
cognizant	認識している|認識力のある
skewer	くしに刺す|くし
bravely	勇敢に
ethically	倫理的に
clematis	クレマチス|昔から人気があり|traveler's joy や old man's beard|virgin's bower などの愛称がある|テッセンはクレマチスの一品種
loathe	ひどく嫌う
leger	ledger|原簿|元帳|台帳|宿帳
torus	トーラス(pl|tori)|ドーナツ型|輪環(面|体)ともいう|(adj|toroidalドーナツ型の)
shortstop	(野球)ショート|(守備のポジション)
incomprehensible	理解できない
demeanor	ふるまい|行ない|態度|物腰|様子|表情
sneer	(人･物･事を)あざ笑う|軽蔑|冷笑する|軽蔑する|を嘲って言う|冷笑
derailleur	(自転車の)変速装置
shipboard	舷側|船側|船上での
larkspur	=delphinium
paganism	異教信仰
retest	再試験|再試験する
pancreatitis	すい炎
immunohistochemistry	免疫組織化学
filigree	(金･銀)線条細工|金属のすかし細工(を施した)
postponement	延期
stench	悪臭
wickedness	邪悪|不正|悪意
simian	類人猿(の)|サル(のような)
trigonometry	三角法
objector	異議を唱える人|反対者
campanile	(特に教会の本堂から離れて建てられた)鐘楼
closeness	密接
celiac	腹[腔]の|腸にある
hypothyroidism	甲状腺機能不全
barbershop	床屋|理髪店|男声の|密集和声の
hyacinth	ヒヤシンス|スミレ色
scriptural	聖書の教義に基づく
behemoth	《しばしば『B-』》旧約聖書「ヨブ記」の中のカバと思われる巨獣|(一般に)巨大でグロテスクな人(動物)
cybernetics	人工頭脳学
discontinuation	中止
shopkeeper	店主
wanton	いたずらっ子|理不尽な|みだらな|抑制できない|浮気女
antiseptic	殺菌の|防腐剤
bookmaker	賭屋|編集屋|のみ屋|胴元(賭けの)
alibi	現場不在証明|アリバイ
notional	概念の
marauder	略奪(襲撃)する
gander	ガチョウ･ガンの雄|ちらっと見ること
bastille	牢獄|小さい砦|防御塔
exterminate	絶滅する
sizzle	ジュージューという音(をたてる)
traceable	跡をたどれる|起源を発する|帰せられる
patina	緑青|青さび
buttercup	キンポウゲ(春に美しい花をつける植物)
reversion	逆転|復帰|隔世遺伝|復帰財産|相続権
aspartate	アスパラギン酸塩
tsar	旧ロシア皇帝の称|皇帝(= czar)
darkly	暗く|陰気に|険悪に|暗中に|ぼんやりと|神秘的に|ひそかに|そっと
faithfulness	忠実|誠実|貞節|信心深さ
clergyman	聖職者|牧師
resourceful	機知に富んだ
pleural	胸膜の
heraldry	〈U〉紋章学|〈C〉紋章
incomparable	比類のない
sidewinder	サイドワインダー(蛇の一種の名)
finisher	フィニッシャー|決着をつける人
mademoiselle	(仏語)(呼びかけ)～嬢|令嬢|マドモアゼル|未婚女性の呼称(英語=miss)
sunspot	太陽黒点|《英話》避寒地
constitutionality	合憲性
macroscopic	巨視的
viscount	子爵
geopolitical	地政学的
decibel	デシベル
chipmunk	シマリス(北米産でsquirrelより小さい)
weevil	ゾウムシ
adamant	非常に堅い|頑固な|鋼石の|意志の固い|アダマント(伝説上の絶対に砕けない物質のこと)
helicobacter	ヘリコバクター･ピロリ(Helicobacter pylori)菌|胃内のらせん型のグラム陰性菌|ヘリコは旋回|バクターはバクテリア(細菌)|ピロリは胃の出口(幽門)の「ピロルス｣に由来
numeral	卒業年度の数字|数字|数詞|数の
orthodontics	歯科矯正(学)
vernal	春の|春に起こる|青春の|生き生きとした
myeloid	骨髄
disorderly	混乱した
antipsychotic	抗精神病薬
fanfic	二次創作
bicentennial	200年続いた|200年祭
mineralogy	鉱物学
harrier	ハリヤー犬(ウサギ狩りに用いる)|クロスカントリーレースの走者
sentient	敏感な|感覚(知覚)力のある|意識する|に気付いている
nameplate	ネームプレート|紙名|種|品|名札|銘板
bidet	(仏語)子馬|婦人用洗浄器|ヴィデ
blatantly	露骨に
fleer	(〜を)嘲笑する|あざ笑う|ばかにする《+『at』+『名』》
caveman	洞窟人|穴居人
gunfire	砲火
veritable	ほんとうの|真の|本物の
moll	情婦|売春婦
subtilis	枯草菌(こそうきん)|自然界に普遍的に存在する真正細菌の一種|学名Bacillus subtilis(バチルス・サブティリス)