nonattainment	未達成
slapstick	どたばたの|どたばた喜劇
arabesque	アラベスク|モスクの壁面のイスラム美術の一様式|幾何学文様を反復し|人物の描写を禁じるスンニ派の世界観に基づく|(シーア派はムハンマド以外は認められている)
hyperbole	(文法)誇張法|誇張
belligerent	好戦的な|けんか腰の|けんか好きの|交戦中の|交戦国
intergalactic	銀河系（宇宙）間の
phosphorous	リンの|(特に)3価のリンを含む
sterility	不作
amiable	人当たりのよい|愛想のよい|気だてのよい|素直な
sitting	座(ってい)ること
cistern	貯水槽|水槽|地下貯水タンク|溜池
payphone	公衆電話(特に硬貨を入れて作動する)
duodenal	十二指腸の
irrevocably	取消し(変更)できぬほどに
coworker	同僚
longterm	長期
unrelenting	厳しい|仮借ない|(速度･努力など)弱まることのない|たゆみない
antiquate	(新しいものがとって代り)〜'を'古くさくする|時代遅れにする
femininity	女であること
opulent	富んだ
humbug	ぺてん師
dimly	かすかに|ぼんやり|ぼんやりと|薄暗く
absolve	免除する|解除する|に無罪を申し渡す
rya	リャー(スエーデンのぶ厚いパイルでできた手織りじゅうたん)
nothingness	無|空|無意義・無価値
antagonistic	拮抗的|対立する
dislodge	取外す|取り除く
outlier	異常値
fervor	熱烈|白熱|情熱
exotica	異国趣味の文学作品|異国風のもの|奇習
innervation	神経刺激伝達|神経支配
prolapse	(腸・子宮などの)脱出|下垂
acquittal	無罪放免|無罪判決
cursory	(仕事など)急ぎの|通り一遍の|不十分の
watertight	水の漏らない|防水の|(議論などが)水も漏らさない|完ぺきな
photocopier	写真複写機
talc	タルク|滑石
pessimism	悲観(主義･論)|厭世(主義･論)
vehemently	激しく|熱列に|熱烈に
checkmate	王手詰み|(計画･事業などの)行き詰まり|敗北
velvety	ベルベットのような|ビロードのような|滑らかで柔らかい|舌ざわりの柔らかな
mononuclear	単核の
legitimize	合法化する|適法とする
nobleman	貴族|華族
ternary	三つから成る|第3位の|(数学)3進の
footballer	フットボール選手
foolproof	しくじりようのない|簡単な|絶対安全な
overshadow	に影を投げかける|を曇らせる|暗くする
foolishly	ばからしくも|愚かにも
immunosuppressive	免疫抑制性の
boathouse	艇庫;ボート小屋
chaff	もみがら|つまらないもの|ひやかす
inanimate	生命のない|無生命の|意識のない|活気のない
recline	もたせかける|もたれる|寄り掛かる|横になる
defensively	防御的に
romaine	ロマイン|平織りの薄い織物|ロメインレタス(野菜)
canker	〈U〉(特に口中の)潰瘍(かいよう)|〈U〉(樹木の)がん腫病|〈C〉(人・社会に)害毒になるもの|病根|幣害|〈樹木が〉がん腫病になる
submariner	潜水艦乗組員|アンダースロー|下手投げの投手
lunacy	精神異常|狂気
dimensionality	次元
squabble	口論|口げんか|小競合い|言い合う|つまらないけんかをする
cyclotron	サイクロトロン(原子核破壊装置)
enchant	に魔法をかける|を魅了する|うっとりさせる
defame	(人など)を中傷する|の名誉を毀損する|侮辱する
notoriety	悪名|悪評|悪名高い人
azt	(医)azidothymidineアジドチミジン(抗エイズ薬)
hydroxyl	水酸基
plantain	オオバコ|バナナの一種(料理用)
preceptor	教師
numismatic	貨幣(古銭)の研究(収集)の
avoidable	回避できる|回避可能な|さけられる
truancy	無断欠席|無断欠勤|skip school
midlife	中年
unavailability	利用できないこと
woollen	=woolen
pantomime	無言劇|パントマイム
onetime	ワンタイム
omnipotent	全能全知の|全能の
poise	安定|平衡|落ち着き|の平衡を保つ|身構える|浮く
judgmental	判断の
unsteady	不安定な|しっかりしていない|不規則な
marimba	マリンバ
carrion	腐肉(の)|腐敗|きたないもの
summarily	かいつまんで
playbill	芝居のビラ|芝居のプログラム
etude	(音楽の)練習曲|エチュード;(絵の)習作
plantar	足の裏
excitedly	ワクワクして|興奮して
approachable	近づきやすい
sweetener	甘味料
gaunt	やせた|気味の悪い|ひょろ長い|ものすごい|寂しい
burk	とんま|うすのろ|嫌な奴
lifesaver	命の恩人
cornstarch	コーンスターチ(cornとうもろこし|starchでんぷん)
buzzword	決まり文句|宣伝文句|キャッチフレーズ|(商売上･仲間内などの)専門語
predominately	主に
metalware	《集合的に》金属製品(容器|用具)
pomp	壮観|豪華|華麗|誇示|虚飾
pretzel	プレッツェル|塩味のビスケット|フレンチホルン|ドイツ人
businesswoman	女実業家
dinette	(家の中の)小食堂
neutrophil	好中球は5種ある白血球の1種|盛んな遊走運動(アメーバ運動)を行い|侵入してきた細菌や真菌類の異物を貪食し|殺菌を行う|骨髄で作られる
segmental	断片の
cetacean	クジラ類|クジラ目の
vestibular	前庭の
honeybee	ミツバチ
brownish	褐色がかった
wnt	ウィント|ショウジョウバエの胚発生とガンに関連するタンパク質
testicle	精巣|コウ丸|睾丸
wallop	をひどく打つ|に大勝する|沸きたつ|強打|パンチ力
tipper	ティッパー(重ダンプトラック)|人名|チップを上げる人
methinks	《古》(〜と)私には思われる
suave	まろやかな|温厚な|丁寧な
riddance	脱出|免れること|追い出すこと|除くこと
greave	すねあて
tumbleweed	秋になると風で地上部が飛ばされる雑草
detest	嫌悪する|ひどく嫌う
tulle	(仏語)チュール|薄い網状の布
gabby	ひどくおしゃべりの|おしゃべり好きな
helplessness	どうすることもできないこと|無力
cockatoo	ボタンインコ|見張り役
circumstantial	付随的な
concoction	スープ|調合|でっち上げ|作り話
backtrack	同じ道を引き返す
adiabatic	(物質が)断熱の(熱を導かないことをいう)
naturalism	写実主義|自然主義
glazier	ガラス屋
lyre	リラ(古代ギリシアのたて琴;歌などの伴奏用)
indestructible	破壊できない
exportation	〈U〉輸出|〈C〉輸出品
allusion	ほのめかし|間接的な言及
bosh	《おもに英俗》ばかげたこと|たわごと|ばかな|くだらない
condense	要約する|集光する|濃縮する|液化させる|凝結させる
interchangeably	同じ意味
backhand	バックハンド
nonspecific	非特異
chickadee	アメリカコガラ(北米産シジュウカラ属の小鳥)
stingy	けちな|乏しい
zealot	(通例けなして)熱狂する人|狂信者|熱狂者
succinctly	簡潔に
gooey	ねばねばした|べたつく|くっつく
rapier	(決闘|フェンシング用の)細身の両刃の刀|レピアー|細身の剣
turmeric	ウコン|ターメリック(染料･調味料)
carnelian	紅玉髄|赤めのう(=cornelian)
vigour	力|活力|元気|活気|迫力|勢い|(植物などの)生長力
crinkle	しわ|しわが寄る|縮れる
parietal	壁の|体(腔)壁の|頭頂(部)の|頭頂眼|頭頂骨|大学構内の居住に関する|異性訪問者に対する寮の規則
underpants	パンツ
illegible	読みにくい|判読しがたい
snot	鼻水
ductile	(金属などが)線状に引き伸ばせる|(粘土が)どんな形にもなる|《文》(人の性質・行動が)御しやすい|従順な
casework	ケースワーク(社会福祉上|身障者・困窮者の調査・保護)
afferent	(医|神経が)求心性の(末梢から中枢に向かう|輸入|導入|求心性|(反)efferent
bridegroom	花婿|新郎
antihypertensive	降圧剤
showplace	名所|有名な所
reshuffle	(トランプの札を)切り直す|(内閣などの)入れ替え|改造|人事刷新
predispose	に受けやすくする|前もって処置する|感染しやすくする
centrality	求心性|重要な地位|中心たること|中心であること|中心性
admirably	りっぱに
nightfall	たそがれ|日暮れ|夕方
sourdough	〈U〉《米西部・カナダ》パン種(パンを焼くときイースト菌の代りに用いる発酵した生パン)|〈C〉(カナダ北部・アラスカの)探鉱者|開拓者
stairwell	階段吹き抜け(階段を入れ(てあ)る井戸状の空間)
poof	ホモ|男の同性愛者|なよなよした男|女々しい男|パッ|フッ|プーッ|キスする
xenophobia	外国人(人)嫌い|外国(人)恐怖症|排外主義
guardrail	手すり|ガードレール
snook	親指を鼻先に当て他の4本の指を広げて動かしたりする軽べつ(不信など)のしぐさ
krypton	クリプトン(無色不活性気体状元素)(希ガス元素)
nary	少しも(一つも)～ない
hydroxylase	水酸化酵素
bombard	質問攻めにする|爆撃する|砲撃する|攻撃する|浴びせる
deport	国外追放する|追放する|運ぶ|処する|ふるまう
ricotta	(ｲﾀﾘｱ語)リコッタ|cottage cheeseに似たイタリアの非熟成ホエーチーズ(ホエイ|wheyウェイ|乳清|乳漿|乳から乳脂肪分やカゼインなどを除いた溶液)
trickster	ごまかす人|手品師|ペテン師|娼婦
irreparable	回復できない|取り返しのつかない|不治の
superstitious	迷信的な|迷信の
callus	たこ|魚の目|皮膚硬結
farina	穀粉|粉末|花粉
markka	マルッカー(フィンランドの貨幣単位)
baseboard	(壁の最下部の)幅|裾|(一般に)土台となる板(プレートなど)
bandy	投げ合う
likable	好ましい
outpouring	ほとばしり|流出|流露
whirling	グルグル回ること
doghouse	犬小屋
standup	立つ|立ち上がる
playgirl	遊び好きな若い女性|プレーガール
flexion	曲がること|屈曲(部)|湾曲(部)|屈曲作用|語尾変化
ibex	アイベックス|ノヤギ
geomagnetic	地磁気の
droppings	(動物･鳥の)糞|(蝋涙など)滴り落ちる(た)もの
celebrant	(執行)司祭|執行者|式典の参加者|祝賀者
designator	指定者|指定する語
causative	原因となる
beeper	ポケットベル|ポケベル(和製英語)
uncontested	無競争
clank	かちゃんと鳴る|がちゃがちゃ鳴る|ガチャーン|剣がぶつかる音
mutable	変わりやすい
militarily	軍事的に|軍事的立場から
sputnik	(またはS-)スプートニク(ソ連製人工衛星)
sty	ものもらい|豚小屋
doughnut	ドーナツ(米|donut)
cribbage	クリベッジ|2-4人で行い各競技者が捨てた2枚の札を親が自分の持ち札にできる
reportage	報道(技術)|報道記事|ルポルタージュ
rondo	旋回曲|ロンド
peppercorn	(干した)コショウの実|つまらないもの
wring	絞り出す|曲解する|力ずくで得る|絞る|絞ること|苦労して得る
barfly	酒場の常連
vegetarianism	菜食主義
chapelle	シャペル(礼拝堂)
flexibly	素直に|曲げやすく|御しやすく|弾力的に|融通よく
radiometer	ラジオメーター|放射計
logotype	商標|会社の意匠
cacao	カカオ
soggy	ずぶぬれの|水浸しの|無気力な
stoic	無関心な人|禁欲的な
substructure	(建造物の)基礎|土台
thatch	わら|屋根をわら(草)でふく
shyness	内気|はにかみ|臆病
angelus	お告げの祈り
ampersand	(ˈæmpɚs`ænd)アンパサンド(&の記号)
unsightly	見苦しい|醜い
linoleum	リノリウム(床材)
criminality	犯罪行為
bide	とどまる|住む|待つ|こらえる|我慢する
overcoat	オーバーコート
spunky	活気のある|勇敢な|魅力的な|美人の|セクシーな
razz	酷評|舌と両唇で出す音|非難|嘲笑|あざける|あざ笑う|からかう|いじめる|冷やかす
shrapnel	爆弾の金属片|榴散弾
deuterium	重水素(化学記号は『D』)
totalitarianism	全体主義|国家統制主義
trigonometric	三角法の|三角法による
nutter	気違い|狂人|変わり者|木の実を拾う人
verbosity	くどいこと|冗漫|冗長
larder	〈C〉肉貯蔵室|食料品室(pantry)|〈U〉貯蔵食料
jumpsuit	ジャンプスーツ
purl	〈小川などが〉さらさらと流れる|さらさらと流れる音
muay	Muay Thai|ムエタイ|(Thai boxing)
nonstandard	規格外の
atrocious	残虐な|極悪な|たちの悪い|ひどい|不愉快な
protectorate	保護国|保護領|(大国と小国の)保護関係
mallow	アオイ科の植物|(特に)ゼニアオイ
consecration	〈D〉神聖にすること;神にささげること|奉献|〈U〉(ローマカトリック教会でミサ聖祭中の)聖変化|〈C〉聖職への就忍式|〈U〉(一般に)奉仕|献身
disaggregated	細分化
forbearance	辛抱|自制
carbonyl	(化学)カルボニル基|木材保存剤等に利用される
golly	(驚き･困惑などを表して)おや|まあ
flay	剥ぐ|こきおろす
ligature	縛ること|ひも|帯|リガチャー
sloop	(1本マストの)スループ型帆船|スループ型砲艦
posy	花束
wobbly	不安定な|ぐらぐらする
outrun	～より遠く(速く)走る|追い越す|を上回る
agave	リュウゼツラン
symbolically	象徴的に
unsubstantiated	証拠立てられない|確証のない
overrule	を却下する
voluminous	著書の多い|多作の|巻数が多い|かさばる
barrette	後ろ髪を留めるピン
zing	ヒューという音(をたてる)|気力|熱意|活気(づける)
cholinergic	コリン作用性の
abbe	神父|師
coachman	(馬車の)御者
univariate	一変量の|単変量の
astrobiology	宇宙生物学(exobiology)
inhumane	薄情な
inadequately	不十分に
overshoot	(目標を)射越す|度を越す
carriageway	車道
randomization	ランダム化
photojournalist	フォトジャーナリスト|写真報道家
ionosphere	電離層(地上約80‐400kmのイオン圏;無線電波が反射され|遠方との交信を可能にする)
retroviral	逆転写酵素を有するRNAウイルスの|レトロウイルスの
amgen	アムジェンinc|ロサンゼルス郊外に本社を置く世界最大の独立バイオテクノロジー企業
carnivorous	肉食性の
orangutan	オランウータン
coot	オオバン(短い翼の水鳥)|《俗》(特に年取った)まぬけ|とんま
exhortation	勧告|熱心な勧め
tidbit	おもしろいニュースの一片|豆記事|(うまい物などの)ひと口|一片
engulf	飲み込む
adornment	装飾品
krispy	クリスピードーナツ|米国のチェーンストア名
pergola	パーゴラ(つる草などをまといつかせたあずま屋・たな)
inoperable	手術不能の|実施不可能の(an inoperable plan|実施できない計画)|作動不能|操作不可能
cyclonic	熱帯(温帯)性低気圧の;大たつまきの
pecker	ペッカー|キツツキ|つつく人|つつく鳥|つるはし|ペニス|鼻|くちばし(=bill|beak|pecker|nib|neb)
scalper	(株などの売買で)利ざやかせぎをする人|だふ屋
eugenics	優生学
amaryllis	アマリリス(大きなユリに似た球根植物)
sandpaper	紙やすり(で磨く)|を紙やすりで磨く
diehard	最後まで抵抗する(人)|片意地な保守主義者(政治家)
perdition	魂の破滅|魂の永遠の滅亡|地獄|破滅|全滅
hardiness	逞しさ|頑健さ|強壮|大胆|厚顔
phew	あーあ|(驚き)ほー|(疲れ)ああ|ちぇっ
pungent	刺激する|辛辣な
discontinuance	中断|中止|断絶|廃止
wraparound	端を重ね合わせて着る衣類(巻きスカートなど)
macaque	サル科マカク属のサル
unbridled	抑えのきかない|馬勒(ばろく)のない|拘束(抑制)のない|放らつな
situate	を(ある場所に)置く
purportedly	うわさによれば
urinate	小便をする
antigenic	抗原性の
dietetics	栄養学
locum	(医師・牧師などの)代行|代理
diatribe	痛烈な非難|酷評|こきおろし
chairwoman	女性の議長|女性の会長
woodcraft	(狩猟・キャンプなどの)森林技術|木彫術
manifestly	明白に|はっきりと
emphatic	断固たる
vole	ハタネズミ(小型のネズミ族の総称)
riv	river
homeward	復路|帰路
vireo	モズモドキ(アメリカ産の小型の鳴鳥)
fluorine	フッ素(化学記号はF)
refutation	論駁|論破
gunslinger	(特に米国西部開拓時代の)ガンマン|ガンファイター
troubleshooter	問題解決者|故障発見者|紛争調停者
caboose	乗務員車(貨物列車の最後尾につき調理・宿泊設備がある;《英》guard's van)
artistically	美術的に|芸術的に見れば
gulag	強制収容所
ampicillin	アンピシリン(ペニシリンに似た抗生物質)
fizzle	(最初はうまくいくが)失敗に終わる|しくじる|弱く消えてしまうようにシューシューと音を出す
wasn	wasn'tの略(俗語)
dissect	分析する|解剖する|切り裂く
tranche	一部分|分割払い込み金
clang	カラーン|ガランと鳴る音|金属がぶつかる音
unconstrained	拘束されない
osteopathy	整骨治療法
viceroy	総督
materialistic	唯物論(者)的な
boater	ボートに乗る人|かんかん帽
congresswoman	婦人国会(下院)議員
tass	さかずき
inaugurate	の開館式|開通式を行う|を開始する|始める
oncoming	近づいて来る|接近する|接近
wooly	羊毛の
beachcomber	(‐kòʊmɚ)|大波|波止場ごろ|(金属検知器などで)浜辺の落とし物を拾って歩く人
butternut	バターナッツ(クルミの一種);その木
theocracy	神権政治|神権政体|神政国家
sputter	ぱちぱちいう|早口で言う|口ごもる|パチパチという音を立てる
cockroach	ゴキブリ(roachも)
littoral	海岸の|沿海の|海岸地方|沿海州
renegotiate	再交渉する
anise	アニス(セリ科の一年草)|地中海原産|種のような果実はアニシードaniseedと呼ぶ香辛料
riverbed	川底|河床
grainy	粒状の|(壁紙･合板など)木目模様のある|(音声が)ざらざらした|(写真が)粒子の荒い
pepperoni	ペパロニ
consummation	達成|完全|成就|終焉
refreshingly	さわやかに
sculptural	彫刻の
outhouse	納屋
biopic	伝記映画
unfaithful	不誠実な
trill	震え声で歌う|トリル|歌を震え声で歌う|を巻き舌で発音する
linguistically	言語的に
criminalize	(人･行為を)有罪とする|(行為を)犯罪とみなす
reconstitution	再構成
interviewee	面接|インタビューを受ける人
titular	名だけの|名義上の|有名無実の|肩書の
diminutive	小形の|小さい|小型の|小柄の|ちっぽけな|(文法)指小の|指小(接尾)辞
transcendence	超越|超絶|(神の)超絶性
ponytail	ポニーテール
cellophane	セロファン(cellophane)はパルプから作ったセルロースを加工して作る透明な膜状の物質
skiff	スキフ(一人でこぐ|または帆走させる小さな舟)
scalpel	外科用のメス
porpoise	ネズミイルカ|(広く数種の)イルカ|でぶ|ふとっちょ
sorrel	スイバ|カタバミ(植物)
matrimony	結婚式|結婚|夫婦関係|結婚生活
hyperbaric	(医療などで)高圧酸素を使った
ailment	(軽い)病気|不快
homely	器量の悪い
subprime	上位に次ぐ位の|最高クラスに次ぐ|サブプライムの
sharpie	詐欺師|抜け目のない人|粋に着こなした人|スイング愛好者|三角帆の1～2本マスト平底船
stepfather	継父
taproot	(植物の)直根|主根
hotshot	やり手|腕利き|うまい選手|急行貨車|有能な(ぶる)人|(スポーツの)名人
underarm	腋(わき)の下|腋の下の;(野球などの)下手投げの|下手投げで
incurable	不治の
menthol	メントール|ハッカ脳(薬・香料に用いる)
propranolol	プロプラノロール(薬品名)
inescapable	逃げられない
brier	〈C〉イバラ|野バラ|〈U〉ブライア(シャクナゲ科の植物)|〈C〉(2の根で作った)パイプ
absorbance	吸光度
minx	おてんば娘|生意気娘|あばずれ女
cornbread	とうもろこしパン
supremely	最高に
mensch	りっぱな人間|あれー|おやおや
decarboxylase	デカルボキシラーゼ|脱炭酸酵素(Carboxy-lyases)|アミノ酸|α及びβケト酸等の有機化合物の脱炭酸を触媒する
excitatory	興奮性の
litigate	訴訟を起こす
fireproof	耐火|防火
singularly	際立って|とくに
underpinning	支柱|ささえ|土台|支持|応援
preposterous	非常識な|バカげた|ばかげた
glean	落ち穂を拾う|拾い集める|収穫する
gape	裂け目|ひび割れ(る)
dissuade	思いとどまらせる|思い切らせる
pyramidal	ピラミッド形の
umbra	本影(日食・月食で太陽光線がさえぎられてできる地球または月の影の部分)|(一般に)影にかった部分|影
poppin	ポッピン(ダンスの名)
kidder	だます人;からかう人
phosphoric	リンの|リンを含む
parquet	寄木細工の床|一階
confide	に打ち明ける|委託する|信任する|信頼する
reparation	賠償金|補償|回復
amply	十分に
saxophonist	サクスホーン奏者
spinnaker	(ヨットの主帆の前に張って追い風を受ける)大三角帆
damask	ダマスコ織り|どんす;(食卓用の)あや織り布|ダマスコ鋼(刀剣の刃に用いられる)|《詩》淡紅色|ダマスコ織りの|ダマスコ鋼の|《詩》淡紅色の
impotent	無力な|老衰した|力のない|無能な|虚弱な
emotive	感情に訴える|感情の|感情を表す|感情表出の|感動的な|激しい感情を起こす
papacy	教皇の位(任期)|教皇権
chemokine	ケモカイン|塩基性タンパク質でサイトカインの一群|白血球などの遊走を引き起こし炎症の形成に関与
ablaze	燃え立った|燃え立って|輝いて|興奮して
gramophone	蓄音機|畜音機
spotty	斑点のある
lech	(létʃ)好色な男|好色家 2|人名(レフ)
tannoy	拡声器(loudspeaker)による宣伝　（商標）タノイ　タンノイ　スピーカーの一種
senatorial	上院(議員)の
unexplored	未踏
sweeten	を甘くする|を清める|を和らげる
unannounced	予告なしの
exalt	昇進させる|高める|賞賛する
loafer	のらくら者(idler)|浮浪人(tramp)
skydive	スカイダイビング
insurmountable	克服できない
reciprocate	やり取りする|報いる
invisibility	隠れていること|不可視性|目に見えないこと
guppy	グッピー(観賞用のメダカ科の淡水熱帯魚)
etching	銅版画
emigrate	移住する
cornice	コーニス|コルニス|軒じゃばら(屋根が外壁に接する部分で軒|庇状に張り出した装飾)|雪庇
impenetrable	突き通せない|通過できない|理解の及ばない|(思想や影響を)受けつけない
gymnastic	体操(体育)の
triglyceride	トリグリセリド|中性脂肪|血清脂質の一種
epidemiologist	流行病学(疫学)者
airstrike	空爆|空からの攻撃|航空ストライキ
bund	海岸通り|築堤|堤防|(punt平底小船|ラグビー等でボールが地に着く前に蹴ること|bunt野球のバント|band帯|楽団|bund海岸通り)
luminescent	冷光を発する
percolation	ろ過|浸透;伝播(でんぱ)|普及
sockeye	紅鮭|sockeye salmon
budgie	《話》セキセイインコ
wheelbarrow	手押し一輪車|ねこ車|手押し車
beluga	ベルーガ(黒海･カスピ海産の大型のチョウザメ･卵はキャビアとして珍重される)|シロイルカ(北氷洋産)
attractor	ひきつける人･物
inane	空の|空虚な|うつろな|ばかげた|無意味な|空虚
euphemism	婉曲語法|婉曲語句
bluntly	無作法に|ぶっきらぼうに|無下に
harlot	《古》売春婦(prostitute)・みだらな女・あばずれ女
corky	コルクの[ような]|《俗》元気のよい|浮かれた
defensible	防御できる
tach	tachometer|タコメーター
vagrant	浮浪者|宿無し|放浪の|流浪の|転々とする|《おもに文》(考えなどが)気まぐれな|取り留めのない
anticancer	抗がん物質
noninvasive	非侵襲
segue	次の楽章･楽曲へ切れ目なく続く|セグエ(の楽曲)|(から~に)変身する(from to)|前の番組に途切れなく続く番組
fie	えーい!|ちぇっ!
abut	(建物など)が隣接する|境を接する|接触する|沿う
silkscreen	シルクスクリーン|孔版捺染(こうはんなっせん)法・〜‘を'シルクスクリーンで捺染する・絹紗スクリーン捺染法. ・= silk screen
olden	昔の
confound	混同する|困らせる|混乱させる
underwrite	(海上)保険を引き受ける|(ある危険を)保険する|(発行株式･社債)引き受ける
unending	果てしのない|絶え間のない|永久の
denunciation	非難|弾劾|告発|公然の非難
headquarter	《通例~s》本社|本部|本部を設ける
grimace	顔をしかめる|渋面|しかめっ面|顔を歪めること
spiffy	きちんとした|気のきいた|スマートな|しゃれた
nuanced	微妙な
abominable	忌まわしい|言語道断な|実に不快な|全くひどい
venomous	有毒の|毒液を出す
impressively	印象的に
patriarchy	族長制度|父主制|教長の管区
inextricably	表裏一体
surrealist	超現実主義(者)
bobsled	ボブスレー(ですべる)
barman	バーテンダー
erector	建設作業員
luminescence	(熱を伴わない)白光|冷光
interdepartmental	各部(局・省)間の|(大学などの)学部間の
persimmon	柿
unjustly	不当に|不公平に
yuk	気持ち悪いもの･こと|オエッ (=yuck)
unicycle	(スポーツまたは曲芸用の)一輪車
unknowingly	知らないで
slog	せっせと働く
swastika	(サンスクリット語由来)かぎ十字マーク|かぎ十字章|まんじ
reedy	アシの 多い|アシのような|アシ笛のような鋭い音の
vasectomy	精管切除[術]|パイプカット
fearsome	恐ろしい
likeable	好ましい
bullfrog	ウシガエル|食用ガエル
defection	亡命|国外逃亡|離脱|離反
millstone	ひきうす|重荷;やっかい者
shrike	モズ
expressionism	表現主義
penultimate	最後から2番目の
outnumber	数で勝る
morphogenesis	形態形成
symbiosis	共生|共存|共同生活|協力関係　(反)寄生parasitism
irregularity	でこぼこ|不揃い|反則|不規則|不規則なもの(こと)|不身持ち|不整|不正行為|不正事件|不品行|不法|変則|便秘
grayling	カワヒメマス
repossession	所有権を取り戻すこと|再所有
pompous	尊大な|大げさな|堂々とした|豪華な
propagator	繁(増)殖する物|植物の培養家|伝道者|宣伝者
possessive	所有の|所有欲の強い|所有格の|所有格|所有代名詞(形容詞)
ellipsoid	楕円体 (the Earth is an ellipsoid 地球は楕円体である)
abhor	ひどく嫌う|ぞっとするほど嫌う|拒否する
impassioned	深く感動した|情熱的な
productively	生産的に
thumbsucker	親指しゃぶりする幼児のような人(サムサッカー)|(俗)誌上エッセー|随想(家)
wheelie	ウィーリー|後輪走行|車輪付き大型ゴミ箱
taking	魅力的な|伝染性の|獲得|捕獲|所得|収入|売上高|悩み|困惑
mouton	(仏語)ムートン|羊の毛皮
contagion	伝染|伝染病|接触伝染
better	よりよい
casing	包装|枠
desecration	(神聖の)冒涜|神聖冒涜
venturer	冒険者;投機家
lackluster	つやのない|パッとしない|活気のない
gunmetal	ガンメタル(鎖・ファスナーなどに用いる銅・すず・鉛・亜鉛から成る金属)|(また gunmetal gray)砲金色(青味がかった暗灰色)
leper	らい病患者
slammer	ドア|戸口|刑務所|ブタ箱
croak	不吉な予言をする|ガァガァ|ケロケロ|カエルの鳴き声
sparkly	キラキラ光る
automaker	自動車メーカー
sputum	喀痰
ornithology	鳥類学
tress	(女性の)髪のひと房|巻き毛|編んだ髪
collard	コラード(米国南部で栽培されるケールの一種で食用)|ちりめんキャベツ
yadda	yadda|yadda|yadda等と使う|等々|の意味|"blah blah blah"や"and so on"と同じ使い方(スラング) (=yada)
audacious	大胆な|(法律などを)軽視した
forefoot	(四足動物の)前足
protestantism	プロテスタント主義|プロテスタンティズム
ferrule	(つえ・こうもりがさなどの先につける)石突き;(接合部補強の)金環
soreness	痛み|苦痛
boldness	大胆さ
confrontational	対立的な
plumage	羽毛|羽|凝った服装|羽衣|美服|羽飾り
chattel	動産|所持品|家財|奴隷
entrapment	おとり捜査|罠(にかけること)|絞扼(こうやく|(医)締め付け感)
underclassman	(大学・高校の)下級生
foetus	妊娠3か月以後の胎児|Cf|embryo 2ヶ月以内の胎児(胚子という)
powdery	粉末状の
detonate	(猛烈な音と勢いで)爆発させる|大爆発を起こす
uncharted	海図(地図)に(載って)ない|未踏の|未知の
amass	集める|(財産)を蓄積する|積む
concatenate	〜'を'連結する|鎖状につなぐ
genotyping	遺伝子型判定
virility	(成年)男子であること|男らしさ|男盛り
inalienable	(権利など)譲渡できない|奪うことのできない
slippage	滑り|滑ること|滑り量|漏れ|減少|差|損失|ずれ|遅れ|低下|不履行
leche	レチェ|練乳
untamed	飼い慣らされていない|言うことをきかない
washcloth	洗面タオル(小型のタオル)(《英》face flannel)
painstakingly	きめ細かに
flinch	しりごみする|たじろぎ|ひるむ
nightshade	ナス科の植物
taser	電気矢発射銃(で人を撃つ|麻痺させる)
shoddy	再生毛織物|見かけ倒しのもの|安っぽい|粗悪な
deceptively	一見|外見的には|人を欺くように
freelander	フリーランダー(車名)
molt	生え変わる|抜け変わる|脱皮する
trustworthiness	信頼性
octagonal	八角形の
pillowcase	枕カバー
dormer	屋根窓(屋根裏部屋の明かりとり窓)
abject	無気力の|悲惨な|情けない|卑屈な
sternum	胸骨
heretical	異端の|異教の|異説の
outlast	より長く続く
histologic	組織学的な
quiescent	静止の|平穏の|鎮静期
strangeness	不思議さ
proliferative	増殖性
peeve	をいらだたせる|じらす
kismet	運命
digitize	数字で表わす
shoo	(小鳥などを)シッと言って追い払う|(子供などを)さあさあと追い払う|shoo birds away|シッと言って小鳥を追い払う
cress	カラシナ類の植物;サラダなどの食用
offshoot	支流|分枝|派生物|子孫|分家
botulinum	ボツリヌス菌
takeout	持ち帰り用の料理
watchmaker	時計屋|時計職人
extramural	(都市・機関などの)城壁外の|外部の|(大学生・講座が)学外の|《米》(試合などが)対校の
layette	赤ちゃん用品一式
chaplaincy	chaplainの居場所|chaplainの職(地位|任期)
isthmus	地峡(略|isth|Isth)|(解剖|植|動)峡部(狭くなっている部分)
airliner	大型旅客機|定期旅客機
poltergeist	騒がしいいたずら好きの妖精
drawdown	(井戸･貯水池などの)水位低下|一時的電圧降下|ローンの借用総額|削減|縮小
exacerbation	(病気・事態などの)悪化
whorl	(巻き貝の)渦巻|輪生体|らせん(の一巻き)
incantation	呪文
mayday	五月祭|メーデー(労働者の祭典5月1日)
barista	エスプレッソ職人|バリスタ 
bacteriology	細菌学
prodigious	巨大な|並外れた|驚くべき|非常な
personage	名士|偉い人|人|個人|人物|役|登場人物
herpesvirus	ヘルペスウイルス
sociable	社交的な|懇親的な|人好きのする|(会などが)なごやかな
deftly	器用に|手際良く
raucous	騒々しい|耳障りな|しわがれた|しわがれ声の
geopolitics	地政学
litmus	リトマス(試薬の名)
tootsie	かわいこちゃん|パーティーガール|レズビアン
attestation	検案書
batgirl	バットガール(バットマンの女性配役)
immorality	不倫
coulee	クーリー(急流の浸食によってできた|夏はよく水がかれる米国西部の深い峡谷)
feldspar	長石(Al・Na・K・Caなどを含む鉱物)
begonia	ベゴニア|シュウカイドウ
incendiary	焼夷弾|放火犯人|焼夷性の|放火の|扇動的な
scowl	顔をしかめる|にらみつける|しかめっ面|渋い顔
spontaneity	自然さ
illusory	錯覚を起こさせる|幻想的な|実体のない|架空の
agglomeration	固まり|固まりになること|凝集作用
ribose	リボース(リボ核酸の加水分解によって得られる五炭糖)
sugarloaf	(またloaf)(精製糖を大きな円錐形に固めた)棒砂糖|すりばち山
tantamount	同等の|等しい
stepwise	段階的な
frigid	寒さの厳しい|極寒の|冷淡な
caulk	穴を塞ぐ|コーキングする
commode	トイレ|移動式洗面台|寝室用便器|lavatoryの遠回しな言い方
recidivism	常習的犯行|累犯
participle	分詞
rounders	ラウンダーズ(野球に似た英国の球技の一種)
immobilization	固定化
enteric	腸の
expropriation	(土地などの)収用|没収
outermost	最も外側の|最も遠くの
buccaneer	海賊(を働く)
myopia	近視眼|近眼
naturopathy	自然療法医|食餌(しょくじ)療法医
beanbag	お手玉
flagrant	言語道断の|極悪の|目に余る|はなはだしい|紛れもない|名うての
outgrow	より大きくなる|(衣服などを)着られないほど大きくなる|成長して～を脱する
trachea	気管
uneventful	波乱のない|平穏無事な
rasp	石目やすりをかける
distraught	ひどく取り乱して|気の狂った
unwavering	動揺しない|確固とした|しっかりしている
astronautics	宇宙航法|宇宙飛行学
piecemeal	ひとつずつ|少しずつ|漸次に|ばらばらの|切れ切れに
bilirubin	ビリルビン|古くなった赤血球が破壊されて生成される黄色い色素|ビリルビンは血液で肝臓に運ばれ|胆汁中に廃棄される
flirty	いちゃつく|軽薄な
rifleman	ライフル銃兵;ライフルの名手
armature	よろいかぶと(armor)|(電気モーター・発電機の)発電子|電動子;(電磁石の)接極子|(動・植物の)防護器官(歯・とげ・殻など)
haplotype	haploid genotypeハプロタイプ|HT(半数体の遺伝子型)|男性のY染色体のHT(ペアがなく乗換えがなく父から息子へ伝承)は父系の調査に|ミトコンドリアDNAのHTは母系の推定に使用
codification	成文化
inferiority	劣等
grope	手探りで捜す|手探りする|手探りで探す
acidosis	(医)酸血症|酸性症|酸性血症|酸中毒|アシドーシス|酸毒症
unroll	繰り広げる|解く|開く|広げる|展開する|示す|明らかにする|解ける|開ける
osmotic	(ɑzmάṭɪk)|浸透圧の|浸透性の|(osmotic pressure浸透圧)
clothe	に衣服を着せる|着せる|衣服を着せる
gentleness	優しさ
rigidly	堅く
oyez	聞け|静粛に(Hear ye!)(開廷の際|廷吏が通例3回叫ぶ)
roundhouse	(中央に転車台がある)円形機関車庫|後甲板|大ぶりの(パンチ)|(野球)大きく曲る(スローカーブ)
homologue	同族体|相同遺伝子(=homolog)|直系遺伝子と側系遺伝子を含め|配列がすべて似ている遺伝子
overstate	大げさに話す|誇張する|通す|貫く|浸透する
dispensary	調剤室|薬局|《おもに英》(学校などの)診療所
ambivalence	反対感情両立|愛憎併存
loudness	けばけばしさ|大声
intertidal	(海岸の)干潮線と高潮線との間の
bream	ブリーム(ヨーロッパ産のコイ科の淡水魚|うろこは模造真珠の塗料になる)|タイ科の海産魚
leaning	傾き|傾くこと|傾向|好み|性癖|偏愛
umber	アンバー(黄褐色の天然鉱物顔料)|こげ茶色|こげ茶色の
doorman	(ホテルなどの)送迎係|ドアマン
meaningfully	有意義に
embellishment	装飾
megalith	(特に|先史時代の遺物である)巨石
bursar	(大学の)会計係
inquisitor	調査官|(不当に厳しい|意地悪な)尋問者|(I-で)宗教裁判官
gullible	だまされやすい|のろまな(gull|羽毛の生えそろっていないまだ飛べない鳥)
biogenesis	生物発生
obviate	未然に防ぐ
smuggler	密輸業者|密輸船|密輸入者
busily	忙しく
synovial	滑液の|滑膜(の)
pedophile	小児(性)愛者|子供を性愛対象とする性的倒錯者
breve	短音記号(特に詩などで|母音が短音であることを示すための(^)の記号)
headlong	まっさかさまに|向う見ずに|真逆様に|直に
captor	逮捕者|賞品獲得者|捕らえる人
indelible	消すことのできない|書いたら消えない|忘れられない
alkalinity	アルカリ性
whiteness	白さ|青白さ|潔白
pentacle	五角の星形(魔よけなど神秘的象徴として用いられた)
immunohistochemical	免疫組織化学の
slop	こぼれる|こぼす|はね|衣服|ゆるい作業服|安物の既製服|不器用によそう|ぬかるみを歩く
unfulfilled	満たされていない
fluently	流暢に|すらすらと
leaven	イースト|酵母|潜在的影響力|(集団内部からおこる)改革向上意識
outstretch	〈手など〉‘を'伸ばす|広げる|〜‘を'枠(わく)(限界)を越える
wellspring	(無限に供給できる)源泉
tarry	ぐずぐずする|遅れる(delay)|滞在する(stay)
possessor	所有者|占有者
unobserved	観察されない|気づかれない|守られない
hous	ハウジング
exegesis	説明|解説|解釈
prat	まぬけ|ばか
intraocular	眼内
skilful	=skillful
squelch	ビシャビシャ音を立てて進む|鎮圧する
flattery	おせじ
backrest	背もたせ
dilatation	拡張
anticipatory	予想の
repulsion	反感|反発|反発力|撃退
drench	びしょ濡れ|浸す
assignable	割当ができる
zebrafish	ゼブラフィッシュ
lassie	(スコットランド方言)娘|少女|お嬢さん
bismuth	蒼鉛(そうえん)(金属元素;化学記号はBi)
unconnected	関係(関連)のない|筋の通らない
airstrip	臨時滑走路|仮設滑走路
ovum	卵|卵子
colonize	植民する
charmer	蛇使い|美女
lantana	ランタナ(香気のある熱帯植物)
seasonality	季節性
reassign	再び割り当てる
whisker	ほおひげ|ひげ|わずかの差
hydrogenate	〜‘に'水素添加する;〜‘を'水素処理する
endow	に与える|を授ける
permanency	〈U〉=permanence|〈C〉永続的なもの(人|地位)
sleet	みぞれ(が降る)|雨氷
allay	(興奮など)を静める|calm|和らげる|軽くする|減らす
transcontinental	大陸横断の
petrel	ウミツバメ
misinterpretation	誤解|誤訳
laxative	下剤(の)|通じ薬(の)
ungodly	神を恐れない|不信心の・《話》ひどい|無茶な・（時刻が）とんでもない・罪深い
chelation	＜chelate|キレート(錯体)を作って除去･浄化すること|キレート化して除去すること
preemie	早産児|未熟児
spectacularly	見事に
bonito	カツオ|鰹
quince	マルメロ(の実)|西洋カリンとも呼ばれる
constriction	圧縮|圧縮された部分|収縮|締め付けるもの|くびれ
babbler	片言をいう幼児|おしゃべり屋
troubadour	吟遊叙情詩人
fibrinogen	フィブリノゲン|肝臓で合成され|血漿中に溶解している糖タンパク質
covet	切望する|むやみにほしがる|むさぼる
handsomely	みごとに
multiracial	多民族の
soapy	石鹸の(ような)|お世辞たっぷりの|メロドラマのような
untenable	(陣地など)守れない|支えられない|(理論・立場など)支持できない|筋道の立たない
microbe	細菌
oratory	雄弁(術)|修辞|小礼拝堂
beautician	美容師
fingerboard	(弦楽器の)指板
grueling	罰する
downwind	風の方向に進む|追い風の|風と同じ向きに|追い風で
libelous	名誉毀損の|中傷的な
tardy	遅々とした|遅い|遅刻
seaward	海の方へ|海に向かう|(風が)海からの
deplete	消耗させる|使い尽くす|枯渇させる|奪う
uppermost	(階級･権力)最高の|最優位の|最上の
hermetic	密封した
showing	展示(会)|外観|説明|できばえ
tare	カラスノエンドウ(牧草)|《通例複数形で》有毒な雑草(新約聖書「マタイによる福音書」から)
cardamom	カルダモン|ショウガ科の多年草
seedy	種の多い
multicolored	色とりどりの
industrious	勤勉な
trestle	架台(木馬のような形をした台で|これを二つ並べ板を載せるとテーブルになる)|構脚(谷間に鉄道・道路を通すための脚立形の構造物)|=trestle bridge
temporally	時間的に
attractively	魅力的に
percussionist	打楽器奏手
stilt	竹馬
sleepover	外泊
tamarack	アメリカカラマツ;〈U〉その木材
promontory	岬(headland)|(突き出た)断崖|(解剖)岬(こう)角(骨の著しく突出している場所)
narcissism	自己陶酔(症)|自(己)愛|自己中心主義
disarray	混乱(させる)|無秩序|だらしない服装
implosion	内破|内部分裂
falsification	(書類などの)偽造;(事実などの)ごまかし|虚偽の申し立て
slaw	スロー|coleslaw(細かく切ったキャベツを使ったサラダの一種)
geomorphology	地形学
superhighway	幹線高速道路
scud	すばやく動く|疾走する(こと)|ちぎれ雲|スカッドミサイル|第二次大戦中ドイツが開発したV2ロケットのソ連版コピー|TEL(Transporter Erector Launcher)から発射でき機動力に優れる
habitually	常に|常々
markdown	値下げ|プライスダウン(和製英語)
voiceover	ボイスオーバー(VO)|映画やテレビなどで|画面に現れない話者の声(場面の叙述など)を用いる表現手法
reprieve	死刑の執行延期|刑の執行を猶予する
squeegee	とんま|まぬけ|ゴムぞうきん|スキージ|抜作|にゴムぞうきんをかける|ゴムぞうきんでふき取る
archetypal	原型的な|典型的な
shirk	避ける|を回避する|責任逃れする
docent	(大学の)講師
brimstone	硫黄(=sulfur)
tantalum	タンタル(希有金属元素;化学記号は Ta)
swagger	威張った歩き方|自慢(する)|ほらを吹く|威張って歩く
cupola	丸屋根 = dome
embellish	飾る|装飾する
flipside	レコードの裏面(B面)
emplacement	設置|位置|砲座|銃座
undersecretary	次官(deputy secretary|大臣|長官の補佐)|政務次官
austere	厳しい|厳格な|質素な|禁欲的な|陰鬱な
cowhide	〈U〉〈C〉牛の生皮|〈U〉(仕上げた牛皮)|〈C〉牛皮のむち
peerage	貴族|貴族社会|爵位|貴族名鑑
diabolical	悪魔の(ような)|極悪非道の|不愉快な
unspoiled	損なわれていない|甘やかされていない|昔のままの
infirmity	虚弱|病弱
haughty	おうへいな|傲慢な|偉そうに構えた|お高くとまっている
narcissistic	自己陶酔的な
pester	を悩ませる|を困らせる|にうるさくせがむ
expound	説明する|明細に説く|解釈する|述べる
musicology	音楽学
semiannual	半年ごとの|年2回の
apathetic	無感動な|無感情な|冷淡な|無関心な
fortify	の防衛を強化する|を固める|を元気づける|の栄養価を高める
subdivide	再分割する|再分する
equitably	公平に|公正に|正当に
centralization	集中化
hydrophilic	親水性の
biennale	隔年(2年に1度)行事|ビエンナーレ(ベニスの隔年美術展)
duress	拘束|監禁|強要|強迫
bluefish	青魚|アジ|ニシン|スズキなど
couldn	couldn’t
gyroscope	ジャイロスコープ|回転儀
deft	器用な
doable	することのできる|可能で
frostbite	凍傷
progestin	プロゲスチン(黄体ホルモン物質)
prefab	プレハブ住宅|プレハブ式の
whizz	びゅーと飛ぶ
bluebell	空色のつり鐘形の花をつける植物の総称;スコットランドのイトシャジン|米国のハマベンケイソウなど
paintbrush	ペンキ用のはけ|絵の具ばけ|絵筆|塗料ばけ
portico	玄関
acetyltransferase	アセチルトランスフェラーゼ|一つの化合物のアセチル基を他の化合物へ転移する反応を触媒する酵素|アセチル基転移酵素ともいう
grandiose	大げさな|仰々しい|壮大な
wormhole	(木材の)虫穴|(地面の)虫の通り穴
concisely	簡潔に
scepticism	(英式綴)懐疑論|懐疑的な見方(米はskepticism)
germanium	ゲルマニウム(希金属元素;化学記号はGe)
constancy	恒常性
countryman	同国人|田舎者
wingspan	翼スパン|翼長|翼幅
buncombe	=bunkum
lempira	レンピラ(ホンジュラスの貨幣単位)
thrall	奴隷(の状態)|を奴隷化する|束縛
insufficiently	不十分に
hick	田舎者
boudoir	婦人の寝室
crutch	松葉杖|支え|股(UK英|米語はcrotch)
famer	殿堂入り
quandary	困惑|ジレンマ|解決できない問題
microsatellite	マイクロサテライト
diploid	2倍体(2つで1対から成る染色体のセットを持つ細胞)|複相体|cf|triploid(3倍体)|tetraploid(4倍体)|haploid(半数体)
discursive	多方面にわたる|散漫な|次々に飛ぶ
amble	ぶらぶら歩く|のんびりと歩く
lampshade	ランプの傘
repudiation	放棄|拒絶|否認|離婚
lye	(合成)洗剤|クレンザー|アルカリ液|アク|灰汁|灰汁処理する
worrisome	くよくよする|厄介な|気にかかる|苦労性の|心配な
seafront	シーフロント|海に面した側|海岸通り|海岸遊歩道
frieze	一種の羅紗
sunblock	日焼け止めクリーム
tole	喧嘩騒ぎ|トール|街頭で行われる喧嘩
heliport	ヘリポート(ヘリコプター発着場)
inhabitant	住んでいる人|住民|居住者|住人|生息動物
antithesis	正反対|対照(法)|アンチテーゼ
frailty	弱さ
mandible	(哺(ほ)乳動物・魚の)あご;(特に)下顎骨(かがっこつ)(下あごの骨)|(鳥の)下くちばし;《複数形で》両くちばし|(昆虫の)大あご
airfoil	《おもに米》翼形|翼(《英》aerofoil)
spender	金を使う人|浪費家
warthog	イボイノシシ
pathogenicity	病原性
talkative	おしゃべりな|話し好きの
deselect	〈特に職業訓練生〉‘を'解雇する
effectuate	達成する
sleaze	やすっぽいこと|低俗
joust	(中世騎士の)馬上槍試合(をする)|試合(競技)に出る(参加する)
matriculation	大学入学許可|入学資格試験
counterclaim	反対要求|(特に)反訴
gremlin	グレムリン(第二次大戦中|飛行機のエンジンに故障を起こさせると言われた小悪魔)
orgasmic	オルガスムの
intubation	(医)胃腸･気管等に挿管すること
leeway	(時間的･金銭的)余裕|行動の自由|大目にみること
pigmentation	染色
lumpy	固まりだらけの
landlocked	内陸国|海岸線がない国
photoelectric	光電の(光によって起こされた電気的影響の)
embattled	戦備を整えた|布陣した|敵(軍)に包囲された
massif	中央山塊
diminution	減少(額)|低下
southernmost	最南端の
embezzlement	横領|使い込み|着服
dowry	持参金|女性からの持参金
confiscate	没収する|徴発する|差し押さえる
brownstone	褐色砂岩|ブラウンストーン(建築材料)|それを正面に張った家
positivity	陽性
camelback	らくだの背　ボイラーの上に機関手室のある蒸気機関車　キャメルバック(タイヤ用の加硫しない再生ゴム)
beautification	美化|装飾|盛装(粧)
fiscally	財政的に
cesium	セシウム|元素記号Cs|Cs133は比振動数が原子時計に使われる|ウラン核分裂生成物としてCs137はベータ線を出し半減期も30年と長く|死の灰や原発事故放射性降下物として問題となる
yippee	きゃあ|わあい
optician	(特に)眼鏡商|光学器機商
bolus	大きい丸薬(動物用)
grater	おろし金(がね)
cud	食い戻し|反芻動物が胃から戻して噛む食物
deadbeat	なまけ者|のらくら者(=loafer)|借金を踏み倒す人
loggerhead	アカウミガメ(大西洋産)|《おもに方言》ばか者
slowness	遅いこと|緩慢
xylophone	木琴
disband	解散する
lectern	講演者用の机|(教会の)聖書台
more	より多くの|もっと多くのこと
sanctification	神聖化|奉納|罪を清める(清められる)こと
indignant	憤概した|憤慨した|怒った|憤然とした
godless	神を否定した
shopgirl	女店員
zit	にきび
politeness	ていねい|礼儀正しさ|丁重さ
hurriedly	あわただしく|大急ぎで
conservatively	控えめに
acquiesce	黙認する|不本意ながら従う
fingertip	指先|いつでも使える
willpower	意志力
media	(mediaはmediumの複数形)|マスコミや報道|中間にあるもの|間に入って媒介するもの
snicker	くすくす笑い
neophyte	新改宗者|初心者|初学者|新参者
aphid	アブラムシ
ick	嫌なもの
omicron	(第15ギリシア文字)オミクロン|Ο|ο
boldface	ボールド体
laborious	骨のおれる
deaconess	慈善事業女性会員|女子執事
magnate	大立者|有力者|大実業家
myrrh	ラム酒|没薬|没薬を採る木
travesty	こっけい化|滑稽化
showy	人目を引く|目立つ|目覚ましい能力を見せる|派手な
altruistic	利他的な|愛他的な
pestilence	ペスト|伝染病|悪疫|腺ペスト|害悪|弊害
immunofluorescence	免疫蛍光
geneticist	遺伝学者
defiantly	挑戦的に
scrambler	はうようにして進む人(物)|周波数帯変換器
pathos	ペーソス|パトス|哀感|情念|哀愁
smartly	厳しく|こぎれいに|すばやく|ひどく|強く|抜け目なく|利口に
nephropathy	腎症
argumentative	議論好きの|論争的な
wisteria	フジ|藤
snout	(特に大きな)鼻|鼻先状の物|機首|(豚などの)鼻づら|筒先|氷河の末端
directorial	指揮者の|指揮上の
condiment	調味料|香辛料|薬味
aloof	離れて|遠く離れて|遠ざかって|風上の方に
teat	乳首|(哺乳動物の)乳頭|小袋|乳頭状突起|哺乳瓶の乳首
debutante	初めて社交界に出る少女|初舞台の女優
rematch	再戦
unsound	不健全な|健康でない|根拠不十分な|不合理な|(会社など)堅固でない|信用できない
mange	(méɪndʒ) (犬･牛などの)皮癬(ひぜん)|疥癬(かいせん|毛が抜ける)
silty	沈泥の;沈泥が詰まった
profusely	過度に|豊富に
rebroadcast	再放送|再放送番組|中継放送|再放送する|中継放送する
bearish	(株式市場が)下がり気味の|弱気筋の|熊のような|乱暴な|無作法な
reverie	夢想
colloquial	日常会話の|口語の|話しことばの|くだけた
thievery	盗み|盗品
homesick	ホームシックの
undercurrent	下層流
hymnal	賛美歌集|賛美歌の|聖歌の
gainer	利益を得た(得る)人;勝利者
ochre	黄土色
heartbreaker	人の心を傷つける人(女)|(特に恋人を振って)男の心を痛ませる女
lupine	ハウチワマメ(マメ科植物)|オオカミの(ような)
distiller	酒造家|蒸留酒製造業者|蒸留器
encyclopedic	百科事典的な|知識の広い|博学な|博学の
slink	こっそり逃げる|こそこそ歩く|を早産する
ironwork	《集合的に》鉄製品;《複数形で》製鉄所;鉄工所
imprecise	不正確な|不明確な
peal	響き|轟き|鳴り響く|轟く|(peel|皮をむく|は別語)
tourette	トゥレット症候群(Tourette syndrome)|チックという一群の神経精神疾患の内|音声や行動の症状のもの|小児期に発症し約半数は18歳までに消失するとされている
unfilled	満たされていない
twit	愚か者|ばか者
exuberance	豊かさ|豊富
endotoxin	エンドトキシン(内毒素)は|グラム陰性菌の細胞壁の成分 (toxinは毒素の意)
unnumbered	番号の付いていない|数えきれない|無数の
encyclical	(ローマ教皇が世界の全司教に与える)回勅
centipede	ムカデ類
wonk	仕事に専念する
checkerboard	チェッカー盤|市松模様|黒人白人混在地区
undying	不死の|永遠の|終りのない
stubble	刈株|麦の切株|無精ひげ
anhydride	無水化合物|酸無水物
appendicitis	虫垂炎(いわゆる盲腸炎)
caliph	カリフ(もと|イスラム教教主兼国王としてのマホメットの後継者たちに与えられた称号)
overplay	大げさな演技をする
existentialism	実存主義
defenseman	ディフェンスマン
toastmaster	乾杯の辞を述べる人|宴会の司会者
uptight	緊張した|苦しい
chimeric	キメラの
jiggle	を軽くゆする|軽く揺さぶる
peacetime	平時(の)
impossibly	ありそうもなく
drunkenness	酩酊|酒気
habitable	住むことができる|住むのに適した
diatom	珪藻