tradesman	商人|店員|小売商|(商品)配達人
myopic	近視の|近視眼的な
unscathed	(ʌnskéɪðd)無傷の
wile	策略|謀略|をだます
foreclose	除外する|排除する|締め出す
snugly	ぴったり|心地好く|こぢんまりと
joule	ジュール|SI(国際単位系)でのエネルギー|仕事|熱量|電力量の単位|1Jは標準重力下で約102|0 グラムの物体を 1 メートル持ち上げる仕事に相当
tuber	塊茎|結節
premonition	予感|予告
taillight	テールランプ
sherbet	シャーベット(=sorbet)
candidature	=candidacy
subjection	服従|征服
punctuality	時間厳守
jackrabbit	北米産の野ウサギ(長い耳と長く強い後ろ足を持つ)
acrobatic	曲芸的な
hoarse	しわがれ声の
chronometer	クロノメーター(科学的実験・航海・天文観測などに用いる精密な時計)
columnar	コラム状の|円柱の|円柱状に作った|縦欄式に印刷した|柱の
anemometer	風力計|風速計
outwit	機知において～より勝る
subtext	文学作品がその基底に持つ意味
midline	正中線
uncorrelated	無相関の
indivisible	分割できない
phonic	音の|音声の|発音上の|有声の
poetical	非常に空想的な|詩の|詩的な|詩人の
microbiologist	微生物学者
bandanna	バンダナ(大形の絞り染めハンカチ)
heraldic	紋章(官)の
sontag	日曜日(独語)
ideologically	イデオロギー的に
princely	君主らしい|王子の
backwash	逆流(船の航跡などによってできる)|後流(プロペラの回転によって疑こる)|(事件などの)余波
cornfield	とうもろこし畑|トウモロコシ畑|(UK英)麦畑
hydrodynamics	流体力学(流体静力学と流体動力学とを含む)
headdress	かぶりもの|ヘアスタイル|頭飾り
expletive	補足的な|単に補足的な|附(つけたり)の
elderberry	アメリカニワトコの実|=elder
misgiving	疑惑|不安|疑い|心配|恐れ
brickwork	煉瓦積み工事|積まれた煉瓦
fitment	備えつけの家具|備品
apportion	を割り当てる
mastitis	乳房炎|乳腺炎
bivalve	二枚目の|二枚貝(ハマグリ・カキなど)
wiesel	イタチ(動物名)|ドイツ陸軍が使用している空挺部隊向けの小型装軌車両
eggshell	卵の殻
wastebasket	くずかご|(=trash box)
mournful	悲しみに沈んだ|死者を悼む|陰気な
trigeminal	三叉神経の
baseless	根拠のない|いわれのない
preamplifier	プリアンプ(受信した弱い電波を検波・増幅する装置)
tipster	助言者|内報者|予想屋|垂れ込み屋
parliamentarian	国会議員|議会人
dismemberment	四肢切断
lamprey	ヤツメウナギ(大きな吸盤状の口を持つ)
suspenseful	サスペンスに満ちた
disingenuous	腹黒い|陰険な|不正直な|不誠実な
feverish	熱のある|熱病の(多い)|熱狂的な
reinvigorate	新たに活気づかせる|生き返らせる
suckling	乳児|幼児|幼獣|青二才|幼い
sleight	策略|手際
reptilian	は虫類の|はこう性の|卑しい
spongiform	海綿
pensive	物思いにしずんだ|悲しげな|沈痛な
disintegrate	崩壊(分解|風化)させる
stereoscopic	(写真・映画などが)立体的な|立体感を与える;立体(実体)鏡の
immunosorbent	免疫吸着剤
paschal	(ユダヤ人の)過越(すぎこし)の祭り(Passover)の|《古》復活祭の
upshot	結末|結果|要旨|要点
showoff	〈U〉誇示|見せびらかし|〈C〉見せびらかす人
radicalism	改革主義
serigraph	セリグラフ(シルクスクリーン印刷法による彩色画)
boisterous	荒れている|がさつな|騒々しい|乱暴な
bivariate	2変数の
reinvention	再発明
dither	おろおろする|うろたえる
incursion	侵略
phenom	非凡な人|奇才|天才
longboat	長艇
fullback	(サッカー･ラグビーの)フルバック
seabird	海鳥
consternation	狼狽|驚愕|びっくり仰天
histopathology	組織病理
minesweeper	(敵の機雷を除去する)掃海艇
wastage	消耗|損耗|消耗高
glasshouse	温室|ガラス工場|営倉
intravenously	静脈内に
memorialize	記念する|追悼する|請願書を提出する
yore	昔|昔の
conversant	通じている|精通している
smithy	鍛冶屋の仕事場|鍛冶工場|鍛冶屋|鍛冶場
ult	先月の
schoolwork	学業|学校の勉強
malformation	障害ある|奇形|不格好な
farmyard	農家の庭
tallow	(牛・豚・羊などの)獣脂(ろうそく・せっけんなどの原料)
rower	漕ぎ手|漕ぐ人|議論|言い争い
unforgiving	容赦のない
hyaluronic	Hyaluronic acid ヒアルロン酸|グリコサミノグリカンの一種|生体内|とりわけ関節軟骨では軟骨の機能維持に重要な役割をする
ravage	荒らす|破壊する|破壊|荒廃|略奪
rocketry	ロケット
immobile	不動の
indisputable	議論の余地のない|確かな|否定できない
dimmer	調光器
unkind	不親切な|不人情な|冷酷な|意地の悪い|(天候)悪い|思いやりのない
magnetosphere	(地球の周囲の)磁気圏
prismatic	プリズムの|分光の;にじ色の|角柱の
droop	うなだれる|伏し目になる|衰える|意気消沈
cahoot	共謀
paucity	少数|小量|少量|不足
faze	を口もきけないほどびっくりさせる|心を騒がせる|あわてさせる
expediency	便宜|好都合|(けなして)ご都合主義|利己主義
overprint	〈印刷したもの〉‘の'上に重ね刷りする|重ね刷りする
philology	言語学|文献学
alga	藻類|酸素発生型光合成を行う生物のうち|種子植物|コケ植物|シダ植物以外の総称|真正細菌のシアノバクテリア(藍藻)から|真核生物で単細胞生物の珪藻類や多細胞生物の海藻類まで含む
acrylamide	アクリルアミド|アクリル酸を母体とするアミドの一種
waggoner	=wagoner
horsey	馬の|馬のような|a horsy face 馬面(うまづら)|馬好きの|競馬･乗馬好きの
benzodiazepine	ベンゾジアゼピン|向精神薬|BZDと略される
backwoods	(特に北米の)森林地帯|辺境
airspeed	(飛行機の)対空速度|対気速度
eerily	不気味に
squawk	ガーガー鳴く|ブーブー不平を言う
decaffeinate	〈コーヒー〉‘から'カフェインを取り除く
concubine	男と同棲する女|内妻|愛人
antagonize	敵にまわす|反対する
alumna	(女子の)卒業生|(pl|alumnae)
amicable	友好的な|平和的な
pressman	印刷工|《英語》新聞記者
immunoprecipitation	免疫沈降
demonstrative	(文法)指示詞(の)
climactic	絶頂の|最高潮の|クライマックスの
stepson	養子の息子
radiocarbon	放射性炭素(生物体の年代測定に用いる)
colloquy	(正式な)協議|会談|(格式張った)会話|対話
splay	外側へ広がった(開いた)|ぶざまな|ぶかっこうな|斜面|隅切り(窓や扉の両側面の壁が傾斜した部分)|〜‘を'広げる|伸ばす|〜‘を'斜めにする;〈窓や扉[の壁面]〉に斜角をつける
joyfully	うれしそうに
opine	意見を述べる(いだく)|考える|思う
thermoelectric	熱電気の
mortician	葬儀屋
kitbag	(兵士の)雑のう|背のう
collegial	同僚が平等に責任(権限)を有する
snide	悪意に満ちた|にせの
contraindicate	〈薬・療法〉‘に'禁忌を指示する
offensively	無礼に|攻撃的
granary	穀倉地帯|穀物倉
distill	蒸留する
mouthwash	うがい薬
plausibility	もっともらしさ|口先のうまいこと
blarney	おせじ|おべっか|〈人〉を甘言でくどく|おせじ(おべっか)を言う
nickle	ニッケル|金属元素|元素記号Ni|鉄と共に最も安定な元素で|ステンレス鋼や硬貨他に広く使われる
vengeful	執念深い
agnosticism	不可知論(感覚的に経験する以上の事は知ることができないという主張)
gadfly	(家畜にたかる)ウシアブ|(批判したり要求したりして)うるさい人
retaliatory	報復的な
inducer	誘導する物|導く物|インデューサー
impracticable	実行不可能な|手に負えない
sorbent	吸着剤
scruffy	薄汚れた|汚い
playfully	ふざけて
vibrato	ビブラート|震動音
schoolyard	運動場|校庭
caddie	ゴルフのキャディー
alleyway	路地|小通路
gruff	粗暴な|どら声の|しわがれ声の|無愛想な|態度が粗野な
earmark	取っておく|目印をつける|指定する|(資金を)割り当てる
buxom	肉付きがいい
bankcard	銀行で発行するクレジットカード
isomer	異性体(分子式が同一で性質が異なる化合物)|異性核(同じ原子番号を持つが放射特性の異なる原子核)
timidity	臆病|小心
musty	かび臭い(moldy)
clapper	舌|拍子木|鳴子
curable	治癒できる|直せる
lithology	岩石学|結石学
pandit	(インドの)賢人|学者
anatomically	解剖学的に
stumbler	つまずく人|よろめく人|よろよろ歩く人
jobber	卸し商|賃(請負で)仕事をする人|場内仲買人
brisket	ブリスケット(brisket)|主に牛の肉の前肢の内側の肩バラ肉で|ブリスケと略される|肉質はやや堅く|バラより脂肪分は少なく淡白といわれる
sleepiness	眠け
honeydew	暑い季節に植物の城・茎にできる甘い汁(しる);(アブラムシ・ヨコバイなどの昆虫が分泌する)みつ|(糖みつで甘くした)甘露たばこ|=honeydew melon
mongrel	雑種(の犬)
transpire	明らかになる|漏れる|発散する
cartographer	製図家|地図製作者
humorist	ユーモアのある人|ひょうきん者|ユーモア作家|ユーモリスト|気紛れな人
cordillera	(大陸を走る)大山脈|大連山
terrapin	テラピン|平屋建てプレハブ住宅
trepidation	恐怖
squatter	不法居住者|大牧場主|うずくまる人
downbeat	指揮棒を振り下ろすこと|強拍|減退|零落|(映画など)暗い|悲観的な|のんびり(ゆったり)した
bambino	赤ん坊|幼い子|幼いキリストの像(画)
couscous	クスクス(北アフリカの蒸しだんご料理･しばしば肉･果物を添える)
stillbirth	死産;〈C〉死産児
prewar	戦前の
lubricate	に潤滑油をさす|滑らかにする
bateau	〈C〉両頭の平底のこぎ舟
tickler	くすぐる人(物)|《米》備忘録|《話》難問
downpour	土砂降り|土砂降りの雨|大降り
ragweed	ブタクサ(花粉は花粉熱(hay fever)の原因となることがある)
lighthearted	気楽な|快活な
minimalism	ミニマリズム(1950年代に始まった形と色の極端な簡素化を強調した彫刻と絵画の芸術運動)
physiotherapist	物理［理学］療法士・物理[理学]療法家
boxwood	ツゲ材
unsalted	無塩の
impostor	詐欺師|ペテン師
ironstone	鉄鉱石|白色硬質陶器
parsonage	(教会のそばの)教区牧師館
sacral	聖礼の
mortally	致命的に
carbonic	炭素の
glisten	きらきら輝く|きらめく|きらめき
unassuming	(人･態度など)でしゃばらない|気取らない|高ぶらない|謙そんな|控えめな
disillusionment	幻滅
premarital	結婚前の
speckle	に斑点をつける|小さい斑点|斑点|にしみをつける|小さな斑点|しみ|ぼつ
wilful	=willful
twisty	曲がりくねった
figment	作り事|作り話|空想事
phonemic	音素の
vacuole	液胞|小胞|空胞
erudite	学識のある|学問のある|博学な|衒学的な
appreciably	認め得るほどに|かなり
exult	歓喜する|勝ち誇る|大喜びする|こおどりして喜ぶ
flagstone	敷石|板石
bitchy	うるさい女
debater	討議者|討論参加者|討論者|論客
tarn	タルン|小湖|氷食でできた盆状の湖
attentively	注意深く|気配りよく
indiscriminately	無差別に|手当たり次第に
evangelize	福音を説く|伝道する|福音を伝える
technetium	テクネチウム(マンガン属の元素;化学記号は Tc)
meatball	ミートボール|(俗)退屈な人|まぬけ
bacteriological	細菌学の
overcharge	過充電|不当に請求する
architecturally	建築学的に
immigrate	移住する
pinko	左翼がかった人|ピンク色の|酔っぱらった
sledgehammer	力ずくの|強力な|大槌(で打つ)|圧倒的な|残酷な
bonkers	《英俗》気の狂った
verdant	青々とした
delimit	範囲(境界)を定める
dotty	馬鹿な
pedagogic	教育上の
tryst	(特に恋人同士の)会合の約束|あいびき(の場所)
mimeo	=mimeograph
brazier	火鉢
backache	背の痛み
remarriage	再婚
cockney	ロンドン子|ロンドン言葉|ロンドン下町なまり|ロンドン子の
interweave	織り合わせる
bilingualism	2か国語併用
nodule	小節|小起節|小さなこぶ(節)|団塊
modeler	模型製作者
assail	激しく非難する|激しく攻撃する|襲う|強い影響を与える
confirmatory	確認
pacesetter	=pacemaker
canard	流言|虚報|先尾翼機|(仏)カモ
shapely	形のよい|均整のとれた
aspartic	アスパラギンの
fairground	博覧会場|市のたつ場所|催事会場
degeneracy	デジェネラシー|退歩|退化|縮退度
mutagen	突然変異原|突然変異誘発物質
mullah	(イスラム教)ムッラー|師(律法学者･神学者の敬称)|先生
overactive	活動的過ぎる|活発過ぎる
homey	家庭の(らしい)|気のおけない|くつろいだ|気楽な
ornamentation	装飾
dictatorial	尊大な|独裁的な
uncomfortably	気詰まりで|心地悪く
aileron	補助翼
refiner	精製(精錬)業者|精製(精錬)機|みがきをかける人
amaranth	〈C〉(伝説の)不死の花|ハゲイトウ(色彩的な葉のヒユ属の植物)
startle	をびっくりさせる|ぎょっとさせる|驚き
randomize	ランダム化する
defenseless	防備のない
jokingly	しゃれて|冗談に
icicle	つらら|氷柱
feign	のふりをする|を装う|だと見せかける
waistline	ウエストライン|腰のくびれ|腰線|胴回り
bipartite	二者が分けもつ|相互の|(a bipartite agreement相互協定)|二つから成る|二通作製の
spectrograph	分光写真機
signification	意味|意義
counterattack	反撃|反撃する|逆襲
halftone	〈U〉(美術・写真などの)暗部と明部との間の階調;中間調(色)|〈C〉(写真印刷の)網版(あみはん);網版画
scorch	焦げる|の表面を焼く|を焦がす|をしおれさせる|あぶる|焼け焦げ
libertine	放蕩者|道楽者|放蕩な
pacifism	平和主義|戦争反対|参戦拒否
immeasurable	測りえない
wanker	自慰をするひと|ろくでなし|好事家
fluoridation	フッ化物添加[法]
colander	水切り器(わんの形の下に小さい穴がいくつもある料理用具)|こし器
testator	(法的に有効な)遺言者
distaste	嫌い|嫌悪
blockhead	ばか者|のろま|でくのぼう
resolutely	堅く決心して|断固として|堅く心に決めて
germane	と密接な関係がある|に適切な|妥当な|密接な関係がある|適切な|近親の
hypertrophic	肥大
silkworm	カイコ|蚕
culpability	非難に価すること;有罪
despotism	専制政治|独裁制
fragmentary	断片的な|破片の|切れ切れ|半端の
omniscient	博識の|賢い|全 知の
gladness	喜ばしさ|うれしさ
frisky	はね回る|元気に飛び回る
ballistics	(単数扱い)弾道学
bogle	幽霊|おばけ|こわいもの|かかし
birdbath	(庭などに設けた)小鳥の水浴び盤
inimitable	まねのできない|独特の|無比の|無類の
ineffectual	効果のない
armorial	紋章の
poppa	おじさま|おじさん|おとうさん|とうさん|とうちゃん|パパ
thickly	濃く|厚く|太く|密に|密集して|濃密に
eponymous	名前の起源となった主人公の
fibrin	フィブリン|繊維素(線維素)|血液凝固に関わるタンパク質
phaeton	フェートン(昔の2頭立て四輪馬車)
fecundity	肥沃|多産|生産力|生産性|生殖能力
hijacker	乗っ取り犯人
dysentery	赤痢
enchanter	魔法使い|魅力的な人
illegality	不法|違法|非合法|不法行為
debenture	債券
gaga	ホモ|ホモの前戯|いかれた|熱狂した|変わった|のぼせ上がった|夢中になって|恍惚の
barstool	固くて座席が丸い酒場の腰掛
lysozyme	リゾチーム|真正細菌の細胞壁を構成する多糖類を加水分解する酵素
antihistamine	抗ヒスタミン剤
proffer	申し出|申出る|を差し出す|を提供する|を進んで申し出る
allegorical	＜allegory|寓話の
beatnik	ビート族の若者|ビート族の人|服装や行動が突飛な人
anastomosis	(血管・神経の)吻合(ふんごう)|接合|(葉脈の)網状連絡
monotony	単調|退屈
steamroller	蒸気ローラー
wellhead	泉|水源|(物事の)源
pontificate	司教の職･位･任期|もったいぶって話す|尊大にふるまう
miniscule	非常に小さい|minuscule
unabated	衰えない|弱らない
inundation	〈U〉〈C〉氾濫(はんらん)・洪水・浸水・ 充満・(人・物の)殺到《+『of』+『名』》
backstory	裏話
philosophic	哲学の|賢明な
arrondissement	フランスの区|郡
protectionist	保護貿易論者|保護貿易主義(的)の
fluorite	ほたる石
rudeness	無礼
digression	余談|脱線
electrocardiogram	心電図(ECG)
submerge	水中に入れる|浸す|を沈める|を覆い隠す|(潜水艦が)潜水する|隠れる|埋もれる
stepchild	継子|連れ子|のけ者
musky	じゃこうの香る|じゃこう(質)の
intercellular	細胞間の
bootie	毛糸編みの小児用靴(ソックス)|くるぶしまでの短い長靴
flashcard	フラッシュカード(生徒の反応速度を増すために語学・算数などの授業に用いる単語・数字・絵などのカード)
shimmy	シミーを踊る|シミー(1920年代に流行したジャズダンス)
arthritic	関節炎患者|関節炎の
streptococcal	連鎖球菌の(による)
snarky	不機嫌な
slew	たくさん|どっさり|殺した|沼地
wintry	冬の|冬らしい|冷淡な|年とった
viewing	鑑賞
wintertime	冬|冬期
wickedly	意地悪く|不正に
digraph	(文法)連字|二字で一音を表すもの
bung	栓|栓をする|うそ|一撃|醸造者|パブの主人|盲腸|肛門
ultrastructural	超微細構造
anemic	無気力の
presuppose	～することを前提とする|仮定する
vindicate	の嫌疑を晴らす|(行動･主張など)の正当さを立証する
patronize	を保護･奨励する|をひいきにする|取り引きする
duodenum	十二指腸
percussive	打楽器|打診|衝撃の|震動の|打奏的な
magnificently	壮大に|堂々と|素晴らしく
neigh	馬がいななく|ヒヒーン(馬の鳴き声)
unpunished	処罰を受けていない
ophthalmologist	眼科医
apostasy	背教(行為)|背信|脱党
biplane	複葉機
vitriol	硫酸|辛らつな言葉
vicarage	〈C〉vicar の住宅|牧師館|〈U〉vicar の職
vestry	(またsacristy)(教会の)祭服室|祭具室|教会付属室(祈祷集会や日曜学校などに用いる)|(英国国教会などの)教区総社|教区委員会
overbear	(重さや･力で)抑えつける|抑える|くつがえす|威圧する|重要性(説得力で)勝る
suboptimal	次善の
cornmeal	ひき割りとうもろこし
gleefully	大喜びで|愉快に
febrile	熱病の|熱からおこる
fosse	堀|溝|運河
striatum	線条体
ilex	ウバメガシ(常緑のカシの一つ)|西洋ヒイラギ
resplendent	光り輝く|輝く|まばゆい
whee	ワーッ(という叫び声)|興奮させる|大喜びさせる|おしっこ
lignite	亜炭|褐炭
thicken	を厚くする|太くする|を濃くする|太くなる|複雑になる
ringside	かぶりつき|リングサイド|近くから見える場所|最前列の席|リングサイドの
artfully	巧妙に
repayable	払い戻せる|恩返しできる
smuggle	を密輸する|をこっそり持ち込む･持ち出す|密航する
airhead	変人
pater	主の祈り|主祷文
trivet	(鉄製の)三脚ごとく|(食卓用の)小型金属台(熱いものなどをのせる|短い脚がついている)
calliope	〈C〉カリオペー(1組の汽笛から成る楽器;サーカスでよく使われる)|《C-》カリオペ(ギリシア神話のMuseの一人で雄弁・英雄詩をつかさどる神)
boomtown	《米》新興都市
windjammer	(大きな)帆船|帆船の水夫|《英》=windbreaker
formalin	ホルマリン
futurity	〈U〉未来|〈C〉《しばしば複数形で》未来のでき事
fruitcake	フルーツケーキ
buhl	ブール細工家具(表面に金属・貝・べっ甲などをはめ込んだテーブル・食器だななど)
pacify	戦乱を収める|平和にする|を制圧する|をなだめる|を静める
reamer	リーマー|穴ぐり工具(金属にあけた穴を大きくしたり仕上げたりする工具)|果汁しぼり器
lavage	(胃などの)洗浄
lopsided	不均衡な|偏った
flipper	水かき
ironclad	装甲艦
quicksand	流砂
tiptoe	爪先|つま先|つま先で歩く
wpm	words per minute 1分間当たりのタイプ打字数
chlorella	クロレラ(緑藻(りょくそう)類の一種で食料として栄養価が高い)
tarpaulin	(タールなどを塗った)厚い防水布|防水シート
overpower	征服する|圧倒する
laud	(大げさに)賞賛(する)|称賛(する)
offal	くず|廃物|ごみ|がらくた
rebus	判じ物(絵)
institutionalize	(慣習などを)制度化する|(精神病者･非行少年)施設に収容する
stipe	茎|子房柄|(葉)柄
axonal	(神経の)軸索の|軸索に関する|軸索に似た
naphtha	ナフサ|粗製ガソリン
travertine	温泉沈殿物(石灰華の一種：イタリアで建築材に用いる)
wormwood	ニガヨモギ|苦悩(の種)
railcar	レイルカー|気動車(ディーゼルあるいは電気で単独でも動かせる鉄道各車)
dasher	突進する人(物)|撹拌(かくはん)器
slipcover	とりはずしできる家具カバー
brainstem	延髄と橋|中脳と間脳を合わせて脳幹と呼ぶ|脳幹･(間脳)･小脳･大脳を合わせて脳と呼ぶ
cockle	(鳥貝|赤貝|ムール貝などザルガイ科の二枚貝)|その殻|小舟|(紙･皮の)しわ|しわを寄せる|小さな暖炉|ストーブ
pineal	松果腺[体]の・松傘状の
nationalistic	国家の|国家主義の|民族主義的な
jailer	看守
bricklayer	れんが積み職人
billfold	札入れ
foamy	泡だらけの|泡の|泡沫の|泡立つ
ringworm	輪癬(りんせん)(たむしの類)
reprogram	再プログラム(する)
unwell	(特に短い時間)体の具合が悪い|気分がすぐりない|月経中である
isothermal	一定温度で起こる|等温の
unconscionable	非良心的な|法外の|途方もない
joyride	車をブッ飛ばすこと
lurid	けばけばしい|ぞっとする
annunciation	布告|受胎告知
demotion	降格
octavo	八つ折り判(全紙を八つ(16ページ)に折った大きさ)|八つ折り判の本
undemocratic	非民主的な
boondocks	荒地|森林地帯|辺境地|片いなか
futurism	(芸術の)未来派
brougham	ブルーム型馬車(一頭立四輪箱馬車)|ブルーム型自動車(運転台が外にある旧式のもの)|ブロアム(自動車の高級モデル)
gunship	武装ヘリコプター
cubism	立体派|キュービズム(20世紀の初めにフランスでPicassoの一派)
maim	(人を)不具にする|不具になる|損なう
immunoreactivity	免疫反応性
flail	殻竿(で打つ)|からざお
misappropriation	着服|横領
resound	音で満ちる|反響する|こだまする|鳴り響く|鳴り続く|轟く|響きわたる
scrubber	床の掃除人|ごしごし洗う剛毛ブラシ|スクラッバー|集塵器|洗浄器|ガス洗浄装置|洗浄工
defile	汚す|よごす|不潔にする|の美観をそこなう
breastfeed	母乳で育てる
subservient	卑屈な|役立つ
narc	麻薬取締官
scepter	王笏|しゃく|王権
lyrically	叙情
stubbornly	強情に|頑固に|断固として
excrement	糞|排泄物(=stool)
stoplight	停止信号|(車の)ブレーキランプ
clink	カチン|かちんという音|コップがぶつかる音
disobedient	服従しない
redwing	ヨーロッパ産のツグミの一種;羽がところどころ赤い
relatedness	関連性
transferability	移動できること;転写できること;譲渡しうること
whiny	泣き言を言う
uninitiated	初心者
desertion	遺棄|脱走|荒廃|捨て去ること|放棄
briskly	きびきびと|活発に
humoral	(医)体液性|液性
disequilibrium	不均衡
huffy	むっとしている|怒っている
snazzy	粋な|すてきな|パッと人目を引く|おしゃれな|快適な|趣味の悪い|派手な柄の|けばけばしい
weariness	疲労|飽き|退屈|倦怠
ascendancy	主導権|優勢
ingrown	内に伸びた|(特に毛髪や足のつめが)肉に食い込んだ
arthroplasty	関節形成
infest	〈害虫・盗賊などが〉‘に'横行する|はびこる
spectrophotometry	分光光度法
spearmint	ミドリハッカ|スペアミント(調味用香料)
energetically	精力的に
itty	(幼児語)ちいちゃい(=itty-bitty)
udder	(牛|山羊などの)乳房
appeasement	(əˈpɪiz|mənt)慰撫|鎮静|緩和|譲歩|宥和政策
tractable	従順な
electrophysiological	電気生理学的な
greenback	ドル紙幣(ドル紙幣の裏面が緑色なので)|米ドル紙幣
erythropoietin	赤血球生成促進因子(EPO)
normalcy	=normality
sluice	源|人工水路|水門を開く|水門から流れ出る
clavier	(ピアノ・オルガンの)けん盤|けん盤楽器
riding	乗馬|乗車(の)|馬場
disorientation	方向感覚の喪失|見当識障害
winsome	愛敬のある|陽気な
gird	備える|囲む|(帯で)～を締める|縛る|まとう
inculcate	繰り返し教え込む|熱心に説き聞きかせる
honcho	長|親方|ボス・日本語の「班長」が語源
loran	ロラン|船･航空機が2無線局から受ける電波の到着時間を測定して自分の位置を割り出す装置
meatpacking	精肉業(家畜を屠殺(とさつ)し市場へ肉を卸す;肉の販売店はa meat(butcher)shop|《英》 butcher's)
gatehouse	守衛詰め所|番小屋
unattainable	手に入れにくい|達しがたい
unremarkable	平凡な
creak	キーキー|きしむ音　(creekは「小川」別語)
mineralogical	鉱物学的の
schmuck	愚か者
uncharacterized	特徴付けられていない
hallucination	幻覚|妄想
desiccant	(薬品など)乾燥力のある|乾燥剤
hippopotamus	カバ(複数形|hippopotamuses|hippopotami)
ethane	エタン(無色・無臭の引火性の気体;燃料ガス用)
vend	(小さな商品を)売り歩く|(土地･家屋などを)売却する
punchline	punch lineジョークなどの話の急所|落ち
astringent	渋い|辛辣(しんらつ)な|アストリンゼン|収斂性の
fluvial	川の;川に住む|河流の作用によってできる(生じる)
uproot	追い立てる|引き離す|を根絶する|を根こそぎにする
upmarket	上級市場向けの|高所得者向けの|金持ち相手の
intercede	嘆願する|仲裁する取り成す|請願する
determinate	一定の|確定的な|決然たる|限定された|有限の|を確かめる
whammy	まじない|縁起の悪いもの|凶眼|強い力|強力な攻撃|邪視|致命的な一撃|魔法|魔力
hoodlum	やくざ|ちんぴら
sachet	(仏語)におい袋
preserver	保存(保護)者|缶(瓶)詰め業者
beget	こしらえる|生じさせる|きたす
chorionic	絨毛膜の
footloose	足の赴くままの|勝手きままな|束縛を受けない|身軽な
precipice	絶壁|危機|断崖|窮地
crozier	=crosier
ferocity	獰猛さ|狂暴な行為
slipstream	スリップストリーム 《高速走行中のレーシングカーの後ろにできる低圧部分; 後続車がここに入るとスピードの維持が容易になる》・後流(飛行機のプロペラが後方へ押す空気の流れ)
procreation	出産;生殖
glengarry	グレンガリ帽(うしろにリボンがついたスコットランド高地人のかぶる縁なし帽子)
gaff	ギャフ(魚かぎ|魚市場等で魚を引っかける道具)|斜行する(海上用語)|ひどい|じっとたえる
parfait	パフェ(アイスクリームに果物やシロップをかけたデザート)
brucellosis	ブルセラ病|波状熱|動物の流産や人間の弛張(しちょう)熱の原因となる
culpable	責められるべき|過失のある|罪のある|有罪の
wordplay	しゃれ
repudiate	否認する|拒む
enslavement	奴隷にすること|奴隷状態
gunsmith	銃砲製造工|銃砲かじ
flunk	(米語)落第する|単位を落とす|しくじる|試験などに失敗する
asunder	ばらばらに
publican	(古代ローマの)収税吏|《英》居酒屋(pub)の主人
counterintelligence	対敵情報活動
unharmed	そこなわれない|無事な
tenon	(木工で)ほぞ
sociocultural	社会文化的な
lambskin	〈C〉(毛つきの)子羊の皮|〈U〉子羊のなめし皮|〈U〉羊皮紙
coverlet	ベッドのおおい
forgetfulness	健忘性|忘却
pectoral	胸の|胸筋の
phlox	フロックス|ハナシノブ科の植物で花が美しい|67種が知られており|越冬性一年草のものと多年生のものがある
oaf	とんま|のろま|取替え子|(希に)低能児
bondsman	(主に米)保釈保証業者(裁判所･刑務所近くに事務所を持ち職業として保釈金を貸したり保証人になったりする人)
underfoot	足もとに
unhinge	乱す|狂乱させる|蝶番(ちょうつがい)をはなす|混乱させる
primeval	原始時代の|太古の|原始
knapsack	ナップザック
horsemanship	馬術
pensionable	年金(恩給)をもらう資格のある
cookout	野外で料理して食べること(集い)|野外料理会の
safekeeping	保管
counterweight	(=counterbalance)対抗勢力
vernier	バーニア|ノギスの英語名|スケール(バーニア)という副尺を持ち|本尺の1/20まで目で計測可能な計算器
clothier	服屋|紳士服店|服地屋|織物仕上げ工
flan	フラン(チーズ･クリーム･果実などを詰めたtartの類の菓子･スペイン料理では甘味をつけたエッグカスタードをいう)
nutritive	栄養に富む|栄養の|栄養に関する
polyphony	(音楽で)対位法|多声音楽
disparage	見くびる|非難する|の名誉を傷つける|評判を悪くする
tepid	生ぬるい|熱意のない
inessential	全然必要でない|全然必要でないもの
belie	正しく伝えない|裏切る
gusher	噴油井|しゃべり立てる人
muscarinic	ムスカリン性の|ムスカリンの|ムスカリン作用薬(神経伝達作用薬)
opportune	適切な
malate	リンゴ酸塩
overwork	過労|こき使う|働きすぎる
papilloma	乳頭腫|ヒト乳頭腫ウイルス(HPV)の感染で喉頭に起こる良性の腫瘍|声が出にくくなる
untie	ほどく|解く|を解放する|自由にする
overpopulation	人口過剰|過密居住
oligarchy	寡頭政治
novation	更改
sooty	すすで覆われた|すすだらけの|すすの|黒っぽい
purveyor	指定商人|(～の)まかない方|調達人|御用商人|賄い屋
telomere	テロメア|真核生物の染色体の末端部にある構造|分裂のたびに短くなるとされる
obfuscation	混乱|心を暗くすること
pentathlon	五種競技
thallium	タリウム(金属元素;化学記号はTl)
failsafe	絶対に安全な|二重安全装置の
porky	(人が)丸々とふとった|豚のような
biofilm	バイオフィルム|菌膜とも呼ばれる|微生物により形成される構造体である
repute	とみなす|と考える|を評する|世評|評判|うわさ|名声|信望
nakedness	剥(む)き出し
faeces	=feces
handrail	手すり
rationalism	合理主義|理性主義|理性論
wistful	物欲しそうな|もの思いに沈んだ
lifeblood	生き血|活力(元気)のもと|源泉|活力の元|生命
moronic	愚かな|まぬけの
acidification	酸性化
regurgitation	逆流|(未消化食物の)吐きもどし|反芻(はんすう)|血液の逆流
alfresco	戸外で|戸外の
elucidation	解明|説明
infectivity	伝染力
vender	=vendor
mousetrap	ネズミ捕り|おとし穴|においの強いチーズ|安いチーズ|小さな家|場末のナイトクラブ|二流の小劇場
deforest	〜‘の'森林を切り払う
spillover	吹越|スピルオーバー|溢流
afterburner	(ジェットエンジンの)再燃焼装置
stretcher	担架|伸ばす人(物)
contractile	収縮性の
arachnid	(クモ･ダニ等)クモ形類動物|クモ形類の
extort	強要する|ゆすり取る|こじつける
upsurge	わき上がる
peewee	異常に小さい人(物)|ちび|=pewee|ちびっこの|非常に小さい
inequitable	不公正な|不公平な
depolarization	脱分極
doubleheader	ダブルヘッダー(同じ2チームが1日に2試合すること)
misnomer	誤称|誤った名
perpetrate	悪事を行う|犯す
odorless	においのない|無臭の
fissile	分裂しやすい|核分裂性の|分裂性|核分裂性
opulence	豊富|富裕
aubergine	ナス(=eggplant)
gastronomic	美食(法)の|料理法の
unease	不安
centigrade	セ氏温度計|セ氏の|(=celsius)
meniscus	凹(凸)面|凹凸レンズ|新月(半月)形のもの|(ひざ関節の)半月板
bigwig	お偉方|大物|an important person
toboggan	トボガンぞり(ですべる)|(相場などが)暴落する
sombrero	ソンブレロ(メキシコのツバ広帽)
ornithological	鳥類学の
melodramatic	メロドラマ風の|芝居がかった
inexperience	無経験|不慣れ|未熟|世間知らず
rime	(=rhyme)|外皮|硬い表面|(白)霜|霧氷|霜で覆う
saboteur	(s`æbətˈɚː)サボタージュを行う人|(軍隊)破壊工作員
serially	シリアルに
prosecutorial	検察
chapbook	呼び売り本(昔|行商人が売った通俗読み物の小冊子)
thoughtless	無分別な|思慮のない|軽率な|不注意な
blasphemous	冒涜的な|不敬な
unaided	助けを受けない
squishy	フワフワな|グニャグニャな|ビショビショな
washout	流失箇所|流失|決壊|大失敗|落第者
empathize	感情移入する|共感する
parapet	(橋などの)欄干|(壁上の)手すり壁|手すり|(城の)胸壁|特有の|特異な|特権|私有財産
fatherland	祖国
delphinium	ヒエンソウ(キンポウゲ科の観賞用植物)
myasthenia	筋無力症
swanky	しゃれた|派手な
marsupial	有袋動物|有袋目の|袋(状)の
benzoate	ベンゾアート(安息香酸エステル)
penumbra	(太陽黒点の)半影(部)|明暗(濃淡)の境
spry	活発な|すばやい
antitumor	抗腫瘍
chafe	こすって暖める|すりむく|いらだたせる
genitourinary	泌尿生殖器の
trifecta	三連勝単式
decennial	10年間(ごと)の
blotch	しみ
acquiescence	黙認|おとなしくしたがうこと
disaffect	〈人〉‘に'不満を抱かせる|‘を'いやにさせる
peroxidation	過酸化
mitochondrion	ミトコンドリア|(複数形)mitochondria
lapidary	宝石|宝石細工の|玉彫りの|玉みがきの
caraway	ヒメウイキョウ(セリ科の植物;実は食用・薬用)
consign	引き渡す|委託する
fastback	ファーストバック(流線形の後部[をもった自動車])
curatorial	管理者の|館長の
earshot	聞こえる範囲
physiologically	生理的に
rheum	《米》粘膜分泌物(涙・鼻汁など)|《古》鼻カタル|感冒
epicurean	快楽主義の|飲み食いの好きな|美食家的な
singe	〜‘の'表面を焼く|焦がす|〈毛髪・糸など〉‘の'先端を焼く|焦げあと;焦がすこと|先端を焼くこと
admonish	警告する|勧告する|促す|注意する
fetter	束縛する|足かせ|足鎖|束縛|拘束
effervescent	泡立つ|発泡性の|起沸性の|興奮した|熱っぽい
sappy	のろま|あほ|感傷的な|女々しい|元気旺盛な|活気に富む|樹液の多い|液汁に富む
secede	脱退する|分離する
transfiguration	〈C〉〈U〉変形|変貌|《the Transfiguration》(カトリックで)キリストの変容
skimmer	上澄み(浮きかす)をすくい取る人(もの|穴あきスプーン)|表面すれすれに過ぎるもの|飛ばし読みする人
reductive	減少させるもの|減少する|復元する|戻す
filial	子としての|親から～世代の
carillon	組み鐘|カリヨン|鐘楽曲
macrobiotic	長寿にきく殻類や野菜からなる|菜食による|長寿食の
pronouncement	公表
sporran	スポーラン(スコットランド高地人がキルトの前につるす皮の袋)
cortisone	コーチゾン(副じん皮質ホルモンの一種|関節炎の治療剤)
natty	粋な|小ぎれいな
contralateral	反対側の
respectability	尊敬すべきこと|尊敬に値すること
radiometric	{形}|放射線測定器の(による)
townspeople	都会人
atherosclerotic	アテローム性動脈硬化
infielder	(野球)内野手
flatulence	ガスで腹の張った
grok	(米俗)完全に理解する|よくわかる|共感する
decently	きちんと|かなり|相当に|親切に|礼儀正しく|体よく
metaphorically	比喩的に|隠喩的に
tripe	くだらない話|牛の胃袋
saguaro	サグワロサボテン(非常に大きなサボテンで|アメリカ合衆国西南部・メキシコに産する;白色の花をつけ|実は食用となる)
flyby	儀礼飛行|低空飛行
boyish	男の子らしい
egotistical	=egotistic
saran	サラン|高温で可塑性を有する合成樹脂の一種
uninvited	招かれない
neuroendocrine	神経内分泌の
comatose	昏睡状態の
dosimeter	線量計(放射線の量を測定する装置)|薬量計
hygrometer	湿度計
meddle	干渉する|おせっかいを焼く|いじくる
forgetful	忘れやすい
peyote	ペヨーテ（= ウバタマ:メキシコ中部から米国テキサス州南部原産サボテンの一種・幻覚をもたらす成分であるメスカリンを含有する）・ それから得られる幻覚剤
concertina	コンチェルティーナ|アコーディオンの一種|(アコーディオンのように)伸縮する|(蛇腹状に)ぺちゃんこになる
photogenic	写真写りの良い|写真向きの|発光する
uneasiness	不安|不愉快|窮屈
afresh	新たに|更に|再び
thalamus	視床(thalamus)|脳の構造のうち間脳の一部を占める部位|嗅覚以外の|視覚|聴覚|体性感覚などの感覚入力を大脳新皮質へ中継する重要な役割を担う
homerun	ホームラン
toothache	歯痛
vaccinia	牛痘(=cowpox)　痘疹
escapade	脱線|とっぴないたずら|脱出
oink	豚の鳴き声|ブーブー
biomedicine	生択臨床医学(生体の化学と機能の関係を扱う)
homicidal	殺人の
mesenteric	腸間膜の
melanin	メラニン(ヒトの肌･頭髪･瞳等の色素)
monstrosity	奇怪(なもの)|怪物|奇形動物|極悪
gutsy	勇敢な|元気のいい|根性のある|図太い
predecease	〈人・事件〉‘の'前に死亡する|‘に'先立つ
plinth	(建築)柱の下の四角な柱脚|台座|銅像の台石|プリンス|幅木
reassert	再び主張する|重ねて主張する
autocratic	独裁の
teenaged	十代の
hiccup	しゃっくり
fencer	フェンシングの選手|剣客|剣士|フェンス(囲い･柵)を作る人
shyly	恥ずかしそうに|内気に
topoisomerase	トポイソメラーゼ|2本鎖DNA(1本鎖DNAが互いに逆向きに結合し二重らせん化したDNA)を切断し再結合する酵素|抗がん剤や抗生物質のターゲットとして知られる
fingernail	指の爪
scone	饅頭形パン
scumbag	卑劣な人
unmanageable	取り扱いにくい|手に負えない
eep	チューというネズミの鳴き声
villainous	悪人の
reexamination	再審理
terrazzo	テラソ(大理石の砕石入りセメント)
steadfastly	しっかりと|断固として
bookbinding	製本[術]|製本業
abstention	節制すること|回避|棄権|慎むこと|不参加|不干渉
conservationist	自然保護論者
ruthlessly	情け容赦なく|無情に|冷酷に
internalization	内面化
puppeteer	人形遣い|人形師|操り人形師|ロボットを操作する人|操る|操作する|人形･人の心を
alleluia	=hallelujah
homeobox	ホメオボックス|動物|植物|菌類の発生の調節に関連する相同性の高いDNA塩基配列
afterword	あとがき
monocyte	単球|まだ未成熟な顆粒白血球の仲間で|組織内に移るとマクロファージと呼ばれる大型の食細胞に変化する
solidification	凝固;結束|団結
cranny	(壁･岩などの)割れ目|裂け目
resuscitate	生き返らせる
actinic	化学線作用を持つ|(actinic rays化学線|紫外線)
toothless	歯のない
rabbinical	ユダヤの律法学者の;彼らの教え(考え方|学問|著作)に関する
gaffe	(特に社交･外交上の)失敗|へま
frankincense	乳香(古くから祭式などに香料としてたかれた樹脂)
creosote	クレオソート(防腐剤)
cloakroom	(また『checkroom|coatroom』)(ホテル・劇場などの)外とう・携帯品預り所|(また『checkroom』)(駅の)手荷物一時預り所|《米》議員控え室|《英》《遠回しに》便所
flyover	(道路・鉄道の)高架式交差道|インターチェンジ|《米》=flyby
gunpoint	銃口
dimer	モノマー(単量体)が結合した重合体がオリゴマー(oligomer)で|数に応じダイマー(dimer|二量体)|トライマー(trimer|三量体)|テトラマー(tetramer|四量体)|ペンタマー(pentamer|五量体)と呼ぶ
telltale	密告者|タイムレコーダー
flout	侮辱(する)|馬鹿にする
beachwear	海浜着
madcap	向こう見ずな|無鉄砲な|向こう見ずな人;無鉄砲な娘
parsnip	パースニップ|セリ科の二年草|ニンジンに似た根菜で|別名アメリカボウフウ|シロニンジン|サトウニンジン|ヨーロッパ原産
scald	にやけどさせる|やけどする|沸かす|熱湯消毒
hypoxic	低酸素の
couturier	(男性の)婦人服デザイナー|婦人服洋裁師
impersonator	物まね芸人|声色使い|俳優
unworkable	実行不可能な
crabby	つむじ曲りの|不機嫌な
confidant	親友(女性形はconfidante)
voracious	食欲旺盛な|むさぼり食う
burlap	バーラップ|黄麻布
phagocytosis	アポトーシス死した細胞の食作用等|他細胞を食する作用(食菌作用)
rescuer	救済者|救助者
aqualung	アクアラング(潜水用の水中呼吸器;もと商標名)
remoteness	よそよそしさ|遠く離れていること|遠隔|疎遠|他人行儀
togetherness	連帯感
sulk	すねる(こと)
balmy	さわやかな|芳香の|香りの良い|快い
podiatrist	足病医
senescence	老化|老齢|老境
unimpressed	感動しない
ravenous	飢えきった
elution	溶出
camphor	樟脳/ camphor tree 楠(クスノキ)|樟(クス)
savagery	野蛮(未開)状態|凶暴性|残忍|野蛮な行為|蛮行
nuthatch	ゴジュウカラ(ゴジュウカラ科の短い尾の鳥)
coming	来たるべき|次の
prokaryotic	原核生物の|核膜を持たず|明確な輪郭をもった細胞核の見られない細胞からなる生物
weeknight	〈C〉平日の夜
prankster	いたずら者|ふざけ屋|ふざけ者
naturism	自然崇拝説|裸体主義
jettison	船外投棄|捨てる
tearful	涙ぐんだ
betwixt	《古・詩》=between
unmistakably	紛れもなく
postsynaptic	シナプス後の
heterologous	異種の
dyspnea	呼吸困難
thunderous	極めて不吉な|轟き渡る|非常に大きな|雷が来そうな
fabulously	途方もなく
overblown	ふくれあがった|誇張された|大げさな|(花が)満開を過ぎた
claymore	16世紀スコットランド高地人が用いた両手で使う両刃の剣
hyphenation	ハイフネーション(ハイフンでつなぐこと)
toleration	寛容|黙認|信仰の自由
individualist	個人主義者
wiggly	波状の
genocidal	大量虐殺の cf|genocide
intravascular	血管内の
furlough	(fˈɚːloʊ)(軍人・公務員などの)賜暇(しか)休暇|Ex|two weeks' furlough 2週間の賜暇休暇
velveteen	ビロード製の(衣類)|綿ビロード(の)|別珍(の)|ベッチン(の)
nonpayment	(〜の)不払い|未払い《+『of』+『名』》
tricot	トリコット(一種のうね織り);(毛糸・レーヨンなどの)編物
corrigendum	(印刷物の)誤植|正誤表
vasodilator	血管拡張剤
daybook	日記|(簿記の)取引日記帳
inexhaustible	無尽蔵の
clothesline	物干しロープ
canny	抜け目のない
parabola	放物線
pianoforte	=piano
telephonic	電話の|電話による
firmament	(文語) 大空|蒼穹(そうきゆう)|天空
scuffle	乱闘する|取っ組み合う|もみ合い
ribonuclease	リボヌクレアーゼ|(=Rnase)|リボ核酸を分解する反応を触媒する酵素|ヌクレアーゼの一種|あらゆる生物に遍く存在する酵素
taiga	タイガ(亜北極地の常緑針葉樹林)
cerulean	空色|空色の
bilberry	コケモモ(ヨーロッパ下部山岳地の低木)|その実
interrelationship	相互関係
thoroughness	徹底|完全
goldfinch	ゴシキヒワ(欧州産の鳴き鳥)
inborn	先天的な|生まれつきの
weeklong	一週間
levitate	浮揚する
newness	新しさ
bearable	耐えられる
uninspired	退屈な
pigskin	〈U〉豚の皮;豚のなめし皮|〈C〉《米話》蹴球のボール(football)
russet	小豆色|朽葉色(の)|あずき色
specie	(紙弊に対した)正金|正貨
krill	オキアミ
hothouse	温室栽培の
milkweed	乳液を出す植物
encircle	取り巻く
patella	=kneecap
skein	(糸を巻く)かせ|(ガンなど飛ぶ鳥の)群れ|もつれ|混乱
nonhuman	ヒト以外の
mettle	血気|気質|勇気
moldy	かび臭い(musty)
relegation	左遷(させん)|格下け;委託
couplet	(詩の)対句|カプレット
placket	(スカート・ドレス・ブラウスなどの)わきあき
devalue	の価値を下げる
arthropod	節足動物
levodopa	=L-dopa
foretell	予言する
lysate	ライセート|溶菌液|溶解質|溶解物|溶血物
bigoted	頑固一徹の
discordant	調和しない
rationalist	合理主義者|純理論者
replaytv	リプレイTV
proteolysis	タンパク質分解
oriel	(壁から外に突き出た)張り出し窓|出窓
forbear	(〜を)『我慢する』《+『with』+『名』》|(〜することを)『差し控える』《+『from』 do『ing』》|〈他〉《forbear to do=forbear doing》(〜すること)‘を'『慎しむ』|差し控える
resorption	吸収
malady	病気|弊害|(社会的)混乱
antimatter	反物質
electromagnetism	電磁気;電磁気学
brahmin	教養人|インテリ
quinine	キニーネ|キンコナ(キナ)の皮から抽出された苦いアルカロイド|マラリアの特効薬(a bitter alkaloid extracted from chinchona bark)
pedophilia	小児性愛
wayfarer	旅人|(特に)徒歩旅行者
beanstalk	豆の茎
liberalize	自由化する|寛大になる
grog	アルコール飲料|酒類|酒|ビール|安物のワイン|グログを飲む
paleontologist	古生物学者
flume	(水の流れる)深くて狭い谷|狭谷|(木材運搬・水力供給などのための)人工水路|とい式水露
immunosuppression	免疫抑制
convexity	凸状|凸面[体]
resentful	憤慨している
complementation	相補性
saintly	気高い|徳の高い|高徳な|仏様のような|聖人のような|聖徒らしい|聖人に適した
endoscope	内視鏡(内臓や内腔器官を検査する器具)
aught	《古・詩》 何か|何でも; あらゆること|少しも|どの程度にもせよ|零|ゼロ; 《古》 無
gangland	暗黒街
spatter	(〜に)〈水など〉‘を'はねかける|まく《+『名』+『on』+『名』》;(水などを)〜‘に'まく《+『名』+『with』+『名』》|〈水などが〉〜‘に'はねかかる|(〜に)〈水などが〉はねる|〈雨などが〉パラパラ降りかかる《+『on』(『into』)+『名』》|はねかける(はねる)こと|(雨などの)パラパラ降りかかる音《+『of』+『名』》|はね|(はねてついた)しみ;(〜のはねた)汚れ《+『of』+『名』》|《a ~》(〜の)少量|少数《+『of』+『名』》
nonfat	無脂肪
grubby	うじがわいた|汚い
comport	身を処する|ふるまう
soliloquy	(複数形-oquies) ひとり言(を言うこと)|(劇などの)独白
tamp	詰める|火薬などを詰める
repairman	修理工
telepathic	テレパシーの
transaminase	アミノ基転移酵素
readjustment	再調整
melange	寄せ集め|混合体
hoopla	輪投げ|大騒ぎ
trilateral	三辺の|三者から成る|三辺形
vacuolar	(生科学)|空胞|液胞|空胞の
quarterfinal	準々決勝
ureter	尿管(じん臓から膀胱(ぼうこう)に尿を送る筋肉質の管)
kindle	アマゾンが発売する電子書籍リーダー
palindrome	回文(前から読んでも後ろから読んでも同じ語|例|Madam|I'm Adam|)
aftertaste	後味|余韻
deceiver	詐欺師
abrogate	(法律などを)廃止する|捨てる
broomstick	ほうきの柄
knave	男の召使い|悪者|悪党
booger	のやつ|鼻くそ
immunogen	免疫原
cluck	鳴き声
refuel	に燃料を補給する
psychosomatic	精神治療学の
kidnapping	誘拐
frictional	摩擦の|摩擦によって起こる
loach	ドジョウ (ゴキブリはroach|cockroach)
philately	切手収集|切手研究
repairable	修理できる|元どおりにできる|回復できる
prefectural	(フランス・日本などの)県の|府の
loathsome	ひどくいやな|忌まわしい
abduct	誘拐する
overhear	ふと耳にする
althea	ムクゲ(植物)
woodblock	木版[画]|(床材用などの)木[目]タイル
skinless	皮のない;皮をむかれた
sauerkraut	ザウアークラウト(塩漬けにして発酵させたキャベツ)
instigator	扇動者
muskrat	マスクラット(北米産のビーバーに似たネズミ科の動物)
stealthy	密かな|一目を盗んだ|ひそやかな
fertilize	肥やす|豊かにする|受精させる|受胎させる
upswing	(経済)上昇|上向き
hooligan	ごろつき|悪党|不良|よた者|与太者
gunnery	砲術|(集合的)銃砲
dyspepsia	ディスペプシア(消化不良|病名)
digestible	消化できる
pyrolysis	(有機化合物の)熱分解
apologist	弁証家|弁明者|擁護者|弁解者|言い訳がましい人
gynecologist	婦人科医
tomboy	おてんば娘
candidly	率直に
honorably	名誉となるように|りっぱに
shifty	やりくりのうまい
attentional	注意の
attractant	引きつける物|誘引物(剤)
footbridge	歩行者専用橋
dilate	広げる|膨張させる|敷衍する|詳しく話す
massless	(物質が)質量のない
intimation	暗示|通告
lemming	レミング(極地帯に住む小型のネズミ|大量繁殖で有名)
laminin	ラミニンは細胞の基底膜を構成する巨大なタンパク質|多細胞組織構築と維持|細胞増殖を促し|がん細胞と関係が深い
neurotoxicity	神経毒性
lipopolysaccharide	リポ多糖(LPS)|グラム陰性菌細胞壁外膜の構成成分で|脂質と多糖からなる糖脂質である|LPSは内毒素(エンドトキシン|Endotoxin)で|他生物の細胞に影響を与える
cyanobacteria	シアノバクテリア(藍色細菌)|藍藻とも呼ばれる真正細菌|光合成で酸素を生み出す|27億年前のストロマトライトの縞状鉄鉱層は酸素を作るシアノバクテリアの出現を示す
geostationary	(衛星が)静止軌道に乗っている
insurable	保険がつけられる
obstinate	頑固な|stubborn|しつこい|病気が難治の|強情な
earthwork	土塁|土工作業
retinoblastoma	網膜芽細胞腫
serology	血清学
buttock	お尻(の肉)|しりの片方
gregarious	群生した|群居性の|集団の|社交的な|(植物)群生する
torrential	激しい|急速な|圧倒的な
farmstead	(土地・建物を含めた)農場
missus	妻|細君|女房|あんた|おかみさん|ガールフレンド
inconsiderate	察しのない|思いやりのない|礼儀作法を心得ない|思慮分別のない|軽率な
scamper	すばやく走る|疾走|素早く走り回る|(子供や動物が)跳ね回る|大急ぎで走る|疾走する
hokey	変に感傷的な
endocytosis	エンドサイトーシス|飲食細胞運動|形質膜陥入
warlike	戦闘的な|戦争の|軍事の|好戦的な
posthumously	死後に
geode	晶洞(どう)石
suet	スエット|料理用の脂(牛|羊など)
barbarous	野蛮な|粗暴な|未開の
runabout	小型のオープンカー|小型モーターボート|小型飛行機|走りまわる子供|浮浪者|うろつき回る人
eggnog	卵酒
anther	葯(やく)|雄しべ(stamen)の一部で|花糸の上端にあり花粉(pollen)をつくる袋状の器官
scrapie	羊海綿状脳症
mufti	(通常は軍服など制服を着ている人たちの)平服|服
quadrilateral	四辺(角)形の|四辺(角)形
confucian	孔子の|儒教の|儒者
demean	(人の)品位を落とす|ふるまう
purist	純正主義者
freestone	種離れのよい果実(ある種のモモ・スモモなど)|軟石(石目がなく)切り出しやすい岩石|種離れのよい