vaporizer	a device that puts out a substance in the form of a vapor (especially for medicinal inhalation)
clack	かたっという音|(crackひび|clackカタッという音)
hotbed	温床|(罪悪などが)育つ場所
prepackage	〈食品など〉‘を'販売前に包装する
stilwell	スティルウェル
pumice	軽石|〜‘を'軽石で磨く
tannery	なめし革工場|皮なめし|皮なめし工場
extravagance	浪費|濫費
indium	インジウム(金属元素)
psychopharmacology	精神薬理学
uncoated	not having a coating; "uncoated paper"|not having a coating
polarisation	分極化|偏光
aback	後ろに
narrate	を順序だてて話す|物語る
scaly	うろこ状の|鱗の|(scary恐ろしい|と混同注意)
esker	(geology) a long winding ridge of post glacial gravel and other sediment; deposited by meltwater from glaciers or ice sheets|a long winding ridge of post glacial gravel and other sediment|deposited by meltwater from glaciers or ice sheets
encroach	に侵入する|侵害する|侵入する
amniotic	羊膜の
fantastically	異様に|空想的に|《話》とてもすばらしく
gantry	信号橋(鉄道線路をまたいで架設された信号台)|ガントリー(クレーンを移動させるための陸橋型の鉄枠)|ミサイル発射(組立作業)台
profusion	豊富|おびただしいこと|大量|贅沢|乱費
lithology	岩石学|結石学
oka	a Turkish unit of weight equal to about 2.75 pounds|a Turkish liquid unit equal to 1.3 pints|South American wood sorrel cultivated for its edible tubers
physiologist	生理学者
unordered	not arranged in order|not arranged in order hierarchically
impinge	侵害する|ぶつかる|突当る|打つ|突き当たる|衝突する
pretence	見せかけ
figuratively	比喩的に
ngultrum	ニュートラム
sorceress	女魔法使い
plait	ひだ|弁髪|編んだもの|プリーツ|を編む
aggressiveness	侵略的なこと|積極性
lioness	雌のライオン|雌じし
oscillatory	振動する
footwork	フットワーク
unconsciousness	無意識
dama	fallow deer
guacamole	グアカモーレ(メキシコのアボカド料理)
dishonor	に屈辱をあたえる
glutamic	グルタミン酸の|グルタミン(glutamine)はアミノ酸の一種
reactivation	再活性化
enslave	をとりこにする|を奴隷にする
heartwood	(材木の)心材|赤身
incipient	発端の|始まりの|初期の
omeprazole	オメプラゾール
scintillation	シンチレーション|きらめき|ひらめき|火花|閃光
sidecar	(オートバイの)サイドカー|側車
exclusionary	排他的な
abutment	迫持(せりもち)受け(建物の弓形門(arch)の両端を受ける部分)
brindle	having a grey or brown streak or a pattern or a patchy coloring; used especially of the patterned fur of cats|having a grey or brown streak or a pattern or a patchy coloring|used especially of the patterned fur of cats
amiss	間違って
lemongrass	レモングラス|レモングラス
timekeeper	計時係|時計
predate	以前にさかのぼる
cavernous	洞窟の多い|小さなくぼみの多い
carib	a member of an American Indian peoples of northeastern South America and the Lesser Antilles|the family of languages spoken by the Carib
scoreless	無得点の
serf	農奴|奴隷
seismology	地震学
taurine	タウリン|タウリン
pluralistic	多元論的
impropriety	不適当
protectionism	保護貿易主義
arraignment	罪状認否手続き|非難|糾弾|被告の罪状認否
phenobarbital	フェノバルビタール(鎮静・催眠に用いる薬品)
chickenpox	水痘
photochemical	光化学の
livid	かんかんに怒って|激怒して|鉛色の
distasteful	嫌気のさした|不快な|いやな味がする|気にくわない
distinctively	区別して|示差的に|特徴的に|独特に|弁別的に
synchronizer	同期装置|シンクロスコープ|同期検定器
pokey	poky|牢獄|ブタ箱
bravado	空威張り|からいばり
raving	declaiming wildly; "the raving of maniacs"|declaiming wildly|in a raving manner; "raving mad"|in a raving manner
childless	子供のない
asana	浅名
lymphedema	リンパ浮腫
lavishly	惜しげなく|気前よく
forthright	率直な|率直に
sarin	サリン(毒ガスの一種|地下鉄サリン事件で使われた)
engraver	彫刻師|彫版工|製版者
tibial	relating to or located near a tibia
flaxseed	亜麻仁
stomper	someone who walks with a heavy noisy gait or who stamps on the ground
cadastre	地籍台帳
encrust	覆う
whopper	すごくでかい物|大ぼら
timekeeping	the act or process of determining the time
supremacist	至上主義者
trickery	詐欺
allograft	同種移植片
adherent	固守する|付着性の|付着した|関係した|加盟した
kierkegaard	キルケゴール
frock	(frάk)|(農夫･労働者のゆったりした)仕事着|(そでが広くすそたけの長い)修道士の服|僧服|フロック(婦人･子供用のワンピースのドレス)|男性用フロックコート
unsold	売れていない|売れ残りの
vindication	擁護|(主張･行動などの)弁護|立証|証明|立証するもの|弁護するもの
nosebleed	鼻血
chatty	おしゃべりの
rheology	流動動学(物質の変形と流動を扱う科学)　レオロジー
encumbrance	妨害|障害|厄介もの|重荷|不動産の負債(抵当権など)
forehand	フォアハンド|上位|前位|前打ち|馬体の前部|優位|最前部の|先頭の|前の|前方の
imperfection	不完全
fluorescein	フルオレセイン|顕微鏡観察に用いられる蛍光色素の一種|他に色素レーザーの媒体|法医学における血痕の探索|色素追跡用などに広く利用される
sorrowful	悲しい|悲しんでいる|悲しげな
wingman	the pilot who positions his aircraft outside and behind (on the wing of) the leader of a flying formation
celebratory	祝う
timepiece	計時器
scythe	大草刈り鎌|草刈りがま|戦車がま
particularity	特別|特殊性|詳細|入念|気むずかしさ
loveable	(=lovable)|愛らしい|愛すべき
unchanging	不変の
urethral	尿道の
glycosylation	グリコシル化|タンパク質もしくは脂質へ糖類が付加する反応で|糖鎖付加とも言う
oratorio	聖譚(せいたん)曲(聖書に題材を取った宗教音楽劇)
rustle	衣擦れの音をさせる|活発に動く|さらさらという音(を立てる)|手早く手に入れる
crematory	火葬場|火葬炉
chickpea	ヒヨコマメ
wedlock	結婚生活|婚姻|結婚状態
mandrel	マンドレル
erstwhile	昔の|いにしえの|かつての
daffy	間抜けの|気違いじみた|silly|crazy
soph	=sophomore
obtuse	鈍い|鈍感な
tappan	タッパン
caudal	尾の|尾状の
sextet	六重唱曲|六重奏曲
nub	要点|核心|しん|結び目|the nub of the matter問題の核心|(小さなかたまり)
sternly	厳格に
disbelieve	信じない|疑う
debunk	正体を暴露する|すっぱ抜く
indecency	わいせつ|みだら
nitroglycerin	ニトログリセリン
roadblock	(路上の)バリケード|障害物
protozoan	原生動物(の)
suffocation	窒息
towner	a resident of a town or city
telepathy	テレパシー|精神感応(術)
tugboat	タグボート|引き船
stalling	時間稼ぎ
retinoic	レチノイン酸(Retinoic acid)|ビタミンA(レチノール)の代謝物質|成長や発達に必要なビタミンAの機能を媒介する|脊椎動物にとって必須の物質
lawlessness	無法状態
clonidine	クロニジン
pyrene	ピレン|ピレン
beadwork	ビーズ細工(飾り)
postmortem	死体解剖|検死|死後の
larch	カラマツ(黄葉の美しい落葉高木)|カラマツ材
hake	メルルーサ(魚の種類)
prefrontal	前頭葉前部の
cliffhanger	はらはらさせるもの|はらはらする試合
situs	あり場所|位置|(部分・器官の)正常な位置|原位置
impatiently	いらいらして
physio	=physiotherapist
riffle	(川の)浅瀬|さざなみ(を立てる)|(トランプ)リフル(する)(札を二つに分け交互に重ねて切る)|ぱらぱらめくる
baptize	に洗礼を施す|洗礼する
rubberize	coat or impregnate with rubber; "rubberize fabric for rain coats"|coat or impregnate with rubber
discotheque	ディスコ
inequity	不公正|不公平
drove	家畜の群れ|driveの過去形
pandemonium	悪魔の巣窟|大混乱(の場所)|地獄
transgress	(罪を)犯す|(制限など)を越える|逸脱する|に違反する
cloisonne	七宝(しっぽう)細工|七宝焼
byway	わき道
playpen	ベビーサークル
typewrite	〜‘を'タイプライターで打つ|タイプを打つ|タイプする
aphasia	失語症
cohosh	a plant of the genus Actaea having acrid poisonous berries
irreplaceable	かけがえのない|替えがきかない|代わりがきかない
fanaticism	狂信(的な行為)|熱狂
dressmaker	婦人服洋裁師
fescue	ウシノケグサ(牧草・芝用の植物)
schoolteacher	先生
godsend	天の与え|神の賜物|思いがけない幸運
counterclockwise	時計と反対方向に|左回りの
swoosh	シューッという音(を立てる|を立てて吹き出す･移動する)|勢いよく動く(ほとばしり出る)
jaunt	遠足|苦しい旅|遊山旅行|遠足をする(=excursion)
utero	胎内で
boatman	(貸し)ボート屋|ボートのこぎ手|ボート商人|舟子|船頭
presage	前兆する|前兆
aerator	通気装置|(穀物の)煙消毒装置
implausible	信じがたい|本当らしくない
outrageously	乱暴に
fentanyl	フェンタニル(中枢神経系に作用し|中毒性ある吸入性麻薬性鎮痛薬|商品名)
vestibule	玄関
unrestrained	抑制のない|無制限の|気ままな
triennial	3年続く|三年ことの|3年ごとの行事|3年目の幾念日
puffer	フグ(=pufferfish)|ぷっと吹く人(物)|お世辞屋|(競売の)さくら|汽車ぽっぽ|心臓|葉巻
asteraceae	キク科
punter	(小口)相場師|投機筋|消費者|客|観客|読者
dualism	二元論|デュアリズム
brae	《スコットランド》丘の側面|山腹
atrazine	アトラジン
indicia	(料金別納郵便物などの)証印
headrest	ヘッドレスト|ヘッドレスト
groundfish	底魚
gyration	旋回|回転
swash	(水などが)バシャッ(ザブン)という音|〈水など〉‘を'パシャッ(ザブン)とはねかける|(波などが)打ってバシャッと音を立てる
armistice	休戦|停戦(条約)
grenadier	擲(てき)弾兵(昔|手りゅう弾を投げる任務をもっていた兵士)|《Grenadier》《英》近衛(このえ)歩兵第1連隊の兵
brainwave	《しばしば複数形で》脳波|〈C〉《おもに英話》ひらめき|妙案
sacramental	聖礼典の
emissary	密使|特使|スパイ
astragalus	距骨|距骨
copayment	患者負担金
inoperative	効力がない
forlorn	見捨てられた|みじめな|絶望した|孤独な|よるべのない
apologetic	わびて|謝って
absolution	(法律)免除|無罪|放免|釈放|免罪|(キリスト教)absolution from (of) sins 罪の赦免
vancomycin	バンコマイシン|真正細菌の細胞壁合成酵素を阻害し増殖を防ぎ|大半のグラム陽性菌に殺菌作用をもつ|黄色ブドウ球菌(MRSA)も殺し最強の抗生物質とされた
fluidity	流動性
inordinate	過度の|法外な|乱暴な|無節制な
gooseberry	西洋スグリ(小さな丸い緑の実をつける)
individualistic	個人主義の
metical	メティカル
racehorse	競走馬
quantile	変位値|分位点|(統計の代表値の一種)
aliphatic	having carbon atoms linked in open chains
monochromatic	単色
distill	蒸留する
artemisia	クラムヨモギ
evermore	常に|とこしえに
flyfish	fish with flies as lures
ruble	ルーブル(ロシアの通貨単位)
clatter	がたがた(する)
viticulture	ぶどう栽培
shinto	the native religion and former ethnic cult of Japan|the ancient indigenous religion of Japan lacking formal dogma; characterized by a veneration of nature spirits and of ancestors|the ancient indigenous religion of Japan lacking formal dogma|characterized by a veneration of nature spirits and of ancestors|relating to or characteristic of Shintoism; "Shinto temples"|relating to or characteristic of Shintoism
questioner	質問者|尋問者
disjunction	分離|離接|分裂|論理和
subsequence	結果|後|次|続いて起こること|続き|部分列
neurosurgeon	脳神経外科医
heckler	妨害する人|総会屋
platen	プラテン(印刷機・タイプライターのローラー)
callable	subject to a demand for payment before due date; "callable bonds"|subject to a demand for payment before due date
copter	《話》=helicopter
chartreuse	シャトルトルーズ(薄黄緑色のリキュール酒)薄い黄緑色|薄い黄緑色の
acolyte	侍祭|アコライト|侍者
recompense	に返礼する|に報いる|報酬|を償う|返報
firstborn	長子(の)
circumvention	裏をかくこと|迂回;回避
infinitive	(文法)不定詞
bareboat	a vessel (such as a yacht) that can be chartered without a captain or crew or provisions
perfectionist	完全論者
puzzler	難問|困らせる質問;困らす人
exude	(汗など)にじみ出る|発散する
axillary	腋窩(えきか|両腕の付け根の窪み )|腋のヨミは「ワキ」
stockman	牧畜業者|在庫品係|倉庫係
recluse	隠遁した|世捨て人
uzi	ウジ
maximally	最大限に
regionalism	地域的特質|地方主義|方言
sweepstake	=sweepstakes
noddy	クロアジサシ(熱帯に棲む鳥の一種)|ばか者|あほう
paltry	つまらない|けちな
anchorman	(ニュース番組の)総合司会者|ニュースキャスター
carelessness	不注意
globin	グロビン
largemouth	ラージマウスバス|大口バス
sextant	六分儀|(ろくぶんぎ|天体や物の高度|水平方向の角度を測るための道具)
goulash	グーラシュ(ハンガリー風の濃厚なシチュー)
craziness	狂気
refurbish	みがき直す|一新する
scrumptious	優美な
devolve	譲渡する|移す|しだいである|depend
categorisation	口分け|仕訳|部別|類別|カテゴリー化|種別|分別|分類|部分け|口分|類別|種別|分類|内訳|区分け|区分|格付け|区別|口分け|仕訳|部別|類別|種別|分別|分類|部分け|仕分け|区分け
thrombocytopenia	血小板減少(症)
keratin	ケラチン
suspenders	サスペンダー(通常複数形)
haemorrhage	出血|大量流出
quickness	機敏|迅速|性急|速さ|短気|敏捷
loopy	愚かな
leal	忠実な|誠実で本当の(faithful and true)
berserker	ベルセルク
serological	血清学
infatuation	夢中|のぼせあがり|心酔|夢中にさせるもの
christen	洗礼を施す|洗礼名をつける
reintroduction	再び導入
neosho	ネオショ川
nought	(主にUK)完全な失敗|ゼロ|無価値|滅びた|零(=naught)
frenetic	逆上した|熱狂的な
postural	体位の
toasty	トーストの
brainy	頭のいい
amorous	恋愛の|好色な|なまめかしい
notifiable	(伝染病など)届け出ねばならない
fascinate	(人)を魅惑する|夢中にさせる
revitalise	give new life or vigor to
vagueness	曖昧さ
spaceman	宇宙飛行士(=astronaut)
aspirant	熱望を抱く人
ribonuclease	リボヌクレアーゼ|(=Rnase)|リボ核酸を分解する反応を触媒する酵素|ヌクレアーゼの一種|あらゆる生物に遍く存在する酵素
scabbard	(刀の)さや
conquistador	征服者|16世紀にメキシコ･ペルーを征服したスペイン人
monoamine	モノアミン
dialectical	=dialectic|《廃》=dialectal
prospectively	将来に向かって
revocable	capable of being revoked or annulled; "a revocable order"|capable of being revoked or annulled
seamstress	お針子
rosin	(rάzn)ロジン|松やにからテレピン(テレビン)油turpentineを蒸留した後の残留物|松やにそのもの(=resin)
flatly	きっぱりと|元気なく|単調に
cockatiel	阿亀鸚哥
malleable	打ち延ばしできる
hydrocephalus	水頭症|脳水腫
ecru	=beige
episcopalian	米国聖公会の
indecision	優柔不断
candidiasis	＜candida|カンジダ症
unselfish	無欲な|利己的でない|無私の|利他的な
whetstone	と石
souffle	スフレ(卵の白身･ミルクなどをふくらまして焼いたもの)
savoury	風味のある|香りのよい|楽しい|味わいのある|模範的な|りっぱな
shem	セム
reticle	a network of fine lines, dots, cross hairs, or wires in the focal plane of the eyepiece of an optical instrument
rainmaker	レインメーカー|人工降雨専門家･科学者|(魔術で)雨を降らす人
stirrer	騒ぎを起こす人
publically	大っぴら|公然と|晴れて
genial	温暖な
cachet	封印|公認の印|品質保証表
steeplechase	障害物競争(陸上競技名)|障害物競馬
unsurprisingly	当然
langmuir	ラングミュア
seaway	航路|航行|(外洋船の航行できる)河川航路|荒海
racoon	=raccoon
salix	a large and widespread genus varying in size from small shrubs to large trees: willows
gatefold	(雑誌などの)折り込みページ
nutritionally	栄養的
obverse	(貨幣・メダルなどの)表側;(一般に)表面|表面の;表向きの
infamy	悪名|不名誉|汚名|醜行|非行
dapper	小粋な身なりの|こざっぱりした|小柄できびきびした
belfry	鐘楼
baldy	薬罐
conic	円すい[形]の
odious	いやらしい|醜悪な|憎むべき
plier	someone who plies a trade
fabricator	製作者|ほら吹き;(文書などの)偽造者
forename	(姓に対する)名(first name)
monophosphate	一リン酸塩|食品添加物ほかに使用される
dextrose	右旋糖|ブドウ糖
parapsychology	超心理学(テレパシー・精神感応術などの研究部門)
launchpad	発射台
laudable	賞賛に値する|あっぱれな
catabolism	(生物)|カタボリズム|異化作用|物質分解代謝
luminal	管腔の|内腔の
cosmonaut	宇宙飛行士
violoncello	チェロ|セロ(cello)
omnipresent	遍在する
stealer	盗む者|どろぼう
barony	男爵の位|男爵領
gesundheit	(くしゃみをした人に)おだいじに（ドイツ語）;(乾杯などで)健康を祝して
creche	《英》保育所|託児所|《米》(クリスマスに飾る)キリスト降誕の情景を表した彫刻(《英》crid)
inconsequential	連絡のないこと|とるに足らない|論理的でない
insensitivity	無神経
pipet	ピペット
renunciation	(権利･要求などの)放棄|断念
apostate	背教者|変節者|転向者|脱党者
tanager	フウキンチョウ(風琴鳥)(米国産の羽毛の美しい小鳥)
headshot	ヘッディングシュート|ヘッド|ヘッドシュート|ヘディングシュート
pessimist	悲観論者|厭世家
abdicate	を捨てる|(正式に)放棄する|退位する
serviceability	役に立つこと|実用性|徳用
banal	平凡な|陳腐な|凡庸な
spectrophotometer	分光光度計
transportable	伝達性
uncooked	料理してない|生の
wintergreen	ヒメコウジ|冬緑樹|冬緑油(の香味)
peculiarly	独特に|特に|奇妙に
beadle	教会区典礼部役員(昔教区の雑事などをした役人)|(英国の大学の)職権標識奉持役(大学の行事に際して標識を持って先導する)
lox	鮭の薫製|スモーク･サーモン
bowtie	ちょうネクタイ
theosophy	神知学|接神教(黙想や直感により神知を得ようとする)
deface	の外観を損う
nonfatal	致命的でない
misalignment	誤整列
perusal	精読
childlike	子供らしい
patrician	(古代ローマの)貴族(の)
shamelessly	臆面もなく
specialism	専門|専門|専業|專門
nmol	ナノモル|濃度を表す方式|溶液1L中の溶質をモル数を使って表した単位が1mol/Lで|その10(-9乗)mol=1nmol|(nmoleも使用)
contrarian	(多くの人が株を売れば自分は買い|買えば自分は売るような)反対意見の人
bandicoot	フクロアナグマ(長いつめを持つオーストラリアおよびニューギニア産の有袋動物)
shh	シーッ|しゃべるな
brotherly	兄弟の|親密な
envelop	を覆い隠す|を包む
uninhabited	無人の
decoupage	紙・プラスチックなどの切り抜きを使った装飾法
demonstrably	明らかに
sunfish	マンボウ|翻車魚
unbelief	信じないこと|不信仰
urinalysis	検尿
maintainability	継続(維持)が可能であること|扶養できること|主張(断言)できること
nectarine	ネクタリン
councilwoman	(女の)市(町)農議員
transference	(感情の)転移
arjuna	アルジュナ
pliable	成形しやすい|柔軟な
inevitability	避けられないこと|必然性|やむを得ないこと
wimpy	弱虫の
maser	メーザー(マイクロ波増幅器)
micrograph	顕微鏡写真
lucite	a transparent thermoplastic acrylic resin
rafter	たるき|いかだ師|いかだ乗り|(建築)たる木|屋根のたるき
tarragon	タラゴン;タラゴンの葉(芳香がありサラダなどの香味料として用いられる)
perceptible	認知できる|知覚(認知)できる|かなりの
flotilla	小艦隊|小型船隊
proletarian	プロレタリアの|無産階級の|労働者階級の
twang	びーんと鳴る|鼻にかかる音
olivine	かんらん石
elapse	時が経過する|過ぎ去る|経過
desegregation	人種差別廃止
megahertz	メガヘルツ
goodly	りっぱな|きれいな|(数量など)相当の
philosophically	哲学的に|達観して|哲学者的に|賢く|冷静に
protester	抗議する人|抗議者|抗議団体|異議を申し立てる人|主張者
gestapo	ゲシュタポ
bouillon	ブイヨン|ブイヨンスープ|肉汁
canasta	カナスタ(カードゲームの一つ)
axiomatic	公理の(ような)|自明の
celibacy	独身|独身生活|独身主義
folie	精神的疾患
inkling	ほのめかし|うすうすと感づくこと
biochemist	生化学者
arrondissement	フランスの区|郡
narcissist	自己陶酔者
decathlon	十種競技
anthill	あり塚
extractive	抽出する|抜き取る|引き出す;抜粋的な
falstaff	フォルスタッフ
bureaucrat	官僚
generically	一般的に
unchallenged	問題にされない|挑戦されない
classicism	古典主義
spiritualism	精神的特質|降神術
gapped	ギャップ
gish	ギッシュ
crewman	乗組員|乗務員|搭乗員
secondment	賛成|賛同
rouser	someone who rouses others from sleep
phthalate	フタル酸エステル
honeypot	South African shrub whose flowers when open are cup-shaped resembling artichokes
demonize	悪者扱いする|悪魔化する
icbm	ICBM|大陸間弾道弾|大陸間弾道ミサイル|ＩＣＢＭ
leatherette	模造革
telecaster	a television broadcaster
materialist	唯物主義者|実利主義者
unanimity	一致|合意
biogeography	生物地理学(生物分布の研究)
educationally	教育的
internalize	吸収する|自分のものにする|習得する|内面化する|内面的にする
erythema	紅斑(こうはん)(炎症などにより皮膚が異常に赤くなること)
grisly	容赦のない
fornication	未婚や夫婦でない男女の性交渉|密通
figural	比喩的
sassafras	サッサフラス(北米産クスノキ科の植物)|その根皮(強壮剤･香料)
ornithine	オルニチン
agronomic	of or relating to or promoting agronomy
fluorouracil	フルオロウラシル
fibronectin	フィブロネクチン(血液や細胞の外表層にある繊維状の接着性糖タンパク質)
debarment	除外;禁止|防止
tracheal	気管の
rightwing	右翼(保守)党員|右派の人々・右翼政党|保守党|(政党などの)保守派|右派
irate	怒った|怒りに駆られた
partisanship	党派心
schrodinger	Austrian physicist who discovered the wave equation (1887-1961)
wean	(赤ん坊を)離乳させる|(母親･乳房から)引き離すwean a baby from the breast
sitar	シタール|インドの弦楽器
milepost	(ある場所との距離を示した)マイル標|里程標
pushy	押しの強い
brogan	くるぶしまである作業靴
sheaf	束|を束にする
herm	a statue consisting of a squared stone pillar with a carved head (usually a bearded Hermes) on top; used in ancient Greece as a boundary marker or signpost|a statue consisting of a squared stone pillar with a carved head (usually a bearded Hermes) on top|used in ancient Greece as a boundary marker or signpost
lazuli	ラピスラズリ
nihilism	虚無主義|ニヒリズム
splurge	誇示する|収入以上の金を使う|贅沢にふける|散財する|大きな顔をしている|のけぞり返っている|贅沢三昧をする
thorium	トリウム(金属元素;化学記号は『Th』)
posthumous	著者の死後に出版された|父の死後に生まれた
hairline	非常に細い線|はえぎわ|わずかの差
bathymetry	measuring the depths of the oceans
skagway	スカグウェー
conger	アナゴ(食用の魚)
indoctrination	(学説・原理・イデオロギーなどを)教えこむこと|教化
monopolize	独占する
jobcentre	公共職業安定所
middleweight	ミドル級選手(ボクシング・レスリング・重量あげの体重147‐160ポンド(66‐72kg)の選手)|平均体重の人
awl	(靴屋などの)突きぎり
opportunist	日和見主義者
dingy	薄汚い
ascetic	禁欲主義の|苦行の|苦行者の|禁欲的な|修行僧|修道僧|禁欲者|隠者
earache	耳痛
mackinaw	a short plaid coat made of made of thick woolen material
undesired	望まれない
clunky	不細工な|ぶざまな|かっこ悪い|さまにならない
neurodegenerative	神経変性の
euphoric	幸福感にあふれた|多幸症の
redeployment	the withdrawal and redistribution of forces in an attempt to use them more effectively
ridgeline	リッジ|山の背|尾根|稜線|山稜
reverberate	反射する|反響する|声が鳴り響く|反響させる
ledbetter	レッドベター
longbow	大弓|長弓
tyrannical	専制的な
infinitesimal	極小の|非常に小さい
nanosecond	10億分の1秒
buckaroo	やっこさん|奴|男|カウボーイ
fishbowl	金魚鉢
rollerblade	(trademark) an in-line skate|an in-line skate|travel on shoes with a single line of rubber wheels attached to their soles; "you'd better wear a helmet and knee protectors when you Rollerblade!"; "The muscular actor loves to Rollerblade"|travel on shoes with a single line of rubber wheels attached to their soles
receivership	管財人の職務|管財人の管理下にある状態
miniskirt	ミニスカート
telomerase	テロメラーゼ|真核生物の染色体末端テロメアの配列を伸ばす酵素|活性が低いと細胞分裂毎にテロメアが縮み分裂停止|活性抑制でのガン治療と|活性を高め細胞分裂寿命の延長で注目
footboard	(列車などの)乗降用ステップ|(ベッドの)足板|(運転手用)足載せ台
sullen	むっつりした|うっとうしい|不機嫌な|陰気な
dartboard	投げ矢遊びの標的(盤)
oestrogen	=estrogen
superficially	表面的には
cellist	チェロ奏者
refocus	焦点を再び合わせる
crone	しわくちゃ婆
capsicum	トウガラシ;その実
infeasible	不可能
thalidomide	サリドマイド|催眠鎮静薬として市販されたが|1960年代に服用した妊婦にサリドマイド胎芽症の新生児が生まれた薬害「サリドマイド禍」を起こした
landrover	ジープ
tripper	旅行者
reprehensible	とがむべき
sequent	(時間的に)次の|次に起こる|(論理的に)結果として生じる
capsid	カプシド(ウイルスのコア(芯)核酸を包む外殻)|形はRNAファージでは正二十面体|RNAウイルスではらせん構造|細胞へ吸着する部分がついている
thunk	a dull hollow sound; "the basketball made a thunk as it hit the rim"|a dull hollow sound
woofer	ウーファー|低音スピーカー|低いうなり声を出す人･動物
milkman	牛乳屋|乳しぼり人|牛乳配達人|乳絞りの男
reverberation	残響音|反響|反射|反射光|反射熱|反射炉処理|余韻
recuperate	回復する
oocyte	卵母細胞
specular	capable of reflecting light like a mirror; "mirrorlike surface of the lake"; "a specular metal"|capable of reflecting light like a mirror
okra	オクラ(植物)
sellout	売り切れ|札止めの興行|裏切り|寝返り
reassemble	再び集める
despot	専制君主|独裁者|暴君|君主
gloriously	見事に
worst	最悪の|最も悪い|最も悪く|一番悪いこと
mugger	追い剥ぎ
nevermore	二度と
oration	(特別な場合の正式な)演説|式辞|(一般的な演説はspeech)|deliver a funeral oration追悼演説をする
vibratory	振動性
sanguine	血色のよい|快活な|信じている|血色の良い|紅色の|自信のある|楽天的な
harmonise	調和|嵌る|似あう|填る|合う|填まる|適する|嵌まる|和する|一致|ハモる|ハモる|ハモる
amaretto	アマレット
shockingly	ゾッとするほど
freesia	フリージア(アヤメ科の植物で芳香性の花をつける)
hallow	〜‘を'神聖にする|神聖なものとする
potentiality	〈U〉潜在状態|〈C〉《通例複数形で》可能性;発展の見込み|将来性
beekeeping	養蜂
curlew	ダイシャクシギ(くちばしが細長く下に曲がっている鳥)
mangosteen	マンゴスチン[の実](東アジア産の植物)
cantaloupe	カンタロープ(キャンタロープ)メロン|ヨーロッパ南部|アメリカ|タイなどで露地栽培される|赤肉種のマスクメロン
bight	海岸の湾曲部|湾
steroidal	ステロイド性
noh	能|猿楽
morgen	a South African unit of measure equal to about 2 acres
stasis	均衡状態|血行停止|静止|体液流の停止|鬱滞|沈滞|停滞|鬱血
inactivate	不活性にする|不活発にする
underprivileged	恵まれない
opossum	オポッサムは有袋類オポッサム科(南北米大陸に分布)|ポッサムは有袋類フクロギツネ科(豪州|ニュージーランドに分布)|混同されやすいが別種
sharpshooter	狙撃兵|一級射手|法律の抜け穴をねらう弁護士
provera	メドロキシプロゲステロン
motorboat	モーターボート
ahab	according to the Old Testament he was a pagan king of Israel and husband of Jezebel (9th century BC)
competently	上手に|いみじくも|みごとに|旨く|立派に
miscellanea	寄せ集め
readjust	再調整する
leveler	a radical who advocates the abolition of social distinctions
prolongation	延長|延長した部分|延長形
arnica	〈C〉アルニカ(キク科の植物)|〈U〉アルニカチンキ(アルニカの花・根を原料とする打撲・捻挫(ねんざ)の治療液)
porthole	蒸気口|舷窓(ふなべりの小さな窓)
sublingual	舌下
tumult	動揺|騒動|混乱|大騒ぎ|わめき声|騒々しさ|暴動
oxytocin	オキシトシン
indict	起訴する|告発する
oxbow	牛のくびきのU字型の部分|《米》川の湾曲部
calyx	花の萼(ガク)
valour	(危険をものともしない)勇気
maisonette	メゾネット|メゾネット
mightily	強く|激しく|非常に|とっても
humiliate	恥をかかせる|侮辱する
unwieldy	ぶかっこうな
stater	any of the various silver or gold coins of ancient Greece|a resident of a particular state or group of states; "Keystone stater"; "farm staters"|a resident of a particular state or group of states
smoldering	showing scarcely suppressed anger; "her tone was...conversational although...her eyes were smoldering"- James Hensel|showing scarcely suppressed anger
tweedy	ツイード(風)の|気軽な|くつろいだ
coarsely	下品に|粗野に
paneling	羽目板
disembark	上陸させる
deserter	(義務･家族を)捨てた人|遺棄者|職場放棄者|脱走兵|裏切り者|離党者
compressible	圧縮性の|圧搾できる
azo	アゾ
topmost	いちばん高い|最高の
behest	命令|依頼
vasopressin	抗利尿ホルモン|adh
kibbutz	キブツ(イスラエルの集団農場)
reevaluate	再評価
abattoir	食肉処理場
ordain	聖職に任命する|制定する|定める|命ずる
wacko	頭のおかしいやつ|へんなやつ
symbology	記号学
weatherman	気象台員
effigy	像|肖像|彫像|人形
agee	United States novelist (1909-1955)|United States novelist (1909-1955 )
depreciate	の価値を下げる|切り下げる|価格が下がる|減価償却する|の減価償却する
sprain	くじく|捻挫|を捻挫する
haphazard	偶然|偶然の|でたらめの|無計画の
infirm	体が弱い|弱い|虚弱な|衰弱した|決断力のない|優柔不断な
quagga	クワッガ(シマウマに似た動物;南アフリカにいたが現在は絶滅)
menage	家族|一門|世帯|門|ファミリー|家門|家|家庭|家人|ファミリ
motherland	母国|発祥地
fellini	フェリーニ
indescribable	言語に絶する|言い表せない|漠然とした
materiality	物質性|有形|有相|有体性
ungraded	(of roads) not leveled or drained; unsuitable for all year travel|(of roads) not leveled or drained|unsuitable for all year travel|not arranged in order hierarchically
curtailment	切り詰め;削減|短縮
inhomogeneous	不均質
berate	しかりつける|叱責する
keyboardist	キーボーディスト
oxygenation	酸素化
gaol	=jail
excellently	ばっちり|いみじくも|見事に|立派に|素晴らしく
benediction	祝福|祝祷
burly	たくましい|がんじょうな|がっしりとした|身体の大きい
cand	遺伝子名　他
infarct	梗塞
culbertson	United States authority on contract bridge whose books helped to popularize the game (1891-1955)|United States authority on contract bridge whose books helped to popularize the game (1891-1955 )
butadiene	ブタジエン
miser	けちんぼ|守銭奴|欲張り
unfairness	不公平
moulder	=molder
psyllium	plantain of Mediterranean regions whose seeds swell and become gelatinous when moist and are used as a mild laxative
rube	田舎者|青二才|世間知らず|ばか|まぬけ|お客|見物人|新参者|新米|田舎の
poplin	ポプリン(綿・絹・羊毛・レイヨンなどの交織物)
weizmann	ワイツマン
anaphylaxis	アナフィラキシーショック|ヒトや哺乳類の急性･重度過敏症のアレルギー反応|僅かなアレルゲンが生死に関わる反応を起こすことがある
congenial	好みにあった|快適な|同様の|気心のあった
fervently	熱烈に
auroral	オーロラの|オーロラに似た|夜明け(暁)の[ような]
carboxyl	(有機化学)カルボキシル基|カルボキシル|−COOH基(the univalent radical-COOH)
lyceum	〈C〉《米》(演説・音楽会などを催す)文化運動団体|〈C〉(上記の催し物を行う)文化会館|《the『L-』》リュケイオン(アリストテレスが哲学を説いたアテネ郊外の学園);アリストテレス学派
weathervane	風見
confessor	(信仰)告白者|ざんげ者
administrate	=administer
marinate	をマリネに漬ける|マリネにする
superhuman	超人的な|神業の
entomological	昆虫学の
unlined	not having a lining or liner; "a thin unlined jacket"|not having a lining or liner
directorship	管理職
conclave	(ラテン語)コンクラーベ|カソリックの教皇(きょうこう)を決める秘密会議
humanly	人間の能力で;人力で|人間的に|人間らしく
abiotic	非生物
premix	ミックス粉
unionism	(特に)労働組合主義|《U-》(特に米国南北戦争時の)連邦主義|《英》連合主義(大英帝国時代に全属領を中央政府に統合しようとした政策)
aventail	a medieval hood of mail suspended from a basinet to protect the head and neck
initialisation	ローレベルフォーマット|ローレベルフォーマッティング
magnificence	壮大|荘厳な雰囲気
damm	(神が)罰する|酷評する|(damn!と)ののしる|間投詞的に怒り･焦り･失望を表わす|Damn it (all)!ちくしょうめ! (ダム|堰|せきはdam)
subacute	亜急性
crossroad	交差道路|十字路
waterline	(船の)喫水線
ugliness	醜さ
tinge	色合い|に薄く色をつける
shaving	ひげ(顔)そり|ひげをそること
mikado	帝(みかど)|日本の天皇
petrology	岩石学
minuet	メヌエット(17世紀フランスで始まった3拍子のゆるやかで優雅なダンス)|メヌエット舞曲
salwar	a pair of light loose trousers with a tight fit around the ankles; worn by women from the Indian subcontinent (usually with a kameez)|a pair of light loose trousers with a tight fit around the ankles|worn by women from the Indian subcontinent (usually with a kameez)
helplessly	どうしようもなく|どうすることもできず|頼るものもなく|力なく
quintessence	精髄|神髄|典型|本質
libellous	(used of statements) harmful and often untrue; tending to discredit or malign|(used of statements) harmful and often untrue|tending to discredit or malign
throe	《おもに文》激痛;(死ぬような)苦しみ;陣痛|(〜とり)苦闘《+of+名(doing)》
squander	浪費する|散財する
homebound	家に引きこもった
cropper	刈り取る人〜(特に)刈り込み機|(ある)収穫を生む作物
culminate	全盛をきわめる|最高潮(極点･絶頂)に達する|ついに～となる|終わる
fumigation	(部屋などを)いぶして消毒すること
justifiably	正当に
stupidly	ばかげたことに|愚かに(も)
reallocate	再割り当てする
occipital	of or relating to the occiput; "occipital bone"|of or relating to the occiput
theism	有神論|一神教
gaudy	けばけばしい|はでな
electrophoretic	電気泳動の
earhart	エアハート
buckskin	鹿革|バックスキン(buckは牡鹿)
brickyard	れんが工場|煉瓦工場
troika	トロイカ|三頭制|3人組
hellcat	意地悪女|じゃじゃ馬|魔女
wriggle	体をくねらせる|のたうちまわる
austerity	緊縮財政|厳しさ|耐乏|緊縮|質素
protozoon	原虫|原生動物
gleaner	落ち穂を拾う人;収集者
casement	開き窓(観音開きの窓)
telegraphic	電信の|簡潔な
edger	a person who puts finishing edges on a garment|garden tool for cutting grass around the edges of a yard
gentlewoman	上流婦人|貴婦人(家柄がよく|身分の高い女性)|淑女(礼儀正しく|上品な婦人)|(昔|身分の高い女性に仕えた)侍女
subgraph	部分グラフ
cartouche	カルトゥーシュ
malnourished	栄養失調の
missive	手紙|信書|(特に)公文書
affirmatively	in an affirmative manner
cloture	(議会で投票前の)討論終結
naphthalene	ナフタレン(ナフタリン)|多環芳香族炭化水素|無色で昇華性を持つ白色結晶|防虫剤として利用される
disquiet	不安にする|心を乱す|を不安にする
sugary	甘い|砂糖のような
operetta	(ｲﾀﾘｱ語)オペレッタ|喜歌劇|軽歌劇
runt	(動物のひと腹の子の中で発育不良の)小さな子|(軽蔑的)ちび
bookman	読書家|文人|学者|本屋|出版屋
bonk	軽く打つ
ferromagnetic	強磁性の|鉄磁性の
binaural	両耳用の|立体放送の|ステレオの
ephemeris	天体暦
creel	(釣りの)魚篭(ヤナギの枝などを使った枝編み細工の小さな籠)
ulceration	〈U〉潰瘍ができること|〈C〉潰瘍(ulcer)
dystopia	state in which the conditions of life are extremely bad as from deprivation or oppression or terror|a work of fiction describing an imaginary place where life is extremely bad because of deprivation or oppression or terror
luxuriously	in an indulgently luxurious manner; "she sprawled out luxuriously on the sofa"|in an indulgently luxurious manner
ambit	範囲|領域|構内|区域
flatness	二次元性|平面性
debauchery	放蕩|酒食にふけること|道楽|乱行
nester	someone who settles lawfully on government land with the intent to acquire title to it|a bird that has built (or is building) a nest
eutrophication	富栄養化
whisker	ほおひげ|ひげ|わずかの差
vesicular	小胞の
positioner	ポジショナ
loupe	拡大鏡|ルーペ
microeconomic	ミクロ経済学の
cruse	陶器のつぼ
alexandrite	アレキサンドライト
overjoy	cause to feel extremely joyful or happy; "the economic growth overjoyed the German industry"|cause to feel extremely joyful or happy
compactness	密度|濃度
monopolistic	専売の|独占的な
anorexic	拒食症の
footrest	(理髪台・歯科医の診療台などの)足載せ台
salmo	type genus of the Salmonidae: salmon and trout
eventuality	起こりうる事柄|万一の事態
malamute	《時に『M-』》(そりを引く)アラスカ犬
lotsa	a lot of
cytoskeletal	細胞骨格の
periscope	潜望鏡
uric	尿
lethality	致死性
handcraft	=handicraft|〜‘を'手仕事で作る
sombre	薄暗い
outsell	より多く売る
succinate	コハク酸塩|哺乳類のミトコンドリア膜内部等にある複合体
entomologist	昆虫学者
approbation	賞賛|許可|認可|是認|賛同
scratchy	ぞんざいな|チクチクする
calmness	静かさ|沈着|平穏|冷静
proteoglycan	プロテオグリカン|糖とタンパク質の複合体|「プロテオ」はプロテイン(=タンパク質)|「グリカン」は多糖類を意味する
hematoma	血腫
finalization	結論
lengthwise	縦の|長い|縦に|長く
uninhibited	抑制されていない
sterilize	を不妊にする|を殺菌する|を不毛にする
workhouse	《米》感化院|《英》救貧院|貧民収容施設
chasse	シャッセ
arbour	四阿|樹木|あずま屋|パーゴラ|東屋
senile	老年の|老衰した|もうろくした|老衰の
millisecond	ミリ秒
tourniquet	駆血|止血帯
interjection	不意の投入|不意の叫び|嘆声|(文法)感嘆詞|間投詞
eschatology	終末論(死･審判･天国･地獄を述べる)
electrochemistry	電気化学
hellish	地獄のような
essayist	随筆家
acrylate	アクリル酸塩
deanery	the official residence of a dean|the position or office of a dean
pidgin	混成語|2つ以上の言語を「いいとこ取り」し単純に合成した語
summarization	摘記
humongous	バカでかい
emote	感情を表に出す
gastroenteritis	胃腸炎
neoconservative	a conservative who subscribes to neoconservatism
ungrateful	恩知らずの|骨折りがいのない|いやな
stewardess	スチュワーデス(今はflight attendantが主な表現)
muenster	semisoft pale-yellow cheese
sikhism	シク教
dismount	おろす|降りる
israelite	ユダヤ人|ヘブライ人
catalase	カタラーゼ
unspoilt	よい|良い
torrid	情熱的な|焼けた|こげた|乾き切った|焼け付くような
goldstone	aventurine spangled densely with fine gold-colored particles
preconceive	〜‘を'あらかじめ考える|‘を'予想する
needlecraft	a creation created or assembled by needle and thread|work (such as sewing or embroidery) that is done with a needle
skateboarder	someone who skates on a skateboard
mastodon	マストドン(第四紀洪積世の象に似た巨獣)
godmother	名づけの母
microgram	マイクログラム
aflatoxin	アフラトキシン
corsage	コサージュ(婦人が肩・腰・手首などに飾る花)
engrave	彫り込む
anachronism	時代錯誤|時代遅れのもの･人|時代遅れ|過去の遺物
bauxite	ボーキサイト(アルミニウム原鉱)
shill	ちょうちん持ち|警棒|雇われの遊び人|大道商|サクラをする
roadless	道路のない
barrack	(通常複数形)バラック|兵舎 (Barack Obama大統領は別綴り)
coquille	コキール|コキール
gouache	グワッシュ (不透明絵の具)
conscription	徴兵制
farthing	ファージング(英国の青銅貨|4分の1ペニー;1961年に廃止)
twee	ピーッ!|いやにかわいらしい|かわいらしく装った|ことさら澄ました|取り澄ました|上品ぶった
tradesman	商人|店員|小売商|(商品)配達人
myopic	近視の|近視眼的な
bogie	ボギー(ゴルフ用語) (boggy|沼地は別語)
unscathed	(ʌnskéɪðd)無傷の
courageously	in a courageous manner; "bravely he went into the burning house"|in a courageous manner
unopposed	not having opposition or an opponent; "unopposed military forces"; "the candidate was unopposed"|not having opposition or an opponent
lir	リル
wile	策略|謀略|をだます
foreclose	除外する|排除する|締め出す
snugly	ぴったり|心地好く|こぢんまりと
joule	ジュール|SI(国際単位系)でのエネルギー|仕事|熱量|電力量の単位|1Jは標準重力下で約102|0 グラムの物体を 1 メートル持ち上げる仕事に相当
tuber	塊茎|結節
premonition	予感|予告
taillight	テールランプ
sherbet	シャーベット(=sorbet)
candidature	=candidacy
subjection	服従|征服
punctuality	時間厳守
jackrabbit	北米産の野ウサギ(長い耳と長く強い後ろ足を持つ)
agricola	アグリコラ
hoarse	しわがれ声の
chronometer	クロノメーター(科学的実験・航海・天文観測などに用いる精密な時計)
claymore	16世紀スコットランド高地人が用いた両手で使う両刃の剣
praetorian	a member of the Praetorian Guard|of or relating to a Roman praetor; "praetorial powers"|of or relating to a Roman praetor|characteristic of or similar to the corruptible soldiers in the Praetorian Guard with respect to corruption or political venality; "a large Praetorian bureaucracy filled with ambitious...and often sycophantic people makes work and makes trouble"- Arthur M.Schlesinger Jr.|characteristic of or similar to the corruptible soldiers in the Praetorian Guard with respect to corruption or political venality
transposon	トランスポゾン(Transposon)|細胞内においてゲノム上の位置を転移(transposition)できる塩基配列|動く遺伝子|転移因子(Transposable element)と呼ばれる
columnar	コラム状の|円柱の|円柱状に作った|縦欄式に印刷した|柱の
terabyte	テラバイト|斗
mortgagor	抵当権設定者
whizz	びゅーと飛ぶ
planktonic	of or relating to plankton
outwit	機知において～より勝る
subtext	文学作品がその基底に持つ意味
midline	正中線
cellini	チェルリーニ
uncorrelated	無相関の
indivisible	分割できない
phonic	音の|音声の|発音上の|有声の
poetical	非常に空想的な|詩の|詩的な|詩人の
microbiologist	微生物学者
bandanna	バンダナ(大形の絞り染めハンカチ)
heraldic	紋章(官)の
plication	曲がり|折り|屈曲|彎曲|折れ|筋目|曲り|曲り目|たわみ|湾曲
ideologically	イデオロギー的に
princely	君主らしい|王子の
backwash	逆流(船の航跡などによってできる)|後流(プロペラの回転によって疑こる)|(事件などの)余波
niner	９|九つ|ナイン|エジプト九柱の神々|玖
centrex	集合自動電話
cornfield	とうもろこし畑|トウモロコシ畑|(UK英)麦畑
headdress	かぶりもの|ヘアスタイル|頭飾り
expletive	補足的な|単に補足的な|附(つけたり)の
elderberry	アメリカニワトコの実|=elder
misgiving	疑惑|不安|疑い|心配|恐れ
brickwork	煉瓦積み工事|積まれた煉瓦
fitment	備えつけの家具|備品
apportion	を割り当てる
mastitis	乳房炎|乳腺炎
formica	any of various plastic laminates containing melamine|type genus of the Formicidae
bivalve	二枚目の|二枚貝(ハマグリ・カキなど)
scrapper	戦士|武者|闘士|戦闘員
eggshell	卵の殻
wastebasket	くずかご|(=trash box)
mournful	悲しみに沈んだ|死者を悼む|陰気な
samsara	(Hinduism and Buddhism) the endless cycle of birth and suffering and death and rebirth|the endless cycle of birth and suffering and death and rebirth
trigeminal	三叉神経の
baseless	根拠のない|いわれのない
tipster	助言者|内報者|予想屋|垂れ込み屋
parliamentarian	国会議員|議会人
dismemberment	四肢切断
lamprey	ヤツメウナギ(大きな吸盤状の口を持つ)
suspenseful	サスペンスに満ちた
agrippa	逆子
disingenuous	腹黒い|陰険な|不正直な|不誠実な
feverish	熱のある|熱病の(多い)|熱狂的な
reinvigorate	新たに活気づかせる|生き返らせる
sleight	策略|手際
reptilian	は虫類の|はこう性の|卑しい
spongiform	海綿
tricyclic	三環系
pensive	物思いにしずんだ|悲しげな|沈痛な
disintegrate	崩壊(分解|風化)させる
stereoscopic	(写真・映画などが)立体的な|立体感を与える;立体(実体)鏡の
immunosorbent	免疫吸着剤
paschal	(ユダヤ人の)過越(すぎこし)の祭り(Passover)の|《古》復活祭の
upshot	結末|結果|要旨|要点
showoff	〈U〉誇示|見せびらかし|〈C〉見せびらかす人
radicalism	改革主義
coumadin	ワルファリン
serigraph	セリグラフ(シルクスクリーン印刷法による彩色画)
boisterous	荒れている|がさつな|騒々しい|乱暴な
litigator	訴訟当事者
cowling	(飛行機の)エンジンおおい
bivariate	2変数の
reinvention	再発明
marceau	マルソー
dither	おろおろする|うろたえる
stitcher	a garmentmaker who performs the finishing steps
phenom	非凡な人|奇才|天才
longboat	長艇
foodie	食い道楽|グールメ|グルメ|エピキュリアン|美食家
fullback	(サッカー･ラグビーの)フルバック
seabird	海鳥
consternation	狼狽|驚愕|びっくり仰天
histopathology	組織病理
trivially	ごちゃごちゃ|ごちゃごちゃ
awn	ノギ
minesweeper	(敵の機雷を除去する)掃海艇
boilerplate	ボイラプレート|ボイラプレート
antigone	アンティゴネ
wastage	消耗|損耗|消耗高
buspirone	ブスピロン
glasshouse	温室|ガラス工場|営倉
demagnetization	消磁
intravenously	静脈内に
memorialize	記念する|追悼する|請願書を提出する
yore	昔|昔の
alendronate	a tablet (trade name Fosamax) prescribed to prevent or treat osteoporosis in women after menopause
modifiable	変更可能
gyrus	回
conversant	通じている|精通している
ump	アンパイア|審判|アンパイヤ
smithy	鍛冶屋の仕事場|鍛冶工場|鍛冶屋|鍛冶場
ult	先月の
schoolwork	学業|学校の勉強
malformation	障害ある|奇形|不格好な
unencumbered	free of encumbrance; "inherited an unencumbered estate"|free of encumbrance|not burdened with cares or responsibilities; "living an unencumbered life"|not burdened with cares or responsibilities
farmyard	農家の庭
continuo	(17|8世紀音楽での)通奏低音
tallow	(牛・豚・羊などの)獣脂(ろうそく・せっけんなどの原料)
rower	漕ぎ手|漕ぐ人|議論|言い争い
unforgiving	容赦のない
hyaluronic	Hyaluronic acid ヒアルロン酸|グリコサミノグリカンの一種|生体内|とりわけ関節軟骨では軟骨の機能維持に重要な役割をする
ravage	荒らす|破壊する|破壊|荒廃|略奪
rocketry	ロケット
immobile	不動の
indisputable	議論の余地のない|確かな|否定できない
dimmer	調光器
unkind	不親切な|不人情な|冷酷な|意地の悪い|(天候)悪い|思いやりのない
magnetosphere	(地球の周囲の)磁気圏
prismatic	プリズムの|分光の;にじ色の|角柱の
droop	うなだれる|伏し目になる|衰える|意気消沈
aunty	叔母様|伯母さん|伯母|叔母御|伯母さま|叔母さん|叔母さま|叔母|伯母御
gentamicin	ゲンタマイシン
cahoot	共謀
paucity	少数|小量|少量|不足
faze	を口もきけないほどびっくりさせる|心を騒がせる|あわてさせる
snafu	混乱した|を混乱させる|混乱した状態
expediency	便宜|好都合|(けなして)ご都合主義|利己主義
bagger	a workman employed to pack things into containers|a machine for putting objects or substances into bags
overprint	〈印刷したもの〉‘の'上に重ね刷りする|重ね刷りする
philology	言語学|文献学
acrylamide	アクリルアミド|アクリル酸を母体とするアミドの一種
waggoner	=wagoner
albee	アルビー
arthroplasty	関節形成
horsey	馬の|馬のような|a horsy face 馬面(うまづら)|馬好きの|競馬･乗馬好きの
benzodiazepine	ベンゾジアゼピン|向精神薬|BZDと略される
airspeed	(飛行機の)対空速度|対気速度
rationalisation	合理化|合理化|ラショナリゼーション|合理化|組織化
eerily	不気味に
squawk	ガーガー鳴く|ブーブー不平を言う
thermostatic	of or relating to a thermostat; "thermostatic control"|of or relating to a thermostat
decaffeinate	〈コーヒー〉‘から'カフェインを取り除く
concubine	男と同棲する女|内妻|愛人
antagonize	敵にまわす|反対する
appaloosa	a hardy breed of saddle horse developed in western North America and characteristically having a spotted rump
alumna	(女子の)卒業生|(pl|alumnae)
amicable	友好的な|平和的な
pressman	印刷工|《英語》新聞記者
immunoprecipitation	免疫沈降
speeder	暴走行為者
demonstrative	(文法)指示詞(の)
climactic	絶頂の|最高潮の|クライマックスの
internationalist	インターナショナリスト|インターナショナリスト
aboveground	on or above the surface of the ground; "aboveground nuclear testing"; "surface instruments for detecting oil deposits"; "surface transportation"|on or above the surface of the ground
stepson	養子の息子
radiocarbon	放射性炭素(生物体の年代測定に用いる)
colloquy	(正式な)協議|会談|(格式張った)会話|対話
splay	外側へ広がった(開いた)|ぶざまな|ぶかっこうな|斜面|隅切り(窓や扉の両側面の壁が傾斜した部分)|〜‘を'広げる|伸ばす|〜‘を'斜めにする;〈窓や扉[の壁面]〉に斜角をつける
joyfully	うれしそうに
opine	意見を述べる(いだく)|考える|思う
thermoelectric	熱電気の
mortician	葬儀屋
kitbag	(兵士の)雑のう|背のう
collegial	同僚が平等に責任(権限)を有する
papillary	of or relating to or resembling papilla
snide	悪意に満ちた|にせの
contraindicate	〈薬・療法〉‘に'禁忌を指示する
offensively	無礼に|攻撃的
granary	穀倉地帯|穀物倉
mouthwash	うがい薬
plausibility	もっともらしさ|口先のうまいこと
blarney	おせじ|おべっか|〈人〉を甘言でくどく|おせじ(おべっか)を言う
attitudinal	of or relating to attitudes
nickle	ニッケル|金属元素|元素記号Ni|鉄と共に最も安定な元素で|ステンレス鋼や硬貨他に広く使われる
vengeful	執念深い
compensable	for which money is paid; "a paying job"; "remunerative work"; "salaried employment"; "stipendiary services"|for which money is paid
agnosticism	不可知論(感覚的に経験する以上の事は知ることができないという主張)
gadfly	(家畜にたかる)ウシアブ|(批判したり要求したりして)うるさい人
retaliatory	報復的な