trivalent	(原子価が)3価の
untutored	訓練(教育)を受けていない
wrangler	口論する人|言い争う人
moralism	教訓|説教|道徳主義
stupefaction	感覚(知覚)を麻痺させること|正気を失った状態|仰天|ぼう然自失
seascape	海げしき|海景画
dreamland	ユートピア|眠り|夢の国|理想の国
layoff	一時帰休
rentier	不労所得生活者
clipper	クリッパー|19Cに発達した大型快速帆船|積載量より速度重視|多くのマストと帆を持つ|ティークリッパー(茶)|ウールクリッパー(羊毛)と呼ばれ|カティーサーク号(英)は保存
nightie	ねまき|ネグリジェ
pedant	学者ぶる人|衒学者
textually	テキストで
unreserved	遠慮のない|率直な|制限(制約)のない|無条件の
debater	討議者|討論参加者|討論者|論客
condiment	調味料|香辛料|薬味
disciplinarian	厳格な(人)
washbasin	=washbowl
taskmaster	職工長|親方
hospitably	あいそよく|手厚く
rootless	根のない|社会的足場のない
obtrude	(〜に)〜‘を'押しつける|むりじいする《+『名』+『on』(『upon』)+『名』》|〜‘を'押し出す|突し出す|(〜に)でしゃばる《+『on』(『upon』)+『名』》
cantankerous	意地の悪い|けんか好きの|意地悪の|つむじ曲がりの|けんか腰の
quire	(紙の)1帖(じょう)(24または25枚)
sultanate	サルタンの領土(位)
perplex	(〜で)〈物事〉‘を'『混乱させる』;〈人〉‘を'混乱させる|当惑させる《+『名』+『with』+『名』》
unalloyed	(感情などが)純粋な(pure)|本物の
presbytery	(教会堂の聖歌隊席裏の)内陣・(長老教会の)中会;中会管轄区域・(カトリック教の)司祭館・(キリスト教)長老会(管轄区)・(集合的) 中会管轄下の全教会; (教会の)司祭席
lighter	明りをつける人|ライター|点灯器|たきつけ|艀|light(軽いの比較級)
metamorphism	変成(地下深部での岩石の変化)|=metamorphosis
mongoose	マングース
inconstant	変わりやすい|気まぐれな|移り気の
truckload	トラック積荷
aftercare	病後の養生|(卒業後の)職業指導;(刑務所出所後の)更生指導
propertied	財産(資産)のある
quaver	震える|震音|声が震える|声の震え|震え声
xenon	キセノン(希ガス元素;化学記号はXe)
dresser	化粧ダンス|着付け係
brawn	(人の)筋肉|筋力|《英》煮て塩づけして固めた豚肉(《米》headcheese)
sylvan	樹木の茂った|森の|森に住む
munch	むしゃむしゃ食う
thievery	盗み|盗品
sutra	(バラモン教・仏教)経|経典|スートラ
swanky	しゃれた|派手な
msec	ミリ秒
inheritor	(遺産)相続人|後継者
ungracious	無作法な|粗野な
demonstrator	デモ参加者|示威運動者|実験の助手|実地説明者|証明者
exemplification	〈U〉例をあげること|例示|〈C〉実例(example);好例
piggyback	抱合せ広告|おんぶ|(子供が大人の)背に乗る
longish	やや長い|長めの
quadrille	カドリール(4人が組みになって踊るスクエアダンス;その曲)
tepee	ティピー(北米インディアンのテント小屋)
patroness	(仏語)patronの女性形
healthily	健康で|健全で
lob	(テニスで)〈ボール〉‘を'ゆるく高く打ち上げる|(クリケットで)〈ボール〉‘を'下手投げでゆるく投げる|(テニスで)ボールをロブで返す|(テニスの)ロブで打った球|(クリケットの)下手投げの緩い球
hyphenate	ハイフンでつなぐ
infield	(野球)内野
rightwing	右翼(保守)党員|右派の人々・右翼政党|保守党|(政党などの)保守派|右派|右翼の|右派の・= right-wing
queenly	『女王の』;『女王のような』;女王にふさわしい
forlornly	侘しく|(forlornの副詞形)
crossroad	交差道路|十字路
crewman	乗組員|乗務員|搭乗員
applesauce	リンゴソース|(俗)たわごと
ecstatically	有頂天になって|無我夢中で
fabulously	途方もなく
heartstrings	心の琴線|深い感情|深い愛情
jinx	不幸をもたらす|運を悪くする|ジンクス
prettiness	かわいらしいしぐさ|かわいらしさ|きれいさ|こぎれいさ
cytoskeletal	細胞骨格の
umpteenth	何度目かの
propitiation	なだめること;〈C〉(なだめるための)ささげ物
uncork	コルクを抜く
piratical	海賊の|著作権を侵害する
proctor	代理人|代訴人|試験監督者
attractively	魅力的に
muggy	むし暑い
penumbra	(太陽黒点の)半影(部)|明暗(濃淡)の境
stretchable	伸ばす(広げる|張る)ことのできる
foundling	拾い子|捨て子
potentiate	強化する
seethe	沸騰する|泡立つ|腹をたてる
airframe	(航空機・ロケットの)機体
dispensable	無くてもすむ
nonentity	非実在|取るに足りないこと(状態)
softener	ソフナー|軟化剤|洗濯用柔軟剤|柔らかくする人|和らげる人|軟化装置
highbrow	知的な|知識人|教養人
corruptible	(人が)堕落しやすい|(物が)腐敗しやすい
plumber	配管工|(俗)台無しにする|ぶち壊す
freewill	自由意志|任意決定|自由意志論|自由意志の|自発的な
sibilant	シューシュー音がする|歯擦音
spigot	コック|飲み口|差込み部|蛇口|栓
pushover	くみしやすい相手|カモ
tangentially	接線方向に
coitus	性交(sexual intercourse)
hairdo	女性のヘアースタイル|髪の結い方
grammarian	文法学者
ornery	意地の悪い|おこりっぽい|強情な|下劣な
conversationalist	座談家|話し好きな人|話し上手
schizoid	精神分裂症(の)
wrecker	救難作業員|救難車|レッカー車|建物解体業者
rosewood	ローズウッド|シタン(材)
demagogue	扇動家|煽動政治家|民衆煽動家|デマゴーグ|民衆の指導者
compartmentalize	を区切る
catatonic	緊張
practicability	実行できること|実用性
expensively	費用をかけて|高価に
attractant	引きつける物|誘引物(剤)
stereoscopic	(写真・映画などが)立体的な|立体感を与える;立体(実体)鏡の
unvarnished	塗装してない|生地のままの
gusty	突風の吹く|風の強い
outback	奥地|未開拓の奥地
triptych	(三面鏡のようにちょうつがいでつないだ)3枚続きの絵画
unroll	繰り広げる|解く|開く|広げる|展開する|示す|明らかにする|解ける|開ける
eardrum	こまく|鼓膜
extensible	広げることができる|伸ばせる|伸張性の|伸張性のある|増築可能な
birdie	(幼児語)小鳥さん
benzoic	ベンゾイン樹脂の|安息香[酸]に関する
dimorphic	二形性の|両形|2つの異なる形式で生じるまたは存在する
verve	(芸術作品に現れた)気迫|熱情|(一般に)活気|力|気力
newscast	ニュースを放送する|ニュース放送
eta	(第7ギリシア文字)エータ|Η|η|(ETA)Estimate Time of Arrival|航空機などの到着予定時刻
searcher	サーチャー|調査員
palliation	(罪などの)弁解|取りつくろうこと|(病気などの)一時的な抑え
calculable	計算できる|信頼できる;予想できる
lode	鉱脈|鉱床
dormer	屋根窓(屋根裏部屋の明かりとり窓)
minx	おてんば娘|生意気娘|あばずれ女
voyeurism	のぞき見趣味
flume	(水の流れる)深くて狭い谷|狭谷|(木材運搬・水力供給などのための)人工水路|とい式水露
cecum	盲腸
violator	違反者
effervescent	泡立つ|発泡性の|起沸性の|興奮した|熱っぽい
senescent	初老の|老境にかかった
exorcist	悪魔払い師
poorhouse	(昔の)救貧院
microscopically	顕微鏡で;顕微鏡で見るように
twitchy	引きつった
bejewel	(宝石で)〜'を'飾る
tingly	ゾクゾクする|ヒリヒリする
sarong	サロン|マレー人･ジャワ人などが着用する腰布
prix	グランプリ
meiotic	減数分裂の|(生殖細胞を作る際|通常の体細胞分裂とは異なり、染色体数が分裂前の細胞の半分になる事)
thinkable	考えられる|想像がつく|ありうる(conceivable)
marjoram	マヨラナ(ハッカに似た植物);〈U〉(香料として料理・調剤に用いる)マヨラナ
changeless	変わることのない|不変の
bop	bebop|ビーバップ(ジャズの一形式)
landholding	土地所有
bluebird	ルリコマドリ|ブルーバード(米国産の青い鳴鳥)|警官|ポリ公
threescore	60の|60束の|~and ten 70束
hatchway	=hatch
mocha	コーヒー色|チョコレート色|モカ|上等のコーヒー|モカ革|モカ風味のケーキ|暗褐色|手袋用なめし革
frizzy	ちぢれた
missense	missense mutation|ミスセンス突然変異|遺伝子のコードに塩基置換が起こることにより|コドン部分の塩基配列が変わり|他のアミノ酸をコードするようになる突然変異
serif	ひげ飾り(『M』|『H』などの活字の上下につく細く短い線)
puller	引くもの|プーラー
agglutination	膠着[状態];接着[作用]
puppeteer	人形遣い|人形師|操り人形師|ロボットを操作する人|操る|操作する|人形･人の心を
electrodynamics	電気力学
risperidone	リスペリドン|セロトニン・ドーパミン拮抗薬|(SDA)と呼ばれる非定型抗精神病薬
dilettante	好事家|芸術愛好家|美術愛好家|素人芸術家
doormat	ドアマット|玄関マット|ぼけ|人にいいようにされる人
vitriolic	辛らつな
slob	泥|だらしなく薄汚い人
racketeer	(大勢で)脅迫する|脅迫|不正に金もうけをする人|ペテン師|ごろつき
goof	まぬけ|(俗)とんま(な人)|へま
advisability	勧めるに足ること|事の当否
unexposed	露光されていない
joust	(中世騎士の)馬上槍試合(をする)|試合(競技)に出る(参加する)
promo	宣伝広告|番組予告|販売促進)(の手段)
boor	オランダ人小作農|小百姓|粗野な男|田舎者|不作法者
newspaperman	新聞記者
neuroscientist	神経科学者
polyglot	多言語に通じた(人)|多言語で書かれた|多言語で記した対訳書(特に聖書)|混合
thunderstruck	びっくり仰天した
verbiage	冗漫
execrable	憎むべき|呪うべき|忌まわしい|実にいやな|劣悪な
insidiously	陰険に|狡猾に|知らぬ間に
pasteurize	低温殺菌する
abolitionism	(特に米国の)奴隷制度廃止論
pathologically	病理学的に|病的に|異常に
prodrug	プロドラッグ(そのままでは不活性な医薬品|投与されると|生体による代謝作用を受けて活性代謝物へ変化し|薬効を示す)
carnation	カーネーション|ナデシコ科の多年草|ピンク色の
complementation	相補性
gyre	輪|回転|旋回(する|させる)|渦(巻)
acrobatics	アクロバット
manorial	荘園の|領地の
plenipotentiary	(特に外交使節などが)全権を有する|全権大使(使節)
abscissa	横座標
medico	医師|医学生
allusive	暗示的な
operable	実施可能の
prosciutto	プロシュート|香辛料の効いたイタリアハム
wistfulness	あこがれの|ものほしそうな|物悲しいこと
snowdrift	雪の吹きだまり(堆積)
phrenic	横隔膜の|(生理学上の意味で)精神の|精神活動の
slapstick	どたばたの|どたばた喜劇
windlass	巻き上げ機;(船の)いかり巻き上げ機
licit	合法の
gyro	ジャイロ(ギリシャ風サンドイッチ)
convulse	身もだえさせる|震動させる
idiosyncrasy	特異性|特異な性格|特異体質
vitiate	価値を低下させる|そこなう|不純にする|腐敗させる
pasturage	牧草|牧草地;牧畜業
repine	(〜に)不満足である|不平を言う|じれる《+『against』(『as』)+『名』》
cornucopia	(ギリシア神話)豊穣の角(つの|幼時のZeus神に授乳したとされるやぎの角)|くだもの･花のあふれた角|豊かさの象徴|豊富
geochemistry	地球化学
unpick	〈ししゅう・編物など〉‘を'ほどく;〈着物など〉‘の'縫い目をほどく
crisscross	十文字|十字の|交差する|十字になる
palpitate	〈心臓が〉動悸(どうき)を打つ|どきどきする|《文》(〜で)〈人・体が〉震える《+『with』+『名』》
assignable	割当ができる
meatloaf	ミートローフ
penmanship	習字|書道|書法|筆跡
rile	苛立たせる|怒らせる= irritate
pinkie	小指|小さい|安物の(赤)ワイン|白人|アルコール常用者
affability	愛想の良さ|感じの良さ
defrost	解凍する
posy	花束
hereto	これに|この点(場所|事)へ
cantaloupe	カンタロープ(キャンタロープ)メロン|ヨーロッパ南部|アメリカ|タイなどで露地栽培される|赤肉種のマスクメロン
anagram	アナグラム(単語または文中の文字をいくつか入れ替えて全く別の意味にさせる遊び) cf|palindrome(回文)
fey	(人|特に女性の行為が)感覚的で愚かな|非現実的な(けなしていう言葉)
intensifier	増圧器|(文法)強度語
percussive	打楽器|打診|衝撃の|震動の|打奏的な
hallucinogenic	幻覚を生じさせる
apprise	に通知する|知らせる|通告する
tritium	トリチウム(水素の同位元素;化学記号はT)
incubus	インキュバス|悪夢|心配事|夢魔(むま)|淫魔
brokenhearted	失意の|悲嘆にくれた;失恋の
tableware	《集合的に》卓上食器類(皿・ナイフ・フォーク・スプーンなど)
cicada	セミ(米ではlocust(本来バッタの類)とも言うが|識別できないためと思われる)
helluva	ひどい|すばらしい|とても|非常に|「hell of a ...」に由来する
blackjack	ブラックジャック
umbrage	不快
mitt	ミット|長手袋|女性用長手袋
bondsman	(主に米)保釈保証業者(裁判所･刑務所近くに事務所を持ち職業として保釈金を貸したり保証人になったりする人)
washerwoman	洗濯女
delusive	人を惑わせる|紛らわしい
gnat	(nˈæt)|ブヨ|ぶよ
poof	ホモ|男の同性愛者|なよなよした男|女々しい男|パッ|フッ|プーッ|キスする
begone	立ち去る|消えうせる
sachem	(北米インディアンの)首長
preoccupy	いっぱいにする|心を奪う|先取する
splutter	(混乱して)早口でしゃべる|〈物が〉パチパチ(ジュー)と音を立てる|(混乱して)〜‘を'早口で言う《+『out』+『名』|+『名』+『out』》|パチパチ(ジュー)という音
relegation	左遷(させん)|格下げ;委託
deflationary	通貨収縮の|デフレの
colorblind	色盲
motorcar	《おもに英》《米》『自動車』《米》automobile)
nostrum	(製造会社が自己宣伝する)妙薬|万能薬|《やや皮肉に》(解決のための)妙案|秘策
sower	種子をまく人(機械)|(うわさ・紛争などを)まき散らす人
foodstuff	食料品
puma	ピューマ
murk	真暗やみ|暗黒
pugnacious	けんか好きな|けんか早い
adipocyte	含脂肪細胞
refreshingly	さわやかに
pettiness	取るに足らないこと|つまらなさ|狭量
purgative	下剤|下剤の
encumber	妨げる|の足手まといになる|苦しめる
paymaster	ボス|会計課長|部長|給与支払係|雇用者|支払主任|主計官|親方
bubonic	(医)横痃(おうげん)|もものつけねのリンパ節が炎症を起こして腫れること|黒死病(bubonic plague)
copier	複写器|模倣者
gingham	ギンガム(棒じまなどの綿布)
contrapuntal	(作曲法で)対位法の|対位法による
manumission	奴隷(どれい)(農奴)からの解放;解放証書
haply	多分
thalidomide	サリドマイド|催眠鎮静薬として市販されたが|1960年代に服用した妊婦にサリドマイド胎芽症の新生児が生まれた薬害「サリドマイド禍」を起こした
expatiate	(〜について)詳しく話す(書く)《+『on』(『upon』)+『名』》
inflect	〈単語〉‘を'語形変化(活用)させる|〈声〉‘の'調を変える;〜‘に'抑揚をつける|〜‘を'曲げる|屈曲させる
baccalaureate	学士(bachelor)の学位
pita	ピタパン(地中海沿岸|中東|北アフリカで広く見られる食文化)
youthfulness	若々しさ|青年らしさ
mercantilism	重商主義
reticule	(昔の)小物入れ・(網製)手さげ袋; (コンピュータ)レティクル (ICの回路パターンの焼き付けられた原版)
appellee	被上訴(控訴)人
discordance	=discord1|2
undernourished	栄養不良の
plod	こつこつ働くこと|とぼとぼ歩く(こと)|ゆっくり進む|こつこつ取り組む
omnivorous	雑食性の
tarantula	タランチュラ(毒グモ)
copra	コプラ(ココヤシの胚乳を乾燥したもの)
necromancy	交霊による占い|いかがわしい魔術
witless	知恵(思慮)のない|無分別な|愚かな
cesspool	=cesspit
boxy	箱に似た|箱のような
pasteboard	ボール紙|厚紙
deadweight	〈U〉自重(車・船などのそれ自体の重さ);死重(自力で動けない物の重さ)|《a dead weight》《比喩(ひゆ)的に》重荷
penetrance	浸透度
processional	行列の
vocalize	声を出す|しゃべる|歌う|発音する|母音化する|言う
snowshoe	雪ぐつ|かんじき
sprayer	霧を吹く人|吸入器|噴霧器
intimal	血管内膜の
octet	8重唱(奏)曲;8重唱(奏)団|8個一組のもの
diaphanous	透けて見える|透明な|ほのかな|かすかな
undigested	消化されない
turgid	腫れ上がった|大げさな
smokestack	重工業の
guacamole	グアカモーレ(メキシコのアボカド料理)
gynecology	婦人科学
diluent	(液体を)薄める|希薄用の|希釈剤
alar	翼のある;翼の形をした
retractable	格納式の|引っ込められる
chiropractor	脊柱指圧(調整)療法師
chloro	chloro (異形chlor- 主に母音の前) 緑の|Chlorophyll(クロロフィル・葉緑素) 2|(化学)塩素の|塩化|クロロ|クロル
pagination	本のページ付け|丁付け|ページ数|ノンブル(ページ数を示す字)
reincarnate	(〜として)〈新しい肉体〉‘に'生まれ変わらせる《+『as』+『名』》
fie	えーい!|ちぇっ!
humorless	ユーモアのない
ascertainable	確かめられる
cloakroom	(また『checkroom|coatroom』)(ホテル・劇場などの)外とう・携帯品預り所|(また『checkroom』)(駅の)手荷物一時預り所|《米》議員控え室|《英》《遠回しに》便所
toner	インクトナー
enchantress	魔女|魅力的な女
flinty	火打ち石の;火打ち石の多い|火打ち石のように堅い;残酷な|冷酷な(cruel)
heartrending	胸も張り裂けるような|悲痛な
polymath	博識家|博学の
gawk	気のきかない人|のろま|とんま|ぼんやりと眺める
vapid	おもしろくない
afforestation	造林|植林
loftily	高々と|高尚に|高慢に
leukemic	白血病性の
cruciform	十字形の|十字架状の
churlish	粗野な|田舎ものの|けちな
torpid	(体の機能などが)鈍い|のろい|不活発な|鈍感な|冬眠状態の|冬眠中の
expressively	表情たっぷりに;意味ありげに
officiate	職務を行う|式の司祭を勤める
rotavirus	ロタウイルス|2層のタンパク質の殻に覆われた2本鎖RNAウイルス|乳児下痢症･嘔吐の原因として知られている
oscilloscope	オシロスコープ(電気の変化を曲線で観測する装置)
sufferance	黙認|容認|許容|忍耐力
unconfirmed	未確認の
oddball	変り者
emu	(emu)エミュー|ダチョウ目の鳥の一種|オーストラリアの非公式な国鳥|ダチョウに次いで背が高い|趾(あしゆび)は3本|Economic and Monetary Union|経済通貨統合(EU)
abalone	アワビ
windbreaker	防風林|風避け|(商品名)ウインドブレーカー
whizz	びゅーと飛ぶ
condor	コンドル
nonfatal	致命的でない
hodgepodge	まとまりを欠いたもの|ごた混ぜ
rocker	ロックを演奏する人|ゆする人
reveler	酒盛りする人|飲み騷ぐ人
linchpin	急所|車の輪止めピンの意から|(荷車などの)輪止めくさび(ピン)|(扇の)要
superscription	手紙などのあて名|上書き|表題|銘
ribald	下劣(野卑)な|みだら(不敬)な(ことを言う)
unenviable	あまりうらやましくない|あまり欲しくない
prepossess	《通例受動態で》〈感情・観念などが〉〈人〉‘に'先入観を抱かせる|〈人〉‘に'第一印象で好感を与える
untranslated	翻訳されていない
photosensitive	感光性の
icebreaker	砕氷船
absinthe	アブサン|ニガヨモギ風味の強いリキュール
olanzapine	オランザピン(略称OLZ)|アメリカFDA(食品医薬品局)で承認された抗精神病薬|最も多く使用されている非定型抗精神病薬のひとつ
deferment	延期|繰延べ|据え置き|徴兵猶予
compositor	合成器|植字工
cymbal	シンバル
waterworks	水道設備|上水道
tenderloin	テンダーロイン|ヒレ肉|盛り場|不法の街
starlit	星に照らされた|星あかりの
breakpoint	ブレイクポイント
gossipy	(人が)ゴシップ好きの|(会話などが)ゴシップに満ちた
consanguinity	血族|血縁
ghoulish	残忍な
endogenously	(生命科学)内生的に
pizzeria	ピッツェリア|ピザパイを売る店
libertarianism	リバタリアニズム(新自由主義などいくつか訳がある)
arroyo	アロヨ|米南西部の乾燥地帯の小川|小峡谷
limber	しなやかな|前車
amidships	船(航空機)の中央部に(で)
herder	家畜の番人|牧夫|家畜の飼い主
expat	国外居住者
prophetically	預言(予言)的に|預言(予言)して
comity	礼譲|礼節|the comity of nations|国際礼譲(各国が他国の法律･制度を尊重する親交関係にあること)
melamine	メラミン(白色の結晶でおもに合成樹脂の製造に用いる)
foxhole	1･2人用塹壕(=dugout)
awakening	目覚め
electrochemistry	電気化学
understudy	代役の俳優|〈役〉‘を'代役としてけいこする|〈別の俳優〉‘の'代役を演ずる
uncharitable	無慈悲な|情け容赦のない
varicose	静脈瘤(りゅう)の|静脈怒張の(特に足の血管が異常にふくれること)
biped	2足ある|二足動物
rafter	たるき|いかだ師|いかだ乗り|(建築)たる木|屋根のたるき
bandanna	バンダナ(大形の絞り染めハンカチ)
godforsaken	(人が)神に見放された|(土地が)荒れ果てた
voyeuristic	(vwὰːjɚ(ː)rístɪk)覗き見の|覗き見趣味の
marksmanship	射撃技量|射撃術|弓術
humpback	猫背|せむし
depute	〈人〉‘を'代理者(代表者)にする;(〜するように)〈人〉‘を'代表にする《+『名』+『to』 do》|(代理者に)〈権限・任務など〉‘を'委任する《+『名』+『to』+『名』》
equipoise	〈U〉釣り合い|均衡|〈C〉平衡おもり;対抗勢力
syndication	シンジケーション
luxuriance	繁茂|豊富
multivariable	多変量
festal	祭りの|祝いの
rambunctious	手に負えない|乱暴な|気ままな|やんちゃな|騒々しい|無軌道な|無法な|どたばたした|むちゃな
hunker	(hˈʌŋkɚ)うずくまる|しゃがむ|ブラブラ歩く|重々しく動く|前かがみになる|背を曲げる
missy	(呼びかけで)お嬢さん|娘さん
fizzle	(最初はうまくいくが)失敗に終わる|しくじる|弱く消えてしまうようにシューシューと音を出す
resinous	樹脂の・樹脂質の・ やにの多い
purser	事務長（事務だけでなく|乗客サービスも担当する乗務員）
rakish	みだらな|粋な|ハイカラな
pedantry	ペダントリー|衒学趣味(げんがく|知識をひけらかす|自慢すること)
ruination	〈U〉破滅|崩壊|荒廃;破産|〈C〉破滅(崩壊)の原因|破滅をもたらすもの
proposer	提案者|発起人|申し込み人
aspartic	アスパラギンの
demoralization	風紀を乱すること|堕落|退廃|(軍隊・軍人の)士気をくじくこと
erotica	エロティカ|性愛の文学作品
upswing	(経済)上昇|上向き
hank	(糸の)束
nosebleed	鼻血
circumvention	裏をかくこと|迂回;回避
fermenter	発酵槽
undistinguished	区別されない|平凡な
glomerulus	糸球体(しきゅうたい)は脊椎動物の腎臓内でボーマン嚢に囲まれた毛細血管の塊|腎臓循環の細動脈から血液が流れ込み|濾過する働きをする
caraway	ヒメウイキョウ(セリ科の植物;実は食用・薬用)
microsomal	ミクロソーム(microsome)の
realty	不動産
sculpt	彫刻する
pasha	パシャ(もとトルコの高官の尊称で名前の後に付けた)
bizarrely	奇妙に
devilishly	極悪に|《話》ひどく|はなはだしく
cuirass	胴よろい;よろいの胸当て
trivialize	つまらなくする|平凡化する|矮小化する
disburse	(金)を支払う|(金･費用を)支払う|支出する
backstop	(野球)バックネット(和製英語)
overreaction	過剰反応
seasickness	船酔い
mainsail	大檣の大帆|メーンスル
straitjacket	精神病者・囚人などに着せる丈夫な拘束服
hyperlink	ハイパーリンク
geomorphology	地形学
embolus	塞栓(そくせん|embolism)|栓子(血塊などの塊|単数形embolus|複数形 emboli)が血液中に遊離し|血管が塞がれ血流が遮断されること
foursome	四人|フォーサム(各2人組の2チームで戦う)|4人組
transshipment	(乗客・貨物を)他の乗り物に移すこと|(〜の)積み換え《+of+名》
whiny	泣き言を言う
postseason	ポストシーズン
dyestuff	染料
planetarium	プラネタリウム
tadpole	オタマジャクシ
freestyle	(競技)自由型|フリースタイル(の)
mandolin	(楽器)マンドリン
immunize	免疫にする
freakin	freaking(熱狂的な|変わった)の省略形
slanderous	中傷的な
castrate	去勢する|精巣を除去する|骨抜きにする
bivalve	二枚目の|二枚貝(ハマグリ・カキなど)
satrap	(古代ペルシアの)太守|(専制的な)総督|知事
ladybird	テントウムシ(=ladybug)
saleswoman	女店員|女性販売員
acclimate	(人･ものを風土･環境などに)慣らす|順応させる
theatrics	〈U〉《単数扱い》演出法|《複数扱い》芝居がかった動作
peptidase	ペプチダーゼ|ペプチド加水分解酵素
ketch	2本マストの小型帆船
sadden	を悲しませる
stoplight	停止信号|(車の)ブレーキランプ
petulance	癇癪|すねること|短気|不機嫌
interrogatory	疑問の
exhumation	発掘
depopulate	〈戦争・悪疫などが〉〜‘の'人口を減らす
incontinent	自制心のない|自制のできない|抑えきれない|失禁の|淫乱な
godson	洗礼で教父母が名づけた息子|Cf|godchild(〃幼児)
expunge	消し去る|抹消する|ぬぐい取る|破壊する|絶滅させる|(語など)を削除する|抹殺する
wallop	をひどく打つ|に大勝する|沸きたつ|強打|パンチ力
loquacious	おしゃべりな|多弁な|騒々しい
comptroller	(会計･銀行)検査官|監査官
homeopathy	同種療法(健康体にある症状を起こす物質は|その症状に類似した症状を治癒するという理論に基づく治療法)
junkyard	古物集散所|廃品投棄所
meanly	卑しく;みすぼらしく|意地悪く|つれなく|けちに
molto	(音楽用語で)非常に
prude	きわめて慎み深い女|慎み深さを装う女|淑女ぶる女
weeklong	一週間
gingivitis	歯肉炎
liven	活気づく|陽気になる|活気づける|陽気にする
abed	就床して
coextensive	(空間的・時間的に)同一の広がりを持つ
pander	女を取り持つ男|売春宿の主人|人の弱みにつけ込む人|迎合する
silversmith	銀細工師
oedipal	エディプス複合(Oedipus complex)の
finch	フィンチ|ヒワ|ウソの類
spacesuit	宇宙服
blotchy	シミだらけの
diatonic	全音階の
subsonic	亜音速の|音速以下の
shiftless	やる気のない|怠惰な|無精な
epiglottis	喉頭蓋|のどぶた
fiefdom	封土|領地|知行
prefectural	(フランス・日本などの)県の|府の
draughtsman	=draftsman
metalwork	金属製品|金属細工品|(特に学科目の)金属加工
capsaicin	カプサイシン|唐辛子の辛味をもたらす主成分|アルカロイド(Alkaloid)のうちカプサイシノイドと呼ばれる化合物のひとつ
colostomy	結腸人工肛門造設術
peyote	ペヨーテ(= ウバタマ:メキシコ中部から米国テキサス州南部原産サボテンの一種・幻覚をもたらす成分であるメスカリンを含有する)・ それから得られる幻覚剤
hillbilly	(アメリカ南部の)田舎者|山の住民
irreducibly	削減できないほどに
contrarian	(多くの人が株を売れば自分は買い|買えば自分は売るような)反対意見の人
treasonable	反逆の，大逆の，国事犯の
raceway	《英》(水車小屋にひく)水路|1頭立ての一人乗り二輪車(sulky)の競走路
subpart	下位区分
amateurish	アマチュアっぽい|素人くさい|下手な|不器用な
irretrievable	(過失・損失などが)取り返しのつかない|元どおりにならない
folktale	伝説物語|民間説話|民話
faze	を口もきけないほどびっくりさせる|心を騒がせる|あわてさせる
doctrinaire	空論家|教条的な|空論の
uptick	(株価などの)上昇　上向き
lanyard	ラニヤード|括帆(かっぱん)索(帆・なわばしごなどを固定する短いロープ)
draftsman	製図係員|起草者|製図家(工)|立案者|デッサン画家
gaslight	ガス灯(の光)|ガスの火口
midstream	流れの中ほど
retentive	保持する力がある
suntan	(健康的な)日焼け
westernmost	最西の|西端の
wizardry	魔法|魔術|妙技
heartwarming	心暖まる
indigestible	消化しにくい|不消化の
windblown	風に吹かれた|(木が)強風で変形した|(髪型が)ウインドブロウン型の
execration	〈U〉憎悪|〈C〉のろいの言葉|〈C〉のろうべき相手(物)
quadruped	四足(よつあし)獣(通例哺乳(ほにゅう)類)|四つ足の
lidar	光線レーダー|laser-infrared radar
igloo	エスキモー人の家
egret	シラサギ(の羽毛)|羽飾り|冠毛
handball	ハンドボール
repetitious	(けなして)繰り返しの多い|くどい
archly	いたずらそうに|ちゃめっぽく|ずるそうに
lawnmower	芝刈り機
deaden	弱める|鈍らせる|消す
blustery	天候の荒れた
offensively	無礼に|攻撃的
shrift	(古)(司祭にする)ざんげ
collapsible	(いす.テーブルなどが)折り畳める|組み立て式の
pertinence	適切さ|妥当性
deacetylase	脱アセチル化酵素
orang	オランウータン(Orangutan)
stepbrother	義兄|義弟
terminator	terminate(断ち切る|終端|抹殺などの意)の名詞形|終端子|(ターミネータ)映画のタイトル
intima	(血管などの)内膜
minstrelsy	(U)吟遊詩人の芸|〈C〉吟遊詩人の歌
riposte	当意即妙の答え|(フェンシングの)突き返し
minaret	(イスラム寺院の)尖塔
loggia	ロジア(片側に壁のない柱廊)
pothole	(車などによる路面の)くぼみ
fatuous	(ひとりよがりで)愚かな|無意味な|まぬけの|頭がからっぽの|愚鈍な|ばかの|低能の
luminary	(知的)指導者|有名人|(月･太陽など)発光体
noh	能|猿楽
coppice	雑木林
extrude	(チューブから)〈歯磨きなど〉‘を'押し出す《+『名』+『from』+『名』》|〈プラスチック・金属など〉‘を'型から押し出して成形する
earldom	〈U〉伯爵の身分|〈C〉伯爵の領地
smugness	気取っていること
undersized	小型の
riverfront	リバーフロント|川沿いの散策地
vino	ブドウ酒|ワイン
sublimate	昇華させる
borate	硼酸塩|硼酸エステル
duckling	子ガモ(の肉)|アヒルの子|暗い青緑色
impalpable	手で触れない|触知(感知)できない|(差異などが)なかなか理解できない|微妙な
spoliation	強奪|略奪
farmhand	作男|農場労働者
burgher	公民|市民
horsehair	馬の毛|馬巣織(ばすおり)
premenopausal	閉経前の
totemic	トーテム信仰のcf|totem
scrappy	断片的な
anemone	アネモネ|イソギンチャク
gynecological	婦人科(病)の
pamper	飽食させる|を甘やかす|の好きなようにさせる
salivate	つば(よだれ)を出す
arrondissement	フランスの区|郡
yum	Yum-yum|(jˈʌmjˈʌm)|うまい!|おいしそう! 2|Yellowdog Updater Modified(Yum ヤム)|Linuxのパッケージを管理するシステム
armadillo	アルマジロ
volunteerism	ボランティア活動
microbiologist	微生物学者
minuet	メヌエット(17世紀フランスで始まった3拍子のゆるやかで優雅なダンス)|メヌエット舞曲
blotter	吸い取り紙
discrepant	不一致|矛盾
octagon	八角形
excreta	排出長(汗・尿・便など)
treasonous	treasonable
bodybuilder	ボディビルダー
solipsism	唯我論|自己中心主義
cahoot	共謀
matronly	既婚婦人らしい|品のある|落ち着いた|(若い女性が)太めの
belay	ザイル等で留める|索止めなどに巻きつける|“Belay that!” he roared|「やめろ」と彼はどなった
ruminant	反芻する|考え込む|反芻動物
portcullis	落とし門(攻撃に対して直ちに開閉できる鉄格子の城門など)
ahem	ふむ|えへん
constabulary	警官隊
endangerment	生死にかかわる危険にさらすこと
kisser	キスをする人
maltose	麦芽糖
lunchroom	簡易食堂|軽食堂|食事室
profligacy	豊富|おびただしさ|不品行|だらしなさ|放蕩|浪費
acrobat	曲芸師
truncheon	杖
promptitude	敏速|機敏
kindhearted	心優しい|情け深い
dyer	染め物屋
boomer	(一時的な)人気者|熱烈なファン
centralism	中央集権制|中央集権主義
primitivism	原始主義(自然ないし自然的なものを人間的価値の規準とする立場)
hah	=ha
ornithologist	鳥(類)学者
versification	作詩;作詩法|格調|韻律の形式
mezzo	(音楽で)適度に|=mezzo-soprano2
overemphasize	過度に強調する|強調し過ぎる
freakish	気まぐれな
anticlockwise	=counterclockwise
mouthwash	うがい薬
provident	将来に備える|節約の|つましい
philosophize	哲学的に思索する
ethnologist	民族学者
likeminded	同じ心(意見|趣味)をもった
nowise	=noways
uninspired	退屈な
stoker	火夫|機関員|機関助士|(自動)給炭機
ballpoint	ボールペン
burning	燃える
sumac	スーマック|中近東一帯に原生するウルシ科の灌木|赤い果実はフルーティーな酸っぱさがあり|乾燥させレモン汁のように利用される
impersonator	物まね芸人|声色使い|俳優
sandbank	砂州|砂浜
loamy	ローム土壌の
catamaran	いかだ舟|ガミガミ女
afterword	あとがき
sappy	のろま|あほ|感傷的な|女々しい|元気旺盛な|活気に富む|樹液の多い|液汁に富む
degas	〜‘から'ガスを抜く
impressionist	印象派の)画家)|物まね芸人
marchioness	侯爵(こうしゃく)夫人(未亡人);女侯爵
decibel	デシベル
anaesthetist	=anesthetist
charitably	慈悲深く|寛大に
ballplayer	野球選手
strabismus	斜視|やぶにらみ
discus	円盤|(discus throw|円盤投げ)
voltmeter	電圧計
creationist	創造論
interrelate	(〜と)相互関係にある《+『with』+『名』》
pontifical	教皇の|大祭司の|独断的な|尊大な
uncommitted	拘束されていない|未遂の;約束
bandy	投げ合う
niobium	ニオビウム(金属元素;化学記号は『Nb』)
sportswriter	スポーツライター
jauntily	のんきそうに|陽気に;元気に;気どって|いきに
lumberjack	木こり|木材伐採人夫|材木切出し人
raider	企業買収家|(企業などの)乗っ取り屋|侵入者
disfigure	外観を台無しにする|傷つける
upstage	舞台の後方の|内気な
miniskirt	ミニスカート
strapless	ストラップレス|肩吊りひもなしの衣服|strapのついていない|肩ひもなしの
ravioli	ラビオリ(こまぎれ肉を小麦粉の薄皮で包んだ料理)
chimerical	想像上の|幻想上の|怪物的な|空想的な|妄想的な
digging	採掘
synecdoche	提喩法|代喩|シネクドキ|全体とその一部についての言い換え
cumulus	積雲
cress	カラシナ類の植物;サラダなどの食用
vilify	(人を)けなす|そしる|中傷する
bisexuality	両性愛|両性具有
raillery	(悪意のない)ひやかし|からかい
briny	海|大洋|塩辛い|塩水の|海の|涙の
blasphemer	(神や神聖なものに対して)不敬なことを言う人|冒瀆する人
meteoroid	流星体(大気圏にはいる前に|宇宙にある間の流星)
patois	(仏語)地方なまり
scrumptious	優美な
skyrocket	ロケット花火|流星花火|狼煙|急に上昇する|急騰する|値上がりする
antimatter	反物質
preteen	13歳未満の子供
antinuclear	原子力開発に反対の|反原子力主義
disincentive	意欲をくじくもの|行動を妨げるもの|行動を抑制するもの|阻害要因|経済成長を阻害するもの|がっくりさせる|意欲をくじく
encamp	〈兵士・部隊など〉‘を'野営させる|(テントで)〈部隊などが〉野営する
octavo	八つ折り判(全紙を八つ(16ページ)に折った大きさ)|八つ折り判の本
standing	立っている|永続的な|状態|地位|身分
womankind	婦人|女性
mufti	(通常は軍服など制服を着ている人たちの)平服|服|(イスラム法を適用する際の)法典説明者
straiten	(特に財政的に)困らせる|難儀させる
unfeigned	偽らない|真実の(genuine)
civilize	教化する|洗練する
acerbic	刺々しい|酸っぱい|苦い|渋い
caput	頭|頭部
readymade	既製[品]の|(思想・意見などが)独創性のない|受け売りの
councilor	議員|評議員(UK英=councillor)
aplenty	たくさんの･に|豊富
catenary	垂曲線|懸垂線
odium	憎悪|反感|汚名|悪評
ciliate	繊毛虫(ゾウリムシなど|繊毛のある微生物)
ersatz	代用品|模造品|イミテーション|代用の
matriculation	大学入学許可|入学資格試験
sevenfold	7倍の|7重の|7倍に|7重に
honeybee	ミツバチ
legatee	遺産受取人
parakeet	インコ
bitchy	うるさい女
stipple	〈U〉点彩(点画|点刻)[法]|点彩(点画|点刻)による作品|〜‘を'点彩(点描|点刻)する
bungee	バンジージャンプ
truculent	痛烈な|野蛮な|凶暴な|喧嘩腰の
whoso	=whoever
cementum	(歯の)セメント質
dehydrate	〜'を'脱水する|脱水状態にする|水分を失う|〈体が〉脱水状態になる
bumble	もごもごしゃべる(=mumble)
coir	ココヤシの実の外側の毛で作ったロープ・マット用のじょうぶな繊維
drawstring	締めひも(袋の口やそで口などを締める)
lesbianism	(女性間の)同性愛
radiolabeled	放射性標識された
biochemist	生化学者
attendee	出席者
milkman	牛乳屋|乳しぼり人|牛乳配達人|乳絞りの男
tuff	凝灰岩|すごい|抜群の
anyplace	どこでも
sequent	(時間的に)次の|次に起こる|(論理的に)結果として生じる
following	次の|以下のような
impugn	非難する|論難する|異議を唱える|反駁する|疑いを差し挟む
neuropeptide	ニューロペプチド|神経ペプチドといい|神経が分泌するホルモンなどの総称
limn	を描く|描写する
henna	(植物)ヘンナ(髪を染める染料ができる)|染料(赤褐色)
lamella	(組織・細胞などの)薄板|薄膜
extremal	極値
handily	手近に
salivation	つばを出すこと;だ液分泌過多|流涎(りゅうぜん)
whirr	whir
cuppa	1杯のお茶
egoist	利己主義者|自己中心的な人|うぬぼれの強い人
contort	をねじる|本来の意味を曲げて解釈する
blessedly	幸いにも
syllogistic	三段論法の;演繹(えんえき)的な
volcanism	火山作用|火山現象
grater	おろし金(がね)
krill	オキアミ
mineralogical	鉱物学的の
sarcomere	筋節|サルコメア(骨格筋線維の収縮単位)
trousseau	嫁入り道具(衣装)
curvaceous	(女性が)曲線美の|セックスアピールのある
immodest	慎みのない
aridity	不毛|無味乾燥
earplug	耳栓
shortbread	ショートブレッド
milliliter	ミリリットル
seesaw	シーソー遊び|変動する
topside	(特に牛の)腰肉の切り身|上側へ(に|で)|甲板上に(で)
alternator	交流電源|オルタネータ
gravimetric	重量測定の
vocative	呼格(の)|呼びかけの
blinder	目をくらます人(もの)|(馬の)目隠し(= blinkers)|(俗)クリケット|サッカーなどのファインプレー
immolation	いけにえ(犠牲)にすること
nope	Noのくだけた言い方
technocracy	〈U〉テクノクラシー|技術家主義(専門技術者に産業の支配・統制を任せようという理論);〈C〉技術家集団|(C)技術家主義の国家
catechol	カテコール|フェノール類の有機化合物|ウルシオール(漆の主成分)|カテキンなどのポリフェノールほか多くの生体物質の骨格に含まれる
frisky	はね回る|元気に飛び回る
fixing	器具|固定
parishioner	教区民
lengthways	=lengthwise
expropriate	(特に|公共の用にあてるため|個人・企業から)〈私有財産〉‘を'没収する|〈人〉‘から'(財産を)没収する《+『名』〈人〉+『from』+『名』》
autoantibody	自己抗体
biweekly	隔週の|週2回の
trackless	道のない人|人跡未踏の|(雪などで)道の跡が消えた
nihilist	ニヒリスト|虚無主義者|暴力革命主義者
chortle	(うれしそうに･満足げに)声高に笑う|笑い
cyberpunk	サイバーパンク|サイバーパンク作家
kickoff	キックオフ|開始
tittle	ごくわずか|小点|点画|みじんも|少しも|ささやく|しゃべる
fiscally	財政的に
pinto	ぶちの|まだらの|まだら馬|カメラのピント(主にfocusを使う|オランダ語puntoに由来)
sump	水などを集める穴;汚水だめ|(坑底の)水だめ|集水坑|(エンジンなどを)油だめ|油つぼ|《英》=crankcase
electroplate	〜‘に'(通例銀の)電気めっきをする
indomethacin	インドメタシン|非ステロイド性抗炎症薬の一つ|鎮痛作用も持つ
yesteryear	先年
bilge	船底の湾曲部|ばかげた談話
compellingly	強制的に|やむにやまれず
fam	家族
bonanza	大当たり|幸運|大儲け|活況を呈していること|(鉱山中の)富鉱帯
churchman	聖職者|牧師|国教徒
uncompensated	補償されていない
albumen	卵白|(植物の種子の)胚乳(はいにゅう)|=albumin
given	任意の|ある|特定の|と仮定すると|if
hanky	ハンカチ
muskrat	マスクラット(北米産のビーバーに似たネズミ科の動物)
atomism	原子論(すべての物質の窮極的な構成要素はそれ以上不可分な微粒子であるという哲学上の説)
twister	ひねった球|より手
forkful	フォーク一杯|一本のフォークにのる量
jawbone	顎骨|(特に)下顎骨
breathtakingly	息を呑むほど
moisturizer	モイスチャー(保湿剤)
stowaway	密航者
epicentre	震源地
peppery	(食物が)こしょうの(ような)|こしょうのきいた|短気な|おこりっぽい
premeditation	前もって慎重に計画すること
sett	舗道用敷石|(金属加工用の)つぶし型
gat	ピストル|ガン|銃|はじき|火器|銃で武装する|(内陸に入り込んだ)水路
divestiture	脱ぐこと|剥奪|はく奪
tantalum	タンタル(希有金属元素;化学記号は Ta)
undercarriage	(自動車などの)車台|(飛行機の)着陸用装置(車輪)
fencer	フェンシングの選手|剣客|剣士|フェンス(囲い･柵)を作る人
nonpayment	(〜の)不払い|未払い《+『of』+『名』》
stomachache	『腹痛』|胃痛
conservationist	自然保護論者
zealot	(通例けなして)熱狂する人|狂信者|熱狂者
fop	しゃれ者|にやけ男|かっこをつける男
mountebank	いんちき薬売り|山師(やまし)|いかさま師
endocrinology	内分泌学
dragoon	竜騎兵(重装備をした昔の騎兵)|〈人〉‘に'むりやり(〜)させる《+『名』〈人〉+『into』 do『ing』》
whimsy	気まぐれ|物好き|奇抜な言葉･行動
syncopate	(音楽で)〜‘に'切分音をおく|〈語中の音〉‘を'消失させて音節を減らす(例えば overをo'erとするなど)
computerization	コンピューター化|電算化
racquet	ラケット
decompensation	(心臓の)代償不全
looter	＜loot|略奪者
relinquishment	放棄|断念
britches	半ズボン(breeches)
foreshore	前浜(満潮線と干潮線との間の砂浜)|なぎさ|みぎわ
incumbency	義務があること|義務|聖職禄所有者(incumbent)の役目(任期)
fetter	束縛する|足かせ|足鎖|束縛|拘束
butte	差別侵食によって形成された孤立丘
perspire	汗をかく|発汗する
salmonella	サルモネラ菌
circlet	小さな円|飾り環(女性が頭・腕・首につける)
atavistic	形隔世遺伝的な|先祖返り的な
lexis	(特定の言語・分野・個人の)総語彙
reprobation	非難|叱責(しっせき)|神に見放されること
gaiter	ゲートル|側面が伸縮性のくるぶしまでの高さの深靴|甲が布地のオーバーシューズ
esquire	人にesquireの敬称を使う|殿|様|同伴する男
stretchy	伸びる|伸びやすい|伸び縮みする|伸縮性のある|弾力のある|胴の長い|伸び過ぎる
pillbox	ピルボックス|ピルボックス形婦人用帽子|マッチ箱のような家|丸薬入れ|小型の乗り物
feedlot	(家畜を屠殺する前に飼料で太らせるための)飼育用地
snivel	鼻水(をたらす)|泣き言(を言う)|鼻をすする|鼻声
calmodulin	カルモジュリンカルシウム結合タンパク質|(多種類のタンパク質に制御を行うため|様々な細胞機能に影響を与える)
sidewise	=sideways
yttrium	イットリウム(希土類元素;化学記号は Y)
lampoon	激しく風刺する|風刺文
collard	コラード(米国南部で栽培されるケールの一種で食用)|ちりめんキャベツ
yearling	(動物の)満1年子|明け2歳馬
gibe	(for)|ばかにする|とがめだてする|あざける|からかい
sinter	温泉沈殿物|湯の花|焼結製品|焼結する
teeter	シーソーに乗る|動揺する|ぐらつく
dhow	ダウ船(アラビアの帆船)
painkiller	鎮痛剤|猥褻な|反道徳的な
ohm	オーム(電気抵抗の単位)
holdup	強盗
slutty	ふしだらな
marten	テン(の毛皮)
sampler	見本集|選書|取り合わせたもの
gabled	(屋根が)切り妻の|破風(はふ)造りの;(家が)切り妻(破風)のある
malediction	《文》のろい|のろいの言葉(curse)
coeval	同年齢の|同年代の
heavyset	やや太めの|がっしりした
wiper	ワイパー|ふきん|スポンジ|タオル|ハンカチ|手ぬぐい
sobriquet	あだ名|仮名
sextant	六分儀|(ろくぶんぎ|天体や物の高度|水平方向の角度を測るための道具)
rick	積みわら
exigent	(事情などが)切迫した|緊急の|(人が)しつっこい|しきりにせがむ
wintertime	冬|冬期
checkmate	王手詰み|(計画･事業などの)行き詰まり|敗北
lifesaver	命の恩人
kip	キップなめし皮|寝床|キープ(ラオスの通貨単位)
calculative	計算の|打算的な;慎重な|抜け目のない
hl	100リットル(=hectoliters)
trafficker	(悪徳)商人|(麻薬などの)密売人
zee	Zの字
hauteur	傲慢|横柄|尊大
runt	(動物のひと腹の子の中で発育不良の)小さな子|(軽蔑的)ちび
abrade	〈皮膚〉'を'擦傷する;〈毛・岩など〉'を'すり減らす
unquiet	平静でない|落着きのない|不安な
plainclothes	(警官が)私服の
unexampled	前例のない|空前の
suzerainty	宗主権;領主の地位(権力)
unrelieved	単調さを破るもののない|変化のない
scurrilous	(言葉づかいの)下品な|野卑な
downbeat	指揮棒を振り下ろすこと|強拍|減退|零落|(映画など)暗い|悲観的な|のんびり(ゆったり)した
repeater	リピータ(繰り返す人|客)
elocution	演説法|(特に公の場での)優れた話術
carburetor	気化器(エンジンの)
warhorse	(昔の)軍馬|百戦練磨の兵士;(政界などの)古つわもの
semitone	半音
tragedian	悲劇作家|悲劇俳優
episcopate	=episcopacy
mordant	辛らつな|皮肉な|刺すように鋭い|ヒリヒリする|色止め料|粘着剤|腐食剤で処理する
alehouse	=public house
cushy	楽しい
bassoon	バスーン|ファゴット(低音の木管楽器)
hippy	尻の大きい
gridiron	=grill{名}1|《米》フットボール競技場
grouchy	不機嫌な|機嫌の悪い
betide	〈不幸・災難が〉〈人〉‘に'起こる|‘の'身にふりかかる|(〜に)起こる《+『to』+『名』》
subtractive	減じる|減算の
decimation	大量殺害
daguerreotype	(昔の)銀板写真
disunion	分離|分裂|=disunity
saccharine	サッカリン(砂糖)の(ような)|(態度･言葉･声)いやに甘ったるい
forewing	(四枚羽を持った昆虫の)前翅(し)
undies	下着
comprehensibility	理解できること|分かり易さ
fecund	よく実る|多産の|よく肥えた|創造力豊かな
pardonable	許せる
netherworld	下界|地獄
sacerdotal	聖職者の|司祭の;聖職制の
debase	の品性を落とす|の品質を低下させる
peristaltic	(腸壁などの)蠕動(ぜんどう)運動の[ような]
phaeton	フェートン(昔の2頭立て四輪馬車)
bearish	(株式市場が)下がり気味の|弱気筋の|熊のような|乱暴な|無作法な
strychnine	ストリキニーネ(有毒の結晶で中枢神経の興奮剤)
invincibility	無敵|無敵の
stanch	を止める|の血を止める
imidazole	イミダゾール|含窒素芳香複素環式化合物の一つ
underemployed	不完全雇用の|能力以下の仕事に従事して(いる)
acrostic	アクロスティック|(数語の語頭などにある語句を折り込んだ遊戯詩･文字遊び)
diatomic	(1分子中に)2原子の(を含む)
sanctimonious	信心ぶった
southbound	南へ向かう|南行きの|南方への旅の
olfaction	嗅覚
sass	生意気|に生意気な口を利く|口答えする
favouritism	=favoritism
smokeless	煙のない|煙を出さない|無煙の
unclouded	澄み切った|かげりのない
rawhide	生皮|生皮のむち(で打つ)
rosebush	バラの木(茂み)
subdomain	サブドメイン
metalloproteinase	メタロプロテイナーゼ|タンパク質分解酵素
unimpressive	印象的でない
bream	ブリーム(ヨーロッパ産のコイ科の淡水魚|うろこは模造真珠の塗料になる)|タイ科の海産魚
communalism	地方自治主義|地方分権主義
schismatic	分裂の(を引き起こす)|宗派分立論者
pentagram	=pentacle
recitative	レチタティーヴォ|オペラ|オラトリオ|カンタータなどの中に置かれる独唱|叙唱|朗唱と訳される
haddock	タラ(魚)|ハドック|ハドックの身
reciprocation	お返し|仕返し|交換|往復運動
sirloin	サーロイン･ステーキ
tympanum	中耳|鼓膜
benzoate	ベンゾアート(安息香酸エステル)
knickknack	おもちゃ|装飾品
classless	(社会が)階級制度のない|(人が)特定の社会階級に属さない
dropper	落とす人|点滴器
hindquarter	(牛・羊などの体の)後四半部の肉・後部・臀部・《複数形で》(動物の足を含めた)腰から下の部分
improv	即興
multitask	マルチタスク|複数処理の
unstained	汚れのない
etymologically	語源
abbreviate	短くする|省略する|短縮する
roundhouse	(中央に転車台がある)円形機関車庫|後甲板|大ぶりの(パンチ)|(野球)大きく曲る(スローカーブ)
wah	ウワーン|泣き声
inclose	=enclose
fissile	分裂しやすい|核分裂性の|分裂性|核分裂性
tactician	策士|戦術家
aquamarine	藍緑色|藍玉(緑柱石の一種|3月の誕生石)
hallow	〜‘を'神聖にする|神聖なものとする
gaff	ギャフ(魚かぎ|魚市場等で魚を引っかける道具)|斜行する(海上用語)|ひどい|じっとたえる
beardless	ひげのない|青二才の
organochlorine	有機塩素系殺虫剤
copulate	交尾する
cambric	(上等の)白麻布
syndromic	症候群の
salubrious	健康によい;健康的な|健全な
pigtail	(少女の)おさげ髪|豚の尾
mischance	不運|不幸|災難|不運な(不幸な)でき事
quayside	波止場地域|(quay|波止場)
ectoderm	外胚葉
bil	billionの略|10億
oleander	西洋キョウチクトウ
sandbag	砂袋|土のう(水害・銃撃のときの防壁用;また凶器にも用いられる)|(防御手段として)〜‘に'砂袋(土のう)を積む(置く)|〜‘を'砂袋で打ち倒す|《米話》〈人〉‘に'(〜を)強制する《+『名』〈人〉+『into』+『名』(do『ing』)》
turning	回転|旋回|転向|曲がり角|構成|形成
electroencephalogram	脳電気図|脳波図
accumulative	蓄積する|蓄財する;ためこみ主義の
longsuffering	しんぼう強い|我慢強い
noisome	有害な|悪臭のする|不快な
motet	(聖書の文句に曲をつけた)経文歌|聖歌
endonuclease	核酸を鎖の内部から切断していく酵素をエンドヌクレアーゼという|(逆に鎖の末端から逐次的に加水分解する酵素がexonuclease)|遺伝子組換え技術の中核となる酵素
translatable	翻訳可能な|言い換えられる
octogenarian	80歳(代)の
jag	とがった角
flagstone	敷石|板石
abacus	そろばん
serviceability	役に立つこと|実用性|徳用
eyeglass	めがねのレンズ
halcyon	カワセミ|カワセミの|のどかな|平穏な|穏やかな|幸福な|はなやかな|繁栄の
caballero	(スペイン語)紳士|騎士|乗馬者
parliamentarian	国会議員|議会人
offbeat	風変りな|突飛な
superannuation	老齢退職;老朽|退職者年金
toddy	ウイスキーなどに湯･砂糖･レモンなどを加えた飲み物
acme	(完成度の)極地(美しさ･技術などについて)|絶頂|頂点
printable	印刷できる;出版に適した
bobcat	ボブキャット|北米産のヤマネコ
menthol	メントール|ハッカ脳(薬・香料に用いる)
polarize	対立する|二極間に分かれる|極性をもつ
hardihood	大胆(boldness);ずぶとさ|厚かましさ
gerbil	アレチネズミ|スナネズミ
easternmost	最も東方(東部)の|極東の
tearoom	ティールーム|喫茶店
worktable	仕事台
cupid	美少年
underling	下役|手下
heterozygosity	(生科学)異型接合(性)|ヘテロ接合(性)
washing	洗うこと|洗濯|洗濯物|洗浄液|めっき|水仕事
spirochete	スピロヘータ|らせん状の形態をしたグラム陰性の真正細菌の一グループ|(Spiro=らせん状の)
antipyretic	熱さましの|解熱の|解熱剤
airtime	放送時間
closing	終りの
poliomyelitis	小児麻痺
fuchsia	フクシア|非常に鮮やかな赤紫色のこと|アカバナ科の植物フクシアにちなんで名づけられた|後にマゼンタと名づけられ|フクシャとマゼンタはしばしば同一視される
fungible	代替可能の|(金銭･穀物など)代替可能なもの|代替物
liberalize	自由化する|寛大になる
astrocyte	星状膠細胞
conquistador	征服者|16世紀にメキシコ･ペルーを征服したスペイン人
sympathizer	シンパ|共鳴者|支持者|同情者|同調者
unadjusted	未調整
unscrew	ねじを抜く
overcharge	過充電|不当に請求する
whaler	浮浪者|並外れたもの|メジロザメ|捕鯨船|捕鯨船員
renter	賃借人|貸し手
cohabit	同棲する
deface	の外観を損う