vertiginous	グルグル回る|目が回るような|目まぐるしい|目まいがする|旋回する|不安定な|変わりやすい
sierra	連山|山脈
reissue	再発刊物|再発行|新版|再び出る|に再発行する|再支給する
chorea	舞踏病(顔面筋および四肢のけいれんを起こす神経系の病気)
pullover	(頭からかぶる)プルオーバー
forswear	誓ってやめる
wank	オナニー|自慰行為
photogenic	写真写りの良い|写真向きの|発光する
gladiatorial	(古代ローマの)剣闘士のような
penetrative	浸透性の|入り込む|鋭い|鋭敏な;感銘を与える
naysayer	反対論者|反対|否定する人
hybridize	雑種を作る|かけ合わせる
effeminacy	男らしくないこと|優柔不断
magnesia	マグネシア|酸化マグネシウム
cloaca	下水|便所
bestiality	獣道|非道
herculean	大力を必要とする|非常に困難な|《しばしばHerculean》(特に|力や勇気などの点で)ヘラクレスのような
radiometric	{形}|放射線測定器の(による)
pedophile	小児(性)愛者|子供を性愛対象とする性的倒錯者
aftertaste	後味|余韻
carious	カリエス(caries)性の|カリエスにかかった
debonair	陽気な
acclimatization	=acclimation
washstand	(洗面器・水差しなどを載せる)洗面台|(水道の設備の付いた)洗面台
perm	パーマネント
poach	密猟する|他人の土地などに侵入する|(人の考えなどを)不正手段で盗む|(卵を)割って熱湯の中でゆでる|(魚などを)ゆでる
insubordinate	従順でない|反抗的|反抗的な;(〜に)従わない《+『to』+『名』》
pantyhose	パンティストッキング
speedometer	速度計
walkout	ストライキ|退場
prate	《『prate』 『about』+『名』》(〜を)ぺちゃくちゃしゃべる|くどくどと話をする
snotty	鼻水でよごれた
vivisection	生体解剖|生体実験(すること)|(比喩的)綿密な検査|吟味|厳しい批評
biotite	黒雲母(くろうんも)(火成岩を溝成する主要鉱物)
supplicate	〜を嘆願する|懇願する|〈神・人〉‘に'嘆願する|懇願する|(〜を)嘆願する《+for+名》
cinnabar	辰砂(しんしゃ)(水銀の主要鉱石|赤色または赤褐色)
forgettable	忘れられがちな
dripping	ぽたぽた落ちる|したたること
academe	大学(学究)生活|学界|教育の場(特に大学)
citron	シトロン(の木･実)|その皮の砂糖漬け
radiantly	光･熱を放つ|輝く|嬉しそうに|にこやかに
rapacity	貪欲(greed)
jangle	けんか|じゃんじゃん鳴る
punctilious	作法にやかましい|形式ばった|きちょうめんな
introversion	内向;内向性
lasagne	ラザーニャ(平たい麺(めん)を肉・チーズ・トマトで調理したイタリア料理)|= lasagna
tautological	(同じ意味の言葉が)重複した|類語反復の
multivitamin	マルチビタミン剤|総合ビタミン剤
detente	(国際関係の)緊張緩和|デタント
despoil	(〜を)〈人・場所〉‘から'奪う《+『名』+『of』+『名』》
extirpation	根絶|撲滅
tampon	(生理用)タンポン|止血栓
chaplaincy	chaplainの居場所|chaplainの職(地位|任期)
injudicious	無分別な|無思慮な
sumptuary	節約の;ぜいたく禁止の
riverboat	川船
debenture	債券
viol	バイオル(16|17世紀に用いられた弦楽器で現在のviolin の前身)
beanie	ビーニー(帽)|ベレー|スキー帽
megalithic	巨石遺物の|巨石を造った先史民族の
preponderant	(数量・勢力などにおいて)優勢な|圧倒的な;(〜に)まさっている《+『over+名』》
trice	瞬間
howitzer	大砲|榴弾砲
westerner	西部地方の人|西部生れの人|西洋人
congruity	〈U〉一致|適合[性]|調和;〈C〉《通例複数形で》一致点|〈U〉(数学で|図形の)合同
cordage	なわ類|(船の)索具
faun	フォーン(ローマ神話の林野・牧畜の神で半人半羊の姿をし|みだらな性質をもつといわれる;ギリシア神話ではsatyrと呼ばれる)
inseparability	分離できないこと|不可分
hoarder	財宝管理人;ためこみ屋
effete	時代遅れの|退廃的な|衰えた|(男が)女々しい
requiem	レクイエム|鎮魂歌
bonkers	《英俗》気の狂った
irremediable	(病気・悪習・欠点などが)直せない;(失敗・損失などが)取り返しのつかない
curettage	人工妊娠中絶|掻爬(そうは)[術]
highroad	《おもに英》幹線道路|本道(highway)|《比喩(ひゆ)的に》楽な道
commode	トイレ|移動式洗面台|寝室用便器|lavatoryの遠回しな言い方
chauvinistic	熱狂的(盲目的)愛国主義の|熱狂的性差別主義の
mislay	置き忘れる
ballistics	(単数扱い)弾道学
leotard	レオタード
emollient	柔らかにする|皮膚を軟化する|苦痛を緩和する
lexicographer	辞書編集者
shuck	(皮･殻･さや)を取る(むく)|さや
jiffy	瞬間|ちょっとの間
fracas	けんか|騒ぎ|どなり合い
yep	yes
pupa	さなぎ
choker	首飾り|カラー|短いネックレス
participial	分詞の
stonemason	石工
slothful	不精な
casework	ケースワーク(社会福祉上|身障者・困窮者の調査・保護)
adoptee	里親
relaxant	弛緩薬
occultism	神秘論|神秘主義(超自然・超能力的な力の存在を信じること)|神秘学
hyperbaric	(医療などで)高圧酸素を使った
clapper	舌|拍子木|鳴子
refundable	返金可能な|払い戻しができる
woodman	木樵|きこり|(=woodsman)
fenestration	窓割り(建物の窓や外壁開口部の設計・配置)
affright	《古》〜'を'こわがらせる
abet	扇動|扇動する|(悪事)をけしかける|教唆する
passionless	感情に動かされない|感情的でない|冷静な|熱意のない
quitter	根気がない人|簡単にあきらめる人
strum	(楽器を)下手にかきならす
musicianship	音楽の技能(知識|才能)
brainwave	《しばしば複数形で》脳波|〈C〉《おもに英話》ひらめき|妙案
papery	紙のような|薄い
brandish	振りまわす|大げさに示す
dethrone	退位させる
wifely	妻らしい|妻にふさわしい
furze	ハリエニシダ(《英》gorse)
folklorist	民俗学者
pestilential	悪疫(腺ペスト)の;悪疫をもたらす|有害な;破壊的な|《話》やっかいな|うるさい
byword	通り言葉|はやりことば
unenlightened	あることによく通じていない|無学の|無知の|偏見をもつ
browbeat	脅す
auricle	(心臓の)心耳(しんじ);(耳の)外耳|耳状のもの
buccaneer	海賊(を働く)
ebullient	沸きこぼれる|沸騰している|あふれるばかりの|ほとばしり出る
locum	(医師・牧師などの)代行|代理
racecourse	競争路
living	生き生きしている|生計|暮らし|生命のある|活発な|燃えている|生存|暮らし方
peeler	(野菜などの)皮むきナイフ|警官
comfortless	慰安のない|わびしい|慰められない|悲しみを抱いたままの
zephyr	西風|微風|そよ風|婦人用服地
agoraphobia	広場(空間)恐怖症(広い場所にいることをこわがる神経症)
fireproof	耐火|防火
appertain	(〜に)属する|関連する《+『to』+『名』》
flashpoint	一発触発の危機|引火点
barroom	酒場
interregnum	(国王の死などによる)空位期間|(政治の)空白期間
dropsy	=edema
caldera	カルデラ
goner	死者|死に体|落ちぶれた人|見込みのない人
lexeme	(ˈlɛksiːm)|(文法)語彙素|言語学の形態論的単位|異なる形態だが同じ語の集合|例|child-children|go-goes-went-gone-going|big-bigger-biggest|各同じ語彙素
blacktop	アスファルト道路|アスファルト(で舗装する)
diversionary	注意をほかにそらす|気晴らしの|(軍事行動が)陽動の|牽(けん)制の
alarmist	心配症の人|人騒がせな人
theoretician	理論家
scarp	急傾斜|急坂
guardsman	監視人|州兵|近衛兵|衛兵
phosphatidylcholine	ホスファチジルコリン|細胞膜で最も多いリン脂質で|脳や神経細胞に必要とされる|大豆|卵黄|レバーなどに微量に含まれる
tutu	チュチュ(バレリーナが着る短いスカート)
holdover	前の時代･時期から残った人(もの)|終了予定日を過ぎても続演される映画･芝居|二日酔い
aesthete	唯美主義者|審美家|美術愛好家
endurable	耐えられる|がまんできる
rhapsody	ラプソディ|狂想曲
baronial	男爵(領)の|男爵にふさわしい
weeknight	〈C〉平日の夜
kiddie	子供|ちびっこ
tortoiseshell	〈U〉べっ甲|〈C〉ヒオドシチョウ(タテハチョウの類の一つ)|〈C〉三毛ネコ|べっ甲製の|べっ甲色(模様)の
wastebasket	くずかご|(=trash box)
diehard	最後まで抵抗する(人)|片意地な保守主義者(政治家)
disparagingly	軽蔑して|非難して|けなして
munificence	気前のよさ|物惜しみをしないこと
mouthwatering	(おいしくて|うらやましくて)口からよだれのでるような
insolation	日光にさらすこと|日光浴|日射病
nuclease	ヌクレアーゼ|核酸分解酵素の総称
odorless	においのない|無臭の
drinkable	飲める|飲用に適した
gumbo	オクラ|オクラ入りスープ
peroxisome	ペルオキシソーム(細胞内の極微小な構造を指す)
liquefy	液化する
woodshed	まき小屋
phrenology	骨相学|フレノロジー
halloo	=hallo
armoire	押入れ|戸棚|大型衣裳箪笥
cogently	(議論など)説得力をもって|効果的に|適切に
purebred	純血(種)の
trivet	(鉄製の)三脚ごとく|(食卓用の)小型金属台(熱いものなどをのせる|短い脚がついている)
overtone	付帯的な意味|(思想･言葉など)含み|含蓄|(音楽)倍音
polytheistic	多神論の|多神教の
raindrop	雨粒
recency	時間的に近いこと|最近であること
alliterative	頭韻の|頭韻体の
breccia	角礫(かくれき)岩(角ばった岩片から成る岩石)
puncher	穿孔(せんこう)機|打ち抜き器|パンチャー
wader	水(どろ|雪)の中を歩いて渡る人|=wading bird|《複数形で》(釣り人がはく腰まである)防水長靴
shamefaced	恥じた|恥じ入った|はにかむ|内気な
kith	[今は成句のみに用いて] 友人|隣人|同胞|知己; 親戚 (kindred)
untruthful	真実性に欠ける|事実に反する|うそをつく
unflagging	衰えない|疲れを知らない
holography	レーザー写真術
permanganate	過マンガン酸塩
discontinuance	中断|中止|断絶|廃止
agog	(期待･興奮で)わくわくして|～したくてうずうずして
matt	(表面が)光沢がなくくすんだ|(写真など)つや消しの(面)|の表面をつや消しにする
dowdy	流行遅れの|だらしない|むさくるしい|野暮な|時代遅れの|みすぼらしい
nastiness	意地の悪さ
seamanship	航海術|操船術
platitude	決まり文句|陳腐|平凡
orientalist	東洋学者|東洋に通じた人
nerveless	勇気のない|意気地のない|力のない(weak)|冷静な|落ち着いた(calm)|神経のない;葉脈(翅脈)のない
primogeniture	長子であること|(またright of primogeniture)長子相続|長子相続権
unpatriotic	愛国心のない
unctuous	なめらかな|脂質の
lyricism	叙情主義
imprimatur	許可|認可
indiscernible	目に見えない|識別できない
antrum	骨の空洞|(特に)上あご骨の空洞
languorous	けだるい
flatmate	フラットの同居人
damned	のろわれた
polygyny	一夫多妻|(植物の)多雌ずい性
denizen	(ある場所の)住人|生息するもの|外国人居住者|外来語|外来動植物
wondrously	驚くほど
microelectronics	マイクロ電子工学
taffeta	タフタ|コハク織
sniffer	くんくんかぐ人(動物)|におい探知器
crus	下腿
fumigation	(部屋などを)いぶして消毒すること
nosegay	(特に|服につける香りのよい)小さな花束
blockhouse	丸太・角材造りの防塞(ぼうさい)(銃眼があり|真下が射撃できるように2階の部分が1階より突き出している)|小要塞|角材造りの小屋|ブロックハウス(ロケット発射台の近くにある観測・制御者が待機するコンクリートの建物)
speakeasy	(禁酒法時代の)もぐり酒場
cosmogony	宇宙成因論|宇宙生成論(宇宙の起源・生成などを扱う天文学の一部門)|宇宙創造説(宇宙の起源・生成に関する学説・物語)
coterminous	=conterminous
psychosexual	性心理の
lugger	ラガー|lugsail(ラグスル|四辺形の帆の一種)を有する小帆船
outrank	より高い地位を占める|重要性でに勝る|より上位にある
waddle	ゆらゆらしながら進む|よたよた歩く(こと)
estrus	発情(期)
earthwork	土塁|土工作業
inconstancy	変わりやすさ;移り気|浮気
purifier	ピュリファイア|清浄器
talon	(猛禽の)つめ|つかみかかる手
swordfish	メカジキ
bowsprit	船首斜檣(しゃしょう)|やりだし(船首から前方に突き出た円材)
extralegal	超法規的
subhuman	人間以下の|(人間よりは)動物に近い|人間に近い|類人の
debauch	〈人〉'を'堕落させる;〈生活など〉'を'退廃させる|放蕩(ほうとう)|道楽;らんちき騒ぎ
escapist	逃避主義の人|現実逃避の
beadle	教会区典礼部役員(昔教区の雑事などをした役人)|(英国の大学の)職権標識奉持役(大学の行事に際して標識を持って先導する)
equable	一様な|均等な|(気分・気性などが)穏やかな|平静な
eyesore	目障りなもの
feckless	無効な|無能な|役に立たない
measurably	測ることができるほどに
railcar	レイルカー|気動車(ディーゼルあるいは電気で単独でも動かせる鉄道各車)
randomize	ランダム化する
baize	ベーズ(玉突き台などに張る緑色の柔らかい毛織地)
galvanometer	(微少電流の)検流計
ennoble	高尚にする
bodywork	(車の)車体
firecracker	爆竹|爆弾|爆筒|癇癪玉|魚雷
unfunded	未積立
largeness	(形・数量・程度などの)大きいこと|巨大|広大|多大;(包容力・活動・興味などの)幅の広いこと|寛大
peradventure	たぶん|おそらく|《『if』または『lest』の後に用いて》偶然に|ひょっとして
precipitant	まっさかさまに落ちる|大急ぎの|まっしぐらの
thundercloud	雷雲
iconoclast	聖像破壊者|因襲打破を唱える人
apoplectic	卒中(性)の|卒中の発作|おこって|ひどく興奮して
surplice	サープリス(聖職者|聖歌隊などが着る|そでの広い長い白の法衣)
drench	びしょ濡れ|浸す
stationer	文房具商
codicil	遺言書の補足条項;(一般に)補足
gizzard	(鳥の)砂のう|《話》胃腸
thickener	=thickening1
sainthood	聖人の位
wonky	ぐらぐらする|不安定な|ゆがんで|信頼できない|不調な|正常でない
insularity	島であること|島国根性|孤立|狭量
plaudit	拍手かっさい|賞賛|拍手|喝采
teat	乳首|(哺乳動物の)乳頭|小袋|乳頭状突起|哺乳瓶の乳首
unsparing	けちけちしない|物惜しみをしない|遠慮会釈のない
northbound	北方行きの
prudish	極端に潔癖でお堅い|淑女ぶる|とりすました
ubiquitously	遍在的に
atomizer	噴霧器|香水吹き
workaday	平日の|仕事日の
bigamy	二重結婚|重婚
drearily	わびしく;気をめいらせて|退屈させて
fab	素晴らしい|驚くべき|信じ難い
incognita	謎の女|素性の不確かな女|(女性の)素性が不確かな
palaver	おしゃべり|むだ話
inundate	水浸しにする|氾濫させる|充満させる
abyssal	深淵(えん)の;深海の
nutriment	〈U〉〈C〉栄養分|養分;食物(food)
gumption	積極性|進取の気性|勇気|ガッツ|世智|世才
camisole	キャミソール(婦人用の昔の袖なし下着)
flummox	〈人〉‘を'まごつかせる|当惑させる
actuate	〈機械など〉'を'動かす|《通例受動態で》〈動機などが〉〈人〉'を'行動させる|動かす
chimp	chimpanzeeチンパンジー
hawser	(停泊･曳航(エイコウ)用などの)大綱|大索
instep	甲|足の甲|((反)sole)
mousy	おとなしい|おどおどした|ネズミ色の|ネズミの|ネズミの多い|ネズミ臭い|内気な
whispering	ささやき|うわさ(話)
rewire	に返電する|の配線を替える|配線し直す
tactless	機転のきかない
hailstorm	あられを伴う嵐
boll	(bóʊl)|(綿・亜麻の種子の入った)丸い莢(さや)
careworn	(人・顔などが)苦労でやつれた
stoical	ストア派哲学の|禁欲の
baneful	有害な|有毒な
rayon	レーヨン|絹に似せて作った繊維|人絹(人造絹糸)や|ステープル･ファイバーからスフと呼ばれていた|Rayonは光線(ray)と綿 (cotton) の合成語
slaw	スロー|coleslaw(細かく切ったキャベツを使ったサラダの一種)
boatload	最大積載量
uproarious	騒々しい|騒然たる|爆笑させる|ひどくおかしい
wildflower	野生の花|野草
rarefaction	(気体の)希薄化|希薄状態
tussock	草むら|茂み
factitious	人為的な|人工の|故意に作られた
tetralogy	四徴 (病気の特徴を示す4種類の徴候)|四幕|オペラ|小説などの四幕構成
groggily	ふらふらして|千鳥足で
rapine	略奪|強奪
counterpane	(装飾的な)ベッドカバー(bedspread)
scud	すばやく動く|疾走する(こと)|ちぎれ雲|スカッドミサイル|第二次大戦中ドイツが開発したV2ロケットのソ連版コピー|TEL(Transporter Erector Launcher)から発射でき機動力に優れる
achy	うずく|痛みのある
braggart	ほら吹き|自慢(話)|ワラビ|蕨の茂み
eruptive	噴出する;突発する;爆発しがちな|噴火する;噴火による
phosphatidylinositol	ホスファチジルイノシトール|真核生物の細胞膜の細胞質側に存在するリン脂質の一つ
hysteric	=hysterical|《複数形で》ヒステリーの発作|〈C〉ヒステリー患者
mojo	魔法のパワー(a magic power)|魔法の呪文(a magic spell)
icicle	つらら|氷柱
unlisted	リストされていない|電話帳に載っていない|(株式)非上場の
bestir	〈わが身〉'を'奮起させる
generalship	将軍としての才能と手腕|(一般に)指導性|リーダーシップ|将官の地位(身分)
infinitude	〈U〉無限|無数|〈C〉無限大の数量
proscenium	プロセニアム|前舞台|幕の前部|前景
jowl	顎(特に下顎)
stapes	(中耳)あぶみ骨
backgammon	バックギャモン|西洋すごろく
birthrate	出生率
anchorite	隠者|世捨て人|隠世者(hermit)
bey	ベイ(中東の高官の称号)|ベイ(Mr.に当たるトルコ語)
constrictive	締めつける|圧縮する
derrick	油井やぐら
truancy	無断欠席|無断欠勤|skip school
bouillon	ブイヨン|ブイヨンスープ|肉汁
yearlong	1年続きの|1年を通じた
climatology	気候学
lea	草原|草地|牧草地
belligerence	交戦|闘争性
sty	ものもらい|豚小屋
accolade	絶賛|栄誉|ナイト爵位授与の儀式
mugger	追い剥ぎ
broadcloth	幅広の黒ラシャ|ブロード(緻密な木綿・絹・レーヨンなどの生地で|ワイシャツ・パジャマ・婦人服などに用いる)
collusive	なれ合いの|共謀の
haywire	干し草を縛る金具|針金|(口)興奮した|気が狂った
cortisone	コーチゾン(副じん皮質ホルモンの一種|関節炎の治療剤)
endue	〈人〉‘に'(資質・才能などを)与える|授ける《+『名』〈人〉+『with』(『in』)+『名』》
roomful	部屋いっぱい|満座の人々
primus	監督長|1番目の|最年長の|首位の|第一の
drear	=dreary
cerulean	空色|空色の
carbuncle	癰(よう)|疔(ちょう)(悪性の吹き出物)|ざくろ石;《古》紅色の宝石(紅玉など)
chiropractic	脊柱指圧療法|カイロプラクティック
overweening	うぬぼれた|思い上がった|ごう慢な
decal	デカール(decal|decalcomania(転写法･転写画)の略)|印刷･加工済のシート|シール|ステッカー|Tシャツなどにアイロンで貼り付ける写真や絵|転写する
grindstone	回転砥石
motorcade	自動車行列
protester	抗議する人|抗議者|抗議団体|異議を申し立てる人|主張者
thereunto	それに|そこへ
cyclonic	熱帯(温帯)性低気圧の;大たつまきの
indelicate	粗野な|ぶしつけな|下品な
perfumery	〈U〉《集合的に》香料|〈C〉香水製造(販売)所|〈U〉香水製造(販売)業
policymaker	政策担当者
splanchnic	内臓の
rotatory	(形容詞)回転する(させる)　交代する　循環する　輪番の
paediatrician	=pediatrician
haversack	《まれ》(兵士の食料・衣類を入れる)雑のう
breadfruit	パンノキ|パンノキの実(メロン大で果肉の主成分は澱粉)
fusillade	一斉射撃|一斉攻撃
incinerate	焼いて灰にする|焼却する
playable	(競技場が)競技に適した|(クリケットで投球したボールが)打てる
aero	航空の|航空学の
sportive	遊び戯れる|ふざける(playful)
calcineurin	カルシニューリン|細胞内シグナル伝達に関るタンパク質|高等動物から酵母まで全生物細胞にある|高等動物では一部の免疫抑制剤の標的とし|免疫系で重要な役割を持つ
grandiosity	雄大|壮大|大げさ|ぎょうぎょうしさ
misapply	〜‘の'適用を誤る|‘を'乱用する
pinna	(動)羽|翼|ひれ|ひれ足(flipper)|耳殻|耳介(auricle|耳穴の周りにある音を集める構造)|(植)(シダの葉など複葉の)羽片
trow	=believe|think　信じる　思う
raptor	猛禽類
droopy	うなだれた|意気消沈の|疲れ果てた|垂れ下がった
supermodel	スーパーモデル
sib	(síb)|血縁者|親類の人
bedlam	混乱|気違いざた|騒々しい混乱の場所
napalm	ナパーム弾(Napalm bomb)|主燃焼材のナフサにナパーム剤と呼ばれる増粘剤を添加した油脂焼夷弾|米軍が開発|極高温(900-1|300度)で燃焼し|広範囲を焼尽する
pretender	要求者|詐称者
lor	ああ!|あら!
molding	型で作ること|造形
snooker	玉突きの一種|〜‘を'じゃまする;〜‘を'負かす
macrocosm	《the ~》大宇宙|〈C〉(小さな体系を含む)大体系
slosh	うろつきまわる|はね飛ばす|(水などを)ぼちゃぼちゃする
submergence	水中に沈めること|水没|浸水
sturdily	たくましく;がんじょうに;がん強に
sentimentalist	感傷的な人|多情多感な人|涙もろい人
hypnotist	催眠術師
mistrial	誤審|裁判での誤った判決|無効審理
profanation	〈U〉神聖を汚すこと|冒瀆(ぼうとく)|〈C〉冒瀆行為
eventuate	(〜の)結果になる|結局(〜に)なる《+『in』+『名』》
newsman	ニュース番組のレポーター|取材記者
proconsul	(古代ローマの)地方総督;(近世の)植民地総督
speechwriter	スピーチライター
openmouthed	口を開けた|(特に驚いて)口をあんぐりと開けた
lawmaker	立法者|legislator|(国会)議員
mutualism	共生
potluck	あり合わせのもの
pocketknife	折りたたみ式小型ナイフ
vibrato	ビブラート|震動音
sinecure	(実務はないが報酬のある)閑職
quarterdeck	後甲板(最後尾マストと船尾の間の間;おもに高級船員用)
indoctrinate	に教え込む|吹き込む
tuner	調律師
dehumanize	から人間性を奪う|機械的な存在にする|非人間化する|非人間的にする
gluttonous	食いしんぼうの|大食の|(〜に)どん欲な《+『of』+『名』》
freewheel	(ペダル・エンジンを止めて)惰性で走る|自由に行動する|(自動車の)自由回転装置|(自転車の)自在輪
unstuck	しっかり留められてない|くっついていない|うまくいかない
unmeaning	無意味な|くだらない・(顔・表情などが)うつろな
gnocchi	ナキ(小麦粉・じゃがいも・チーズ・卵を蒸しだんごにしたイタリア料理)
televisual	テレビ放送向きの
calypso	カリプソ(西インド諸島の即興的民謡)
cambium	形成層(植物の幹や根の木部と樹皮部の間にある柔らかな組織層)
magnetosphere	(地球の周囲の)磁気圏
understaffed	人員不足の
confectioner	菓子製造(販売)人|菓子屋
astrophysical	天体物理学の
reassign	再び割り当てる
waggle	揺れる|振れ|揺れ動く|を振る|揺する|振れる
insecticidal	殺虫剤の|殺虫の
solidus	ソリドゥス(ローマ帝国の金貨)|(日付・分数などの)斜線(oblique)
twisty	曲がりくねった
lockup	留置場|拘留所|刑務所
obviousness	明白さ
disappointingly	がっかり
turpitude	邪悪|卑劣
oilskin	〈U〉油布|防水加工生地|〈C〉レインコート;《複数形で》防水服上下
couldst	=couldの二人称単数形
censorious	厳しく詮索する|あら探ししたがる|非難を表わす
fps	feet per second
whin	ハリエニシダ
headliner	主役スター
milligram	ミリグラム
pebbly	小石の多い
fishnet	魚網
counterrevolution	反革命
ragtag	社会のくず|下層民
bauble	つまらないもの|安ピカもの|子供の玩具|子供じみたこと
pseudonymous	ペンネームで書かれた|偽名(変名)を用いる
steersman	舵手(だしゅ)|かじとり|(自動車などの)運転手
dogwood	ハナミズキ|アメリカヤマボウシ
waterhole	水たまり|泉|パブ|ホテル
transgressor	違犯者|(特に宗教･道徳上の)罪人|違反者
chemotactic	走化性の
monozygotic	一卵性の
superpose	(〜の上に)〜‘を'重ねて置く《+名+on(upon)+名》|(幾何で)〈図形〉‘を'重ね合わせる
hailstone	あられ|ひょう
spineless	背骨の弱い|刺のない
transom	横棒|横木|窓の横仕切り(反|mullion窓の縦仕切り)|欄間
huckster	呼び売り商人|行商人|押しの強いセールスマン|金目当てに働く人
perfunctorily	おざなりに
kingpin	中心人物
rehear	(裁判で)〜‘を'再審理する
expostulation	いさめること|訓戒;説伏
hibernate	冬眠する|冬ごもりする|避寒する|引きこもる
spry	活発な|すばやい
negligee	ネグリジェ
saleable	=salable
illusive	錯覚を起こさせる|迷わせる
recalculate	計算し直す
guardhouse	衛兵所|留置所
pinnate	(葉が)羽状の
munition	軍需品(munitions)
superfine	(商品などが)極上の|最上の;superfine cloth 極上の布|余りにも細かい|極微粒でできている
coadjutor	補佐司教|補助司教|助手|補佐役
monocle	単眼鏡|片めがね(目のくぼみにはめて用いる)
rookery	みやがらす(rook)の群居する所(森);ミヤマガラスの群れ|アザラシ(オットセイ|ペンギンなど)の繁殖場
akimbo	両手を腰に当て|肘を張って(with one's arms akimbo)
waterman	漕ぎ手|船頭|漁師|こぎ手
metaphysician	形而上学者
plotter	プロッター
cogeneration	コージェネレーション
wampum	貝殻玉|磨かれた貝殻から作られ|ひもやベルトに使われる小さな円柱形のビーズ
bleakly	荒涼として|冷たく|暗く|わびしく
mismanage	〜‘の'管理(経営|取り扱い)を誤る
polytechnic	工芸の|工芸学校|科学技術専門学校
suffragette	女性の婦人参政権論者
blandishment	ごきげん取り;甘言
footing	(しっかりした)基礎|(確固たる)地位|足がかり|足場|加算|総計
macromolecule	高分子
tarn	タルン|小湖|氷食でできた盆状の湖
bankroll	融資する|資金を出す
contralto	〈U〉コントラルト(tenorとsopranoとの間で女性最低音)|〈C〉コントラルト歌手|コントラルトの
congruency	=congruence
heliocentric	地動説the heliocentric (Copernican) system(theory) (反)geocentric theory
spyware	スパイウェア
circumlocution	まわりくどさ|婉曲な言い方|言い抜け|遠回し
frond	葉状体|(シダ･海そうの)葉
packer	荷造り人
toasty	トーストの
newscaster	ニュースキャスター
cogitation	〈U〉熟考|熟慮;思想力|〈C〉《しばしば複数形で》熟慮の結果;考案|着想
airspeed	(飛行機の)対空速度|対気速度
jabber	ぺちゃくちゃしゃべる|きゃっきゃっと叫ぶ|早口にしゃべる|おしゃべり
kudos	名声|栄誉|威信|賞賛
cuteness	かわいらしさ
dilatory	のろい|遅々とした|遅れた
astrophysicist	天体物理学者
lefty	左利き
amputate	切断手術をする
durum	デュラム小麦(マカロニ・スパゲティを作る原料)
retroviral	逆転写酵素を有するRNAウイルスの|レトロウイルスの
windstorm	暴風
acceptation	(語句の)一般に認められた意味
directorial	指揮者の|指揮上の
antihistamine	抗ヒスタミン剤
polythene	=polyethylene
enzymatically	酵素的に cf|enzyme(酵素)
wallflower	壁の花(舞踏会で相手のいない女性)　(植物)ニオイアラセイトウ
prioress	女性の小修道院長;(時に)女子修道院の女副院長(abbessの次に位する)
leguminous	マメの|マメ科の
anthracite	無煙炭
oaf	とんま|のろま|取替え子|(希に)低能児
rood	《古・文》(特に|祭壇の上の大きな)十字架上のキリスト像|《現在まれ》ルード(土地面積の単位で1|4acre)
excommunicate	(教会から)〈人〉‘を'破門する
graceless	無作法な
architrave	台輪(だいわ)(古典建築のentablatureの最下部で柱の上に直接のる)|(ドア・窓の)化粧縁|装飾縁
parlay	賭の元金と配当もさらに賭けていく
upturn	景気上昇
overpayment	払い過ぎ
carbocation	カルボカチオン(正に帯電した炭素を含む化合物)
cockade	花形帽章(階級などを表してつけられたが|現在は装飾用)
sidle	横歩きで進む|こそこそ歩く
corticosterone	コルチコステロン|副腎皮質で合成される副腎皮質ホルモンのうちのステロイド系ホルモン
cyanobacterial	藍色細菌の
trioxide	三酸化物、三酸化の、3酸化・化合物の中の酸素数が3個のもの。一酸化=monoxide。二酸化=dioxide。三酸化=trioxide。四酸化=tetroxide。五酸化=pentoxide
immunoreactive	免疫反応性
periwinkle	[ツル]ニチニチソウ|タマキビ貝(食用の巻き貝)
gravedigger	墓掘り人
antineoplastic	腫瘍(しゅよう)の成長を防止する
amniocentesis	羊水採取(胎児の性別・染色体異常診断のために羊水を調べる方法)
banditry	追いはぎ(強盗)すること
buckboard	(米西部やいなかで用いる車体を木で作った)軽四輪荷馬車
hatter	帽子屋;帽子製造人
cognizable	認識できる|裁判所の管轄内の
daredevil	がむしゃらな人|向こう見ずの人|命知らず|向こう見ずな|命知らずの|無謀な
manhunt	犯人追跡
sonny	坊や
creationism	創造説(宇宙や生命の起源を創世記に書かれた「創造主なる神」に求める考え方)
spasmodically	けいれん的に|発作的に
torah	律法
appendectomy	虫垂切除[手術]
seneschal	(中世の王族・貴族の)執事|家令
hitchhike	ヒッチハイク
rhabdomyosarcoma	横紋筋肉腫
caesura	中間休止(詩行の中間で意味の切れによる休止)
metalanguage	〈U〉メタ言語(言語を論じるための表現・語句)
secant	(三角法で)セカント|正割・(幾何で)割線・(数学)切る・(線または面が)交わる|交差する
trophoblast	栄養膜
cagey	抜け目のない
ineradicable	根絶できない|根深い
sublet	転貸する
wrack	波に打ち上げられた海草|難破船|漂着物
metaphase	(生物学用語)中期(核分裂の)|細胞分裂で染色体が赤道板状に並んだ時期
mouthpart	口器(節足動物の口の周辺にある付属器官)
dipstick	計深棒(内燃機関内の油の深さを測る棒)
hawker	行商人|鷹匠|飛翔中獲物を捕る虫
vasectomy	精管切除[術]|パイプカット
gonad	性腺(せん)|生殖腺
anorexic	拒食症の
tracing	さかのぼる|透写|追跡|捜索|複写
undertow	あとびき|引き波|下層流|逆流
escutcheon	紋章の描かれた盾(たて)|盾形の紋地
neutropenic	好中球減少
bandstand	野外ステージ
theist	有神論者
blackbody	黒体(その表面に投射するすべての電磁波を吸収すると物理学的に仮定される物体)
coherency	=coherence
lunchbox	弁当箱
wingless	翼のない
prodigality	浪費|放蕩|(いくら使っても尽きないほど)たくさんあること
bawl	わめく|叫び|大声でわめく|しかる|ワーン|泣き声
rhinestone	ラインストーン|ライン石
aeronautics	航空学
craftily	ずるく|悪がしこく
cockney	ロンドン子|ロンドン言葉|ロンドン下町なまり|ロンドン子の
carpool	自動車の相乗り
semolina	セモリーナ(マカロニ・プディングの原料となる粗い小麦粉)
calligraphic	書道の|能筆の
dietician	栄養学者|栄養士|食事療法士
geocentric	地球を中心とした|地球の中心から見た|天動説|(反)the heliocentric (Copernican) system(theory)
proofreader	校正者
ablution	《複数形で》(宗教上の儀式としての)沐浴(もくよく)
scallion	ニラネギ|ワケギ|若玉葱|ラッキョウ
repaint	塗り直し|塗り直したもの|にペンキを塗り直す
paraplegia	対麻痺(ついまひ)(病気による両下肢(し)の麻痺)
punchline	punch lineジョークなどの話の急所|落ち
mailman	郵便集配人
woodwind	木管楽器|《the woodwinds》(オーケストラの)木管楽器部|木管楽器の(から成る)
endocrinologist	内分泌学者
brucellosis	ブルセラ病|波状熱|動物の流産や人間の弛張(しちょう)熱の原因となる
madwoman	気違い女|狂女
microsome	ミクロソーム|細胞をホモジナイズ(すりつぶす)して遠心分離すると|最初に核が|次にミトコンドリアが沈殿し|最後に上澄みから得られる小胞体などを含む部分|タンパク質合成活性などがある
ubiquitination	ユビキチン化|ubiquitinは多数のアミノ酸でなるタンパク質で|他タンパク質の分解|DNA修復等生命現象に関わる|保存性が高く全ての真核生物でほぼ同じアミノ酸配列を持つ|真正細菌にはない
oligo	オリゴ糖(oligosaccharide)とは|単糖類同士が結合した多糖化合物で|ビフィズス菌などの腸内善玉菌を増やす効果で知られる
ragtime	ラグタイム1900年前後にアメリカで流行したピアノ中心の音楽|(time lagとは異なる)
tuneful	旋律の美しい
fistfight	拳骨での殴り合い
entrain	〜‘を'列車に乗せる|列車に乗る
elderberry	アメリカニワトコの実|=elder
flagellum	(バクテリアなどの)鞭毛(べんもう)|むち
meddlesome	(うんざりするほど)おせっかいな
radiometer	ラジオメーター|放射計
modeler	模型製作者
porno	ポルノの|ポルノ|ポルノ作家
masterwork	傑作
catlike	猫のような|ゆだんのない;足音を忍ばせた
workgroup	ワークグループ
coleslaw	キャベツサラダ
thusly	次いで|こうして
overheat	過熱する|過度に興奮させる|過度の興奮
deerskin	鹿皮
gamely	勇敢に(game:遊び･闘志･勇気の副詞形)|遊戯|遊び|ゲーム|競技|スポーツ|冗談|戯れ|からかい
tonsil	扁桃腺
monkish	修道僧の|坊さんくさい|修道院じみた
quickie	急いでする行為|急ごしらえのもの|ウイスキー一口|短時間のセックス
saddlebag	くら袋(くらの後ろの左右にぶら下げる)|(自転車の)サドルバッグ
punctate	点状の
freckle	そばかす
aneuploidy	異数性 
simian	類人猿(の)|サル(のような)
chignon	シニョン(うなじにまとめて結った女性の束髪)
grandmaster	チェス名人|《G- M-》(騎士団・友愛会などの)団長|会長
altimeter	(航空機の)高度計
cowherd	牛飼い
regurgitate	噴き返す|逆流する|(食物を)吐き戻す
tonsure	剃髪(ていはつ)(司祭職に就くため|または修道士になるため頭髪全部またはその一部をそること)|頭髪をそり落とした部分|〜を剃髪する
concupiscence	好色|肉欲
entomology	昆虫学
oceanography	海洋学
hotelier	ホテル経営者
chirrup	〈小鳥などが〉チュッチュッとさえずる|(馬などを励ますために)チュッチュッとくちびるを鳴らす|チュッチュッ|チッチッ(鳥・虫の鳴き声)
sherd	=shard　破片　かけら
beggarly	こじきのような|見すぼらしい|貧弱な|おそまつな
loony	頭がおかしい
geniality	温情|親切で愛想のよいこと
twit	愚か者|ばか者
minster	修道院付属教会堂|大寺院
dingo	ディンゴ|ディンゴ犬|ルンペン|浮浪者|卑劣な奴
erotically	性愛的に|好色に
antinomy	二律背反(二つの命題が互いに矛盾すること)
envelopment	包むこと|包囲
gerontology	長寿学
mainmast	(帆船の)大檣(しょう)|メーンマスト
semipermeable	(膜などが)半透性の
popsicle	ポプシクル|アイスキャンディー
retch	むかつく
launder	洗たくする|洗たくしてアイロンをかける
sensationalist	扇情的な人|(哲学で)感覚論者
stooge	(喜劇役者の)引き立て役|ぼけ役|相手の言いなりになる人
hist	シーッ|静かに|静まる|シーと言って追い立てる
fakir	(イスラム教・バラモン教などの)行者|たくはつ僧
catechist	教義問答師|問答式教義
pulsate	鼓動する|脈打つ
chemiluminescence	化学発光
cheekily	生意気に
mannerism	マンネリズム|マンネリ
complaisance	人を喜ばそうとする気持ち;愛想のよさ
rosin	(rάzn)ロジン|松やにからテレピン(テレビン)油turpentineを蒸留した後の残留物|松やにそのもの(=resin)
neurotoxin	神経毒
asphyxiation	窒息
veld	(南アフリカの)草原(地帯)|ヴェルド(人名)
flowerpot	植木鉢
saxophonist	サクスホーン奏者
spyglass	小望遠鏡
welt	(靴の甲と底との)継ぎ目革|へりかがり(飾り)|ミミズばれ(をこしらえる)|さんざんに殴る
electioneer	選挙運動をする
pyridoxine	=vitamin B6
spectrophotometry	分光光度法
mirthful	楽しい|愉快な|陽気な(merry)
anthracis	Bacillus anthracis炭疽菌(たんそきん)|炭疽(炭疽症)の原因になる細菌|生物兵器として各国の軍事機関に研究された
placer	砂鉱床
curdle	(牛乳など)凝結させる|凝固する
hunky	互角の
employable	(人を)雇用できる;(物が)使用できる
charnel	納骨堂
lovebird	つがい鳥(ボタンインコの俗称)|《複数形で》《話》愛し合っている恋人同士
marginalia	《複数形》(本の)欄外の注|傍注
callously	冷淡に
mesophilic	(生科学)中等温度好性の(中温が好適な温度環境である性質)|中温性の
tutelary	(人・物の)保護者(後見人)の地位にある|保護(後見)の
submersion	=submergence
esplanade	散歩道|エスプラネード
fortnightly	2週間ごとの
spinoff	スピンオフ
miscibility	混和しやすいこと|混和性
encase	包む|入れる
hygroscopic	湿りやすい;吸湿性の
housing	住宅|住宅供給|家|2保護するもの|覆い|馬衣|馬飾り
postern	裏口|裏門|通用門
bleep	ピーという音
tern	三つ揃い|三つ組|3数の組み合わせによるくじ|3本マストのスクーナー|アジサシ(鳥)|インターン|実習医
hyssop	ヒソップ|ヤナギハッカ(芳香のあるハッカ属の草)|ヒソプ(聖書で|この小枝を水に浸して清めの儀式に用いた)
airfare	航空運賃
semiannual	半年ごとの|年2回の
occidental	西洋(人)の
sherbet	シャーベット(=sorbet)
conjoin	〜'を'結合(連合)させる|結合する
daffodil	ラッパスイセン|水仙
commensurable	=commensurate|同一規準で比べられる;(〜と)同じ規準の《+『with』(『to』)+『名』》
prowler	こそ泥
vaunt	自慢|誇示する
manioc	=cassava
snooty	紳士気取りの|傲慢な|きざな|うぬぼれが強い
stockman	牧畜業者|在庫品係|倉庫係
bivalent	二価の(二つの原子価を持つ)
notepaper	=writing paper2
painterly	絵画的な
biz	ビジネス
gullibility	だまされやすいこと
erst	昔は|以前は
woodsy	森林の|森林を思わせる
ravish	夢中にする
realpolitik	現実政策|実益政策
rematch	再戦
poetess	女流詩人
windless	風のない|なぎの
oriole	コウライウグイス(ムクドリの一種)
ineluctable	不可抗力の|不可避の|免れえない
loftiness	非常に高いこと|高尚|高潔|高慢|尊大
millinery	(婦人帽子屋の扱う)服飾品|婦人帽製造販売業
refract	〈水・ガラスなどが〉〈光〉‘を'屈折させる
macaw	(動物)金剛インコ|(植物)オニトゲココヤシ
genealogist	系図学者|系譜専門家
tendentious	(文書･発言)傾向的な|宣伝的な|偏向した
trainable	訓練(教育)ができる|訓練のしがいのある
baldly	ありのまま|あからさまに
dukedom	〈U〉公爵の位|〈C〉公国|公爵領
respectably	見苦しくなく
sunder	〜‘を'分ける|切り離す|(〜から)分かれる|離れす《+from+名》
signor	(イタリア語)《S-》〜君(様|殿|閣下)(英語のMr.|Sirに相当)|(特にイタリアの)貴族|紳士
abuzz	ざわめき立って
bodega	ワイン貯蔵室(庫)|ワインショップ|バー|(スペイン語系米人の)食料雑貨店
geodetic	測地学の;測地線の
recuse	忌避する
doldrums	沈滞状態
haulage	引っぱること|(貨物の)運搬;運搬料
mirthless	愉快でない
ventriloquist	腹話術師
beachhead	足がかり|橋頭堡
fez	トルコ帽
crudity	〈U〉天然のままであること|なま[の状態]|〈U〉未熟;〈C〉未熟なもの|〈U〉粗雑|粗野;〈C〉粗雑(粗野)なもの
presto	(イタリア語)きわめて速く|速い|するとたちまち|プレストの(で)
solubilized	可溶化
overdress	〜‘に'はでな服装をさせる|はでな服装をする
underarm	腋(わき)の下|腋の下の;(野球などの)下手投げの|下手投げで
choleric	怒りっぽい
prof	教授|先生
milkmaid	乳しぼりの女
slanderer	中傷者|悪口を言う人
inculcation	繰り返し教え込むこと|心にたたき込むこと
cubical	=cubic1
nifty	粋な(stylish)|楽しい(pleasing)|気が利いた|格好いい|素晴らしい
tabu	=taboo
alphanumeric	英数字の(文字)
billowy	うねりの高い;大波のようにうねる
jollity	愉快|陽気
unlettered	無学の|無教育の(uneducated)|読み書きのできない|文盲の(illiterate)
sere	枯れた|しなびた
roundish	丸みのある|やや丸い
victimize	を犠牲にする|苦しめる
dickens	驚きや婉曲な悪口をあらわす
mistrustful	疑い深い
paleontology	古生物学
homologue	同族体|相同遺伝子(=homolog)|直系遺伝子と側系遺伝子を含め|配列がすべて似ている遺伝子
cultivable	耕作(裁培)できる|教化できる
tradespeople	小売商人
hematology	血液学
insensate	感覚(生命)のない|感受性(思いやり)のない|無情な;(〜に)感受性がない《+to+名》|理性を欠いた
knick	小物
serovar	血液型亜型
cornflower	矢車菊|ヤグルマソウのほうが一般的|bachelor's button とも
globule	(glάbjuːl)|液体の小球|小滴
unflappable	(危機に臨んでも)動じない|冷静な|泰然とした
regatta	ボート(ヨット)レース
boogie	boogey|ブギ(速いテンポのブルース調ロック)|ディスコ(で思う存分踊る)
cornflour	=cornstarch
hyperbola	双曲線
sciatica	座骨神経痛
chaparral	(低木や灌木の)茂み|密集
malachite	クジャク石(装飾品に用いる);マラカイト色(鮮やかな緑)
congeal	(液体を)凍らせる|凝結させる(する)|ゼラチン状になる(become gelatinous)
chromate	クロム酸塩
inelegant	優美でない
sago	サゴ(サゴヤシの幹から製するでんぷん)|=sago palm
retry	リトライ|再試行
craftiness	ずるさ|悪がしこさ
incarcerate	幽閉する|監禁する|閉じ込める
maintainability	継続(維持)が可能であること|扶養できること|主張(断言)できること
sunless	日のささない|暗い|さびしい|陰気な
synonymy	〈U〉同義[性]|〈U〉同義語(類語)研究|〈C〉同義語集|類語表|〈U〉(強調のため)同意語を重ねて用いること
aviary	(大きい)鳥のおり|鳥類飼育場
recondite	(思想･知識など)深遠(難解)な
wattage	ワット量
gouty	痛風の|痛風にかかった
interminably	果てしなく
physio	=physiotherapist
malate	リンゴ酸塩
sanitarium	保養地|療養所
vacillate	ぐらつく
impound	押収する|閉込める|囲い込む
cordless	コードレス
grandad	=granddad
cour	裁判所
osprey	大きなタカの類|みさご|ミサゴ
bolo	片刃の大なた|打撃
antediluvian	大昔の|時代遅れの(人)
receivership	管財人の職務|管財人の管理下にある状態
anthropoid	人間に似た|類人猿
prance	意気揚々と歩く|はね回る
peddle	行商する|を売り歩く|を少しずつ広める
distractor	気を散らすもの|誤った選択肢.
printing	印刷する
flamethrower	火炎放射器
ascertainment	確認
nosey	=nosy
hematoxylin	ヘマトキシリン|アカミノキの心材から抽出される染料|媒染剤により色調が異なり青白色や青黒色となる
lope	大股で走る
uncounted	数えてない|多数の|無数の(innumerable)
transliterate	〜‘を'字訳(音訳)する
undergarment	下着
bacteriological	細菌学の
alcalde	(スペイン・米国南西部で)司法権を持つ市長
cadaverous	死体(死人)のような|青ざめてやせこけた
gloaming	たそがれ|薄暮
drivel	たわごとを言う
astound	びっくり仰天させる
hertz	ヘルツ
geostationary	(衛星が)静止軌道に乗っている
rancho	仮小屋|粗末な小屋
stamen	おしべ|雄ずい 
doughty	勇気のある|勇敢な(valiant);強い|がんじょうな
earthbound	地球から離れない|(宇宙船など)地球に向かう|俗事にとらわれた
deist	理神論者
dreariness	わびしいこと|退屈させること
embryonal	胎生の|胚性の|胚
herniate	脱腸する
mesenchyme	間葉または間充組織と呼ぶ|胚の胚葉から派生した結合組織|内胚葉･外胚葉の間に生じる
unworldly	世間離れのした
hajj	メッカ巡礼
prestressed	(コンクリートが)補強鋼線入りの
flycatcher	ヒタキ(鳥)|ハエ取り器
rial	リアル(イランの通貨の単位)
starlet	売出中の若手女優|小星|小さい星
tuberculin	ツベルクリン注射液(結核感染の有無を調べるための注射液)
cabby	(俗)タクシーの運転手
chump	太い木切れ|厚い肉の切り身|(俗)ばか
oversupply	供給過剰
bounteous	=bountiful
dromedary	ヒトコブラクダ|(=Arabian camel)|背中のこぶはhump
bleomycin	ブレオマイシン|グリコペプチド系抗生物質|抗癌剤などに使用される
spidery	くものような|くもの巣の
pedicure	ペディキュア|足治療|足治療医|にペディキュアを施す
asparagine	アスパラギン(アミノ酸のひとつ)
firehouse	消防署
newlywed	新婚
hydroponic	水耕の
camcorder	カムコーダー|カメラ一体型VTR
bionic	身体機能を機械的に強化した|生物工学的な
dryad	ドリュアス(ギリシア神話の樹木の精)
taproom	=barroom
affiance	(〜と)〈人〉'を'婚約させる《+『名』+『to』+『名』》
brassy	真鍮の|真鍮のような|厚かましい
mainspring	(時計などの)主ぜんまい|主因|主要動機
joist	根太
benignant	(特に目下の人に)優しい|親切な|ためになる|有益な
humph	ふふん
hawkish	タカ派の
starling	ムクドリ|水切り杭
teepee	=tepee
bogey	ボギー(ゴルフ用語)|悪霊|お化け
chaplet	頭飾りの花輪|小さなじゅず|(一般に)ビーズ飾り|玉飾り
behead	(刑罰として人の)首を切る
unnerve	気力を奪う|おじけづかせる|落胆させる|挫く|狼狽させる
indivisibility	分割できないこと|不可分性
hick	田舎者
babyhood	赤ん坊時代|幼年(期)
blameworthiness	非難に値すること|不都合|責め
inadvisable	勧められない;賢明できない|当を得ない
spicule	針状のもの|(海綿などの)針骨|針片|(植物の)小穂(すい)状花　交接針
bate	減らす|弱める|取り去る|鈍らせる|激怒する|逃げようとする
sunspot	太陽黒点|《英話》避寒地
litigious	訴訟好きな|訴訟(上)の
gainer	利益を得た(得る)人;勝利者
yap	ほえる|おしゃべり|がみがみしゃべる|キャンキャン|犬の鳴き声
breakeven	損益分岐
erg	(広大な砂丘列)エルグ
banknote	銀行券|銀行紙幣
pratique	検疫済み入港許可証
residuary	(法律上)残余遺産の取得権を持つ|残留物の
velar	(比較変化なし)軟口蓋の|軟口蓋と舌との接触により発音された|軟口蓋|軟口蓋音
measureless	限界のない|測りしれない|測れないほど大きい
meatball	ミートボール|(俗)退屈な人|まぬけ
helicase	ヘリカーゼ(ヘリケース)|核酸のリン酸エステル骨格に沿って動きながら絡み合う核酸をほどく酵素の総称|すべての生物に必須と考えられる
ignoramus	無学な人
borax	硼砂
audiology	聴力(覚)学(聴覚障害の治療などを扱う)
byline	(記事タイトルの下の)筆者名を記す行|署名記事を書く|副業|アルバイト
panache	見事なやり方|手ぎわ|貫禄(かんろく)
intrepidity	勇敢|大胆不敵
lucidly	明快に;透明に
seahorse	タツノオトシゴ(竜の落し子)
unclothe	〜‘の'衣服を脱がす|‘を'裸にする
haft	(ナイフ・短刀などの)柄|つか
knobby	でこぼこの|こぶだらけの
preseason	シーズン前
bethink	(〜について)〈自分〉‘に'考えさせる|思い出させる《+one『self』 『of』+『名』(『wh-節』)》
bookworm	読書家|クラスで一番勉強のできた子供のあだ名|勉強好き|ガリ勉
lexicography	辞書編集
midtown	ミッドタウン
tucker	完全に磨り減る|仕立て屋|食べ物
lysosome	リソソーム(lysosome)|真核生物が持つ細胞小器官の一つ|水解小体(すいかいしょうたい)とも呼ばれる|語源は“lysys(分解)”+“some(〜体)”に由来
merman	(男の)人魚|男子水泳選手
decapitate	首を切る
dyspnoea	呼吸困難
lampshade	ランプの傘
myocyte	筋細胞
prepackage	〈食品など〉‘を'販売前に包装する
purloin	〈ささいな物〉‘を'盗む|盗む
schnapps	シュナップス|オランダ|デンマーク|スカンディナヴィアの香りをつけた蒸留酒
arrowroot	クズウコン(病人食として用いられた熱帯アメリカ産の植物)
venial	(罪・過ちが)重くない|許されるべき|ささいな
intermarry	(異なる人種･階級の人と)結婚する|近親結婚する
intermingle	混りあう|混る|を混ぜる|混ざる
revivalism	再流行の動き(きざし)|信仰復興運動
tapir	バク(貘)
quartzite	珪岩(けいがん)(おもに石英から成る粒状の変成岩)
siliceous	ケイ酸を含む|ケイ酸質の土壌に生育する
constipate	〈人〉'を'便秘させる
prostatitis	前立腺炎
sisal	サイザル(シサル)麻|(メキシコ|中米産のリュウゼツランの一種)|(各種ロープ用)
vacuity	空虚|真空|ぼんやり|放心|愚鈍|まぬけ
undulation	波動|うねり|振動|音波|光波|動悸
decriminalization	非犯罪化
phasic	相の
chorale	合唱曲
extraterritoriality	(独立国内における他国の)外交特権
decongestant	充血除去剤|消炎剤
distaff	糸巻き棒
coot	オオバン(短い翼の水鳥)|《俗》(特に年取った)まぬけ|とんま
canthus	目の両端(目がしら及び目尻)
tangibly	触知できるよう(ほど)に;明白に
tinfoil	アルミ箔
breve	短音記号(特に詩などで|母音が短音であることを示すための(^)の記号)
newsagent	=newsdealer
woodpile	まきの山
situs	あり場所|位置|(部分・器官の)正常な位置|原位置
fanny	(俗)お尻
hellhole	不快な(不潔な)場所
pinnace	艦載艇|(船への人の乗降・荷の運搬に用いる)小舟|小ボート
forelock	前髪
humongous	バカでかい
murderess	(女の)殺人者
undulate	波のようにうねる
discreditable	不名誉な
ibis	トキ|アイビス
beggary	貧困|赤貧|さもしさ|卑劣
endoderm	内胚葉
carbolic	石炭酸の
ruck	多数|多量|がらくた|大衆|しわ|ひだ
stepparent	まま親
arsenate	ヒ酸塩
jerkily	ぐいと[動いて]|けいれんして|愚かにも
wainscot	羽目板|腰板|〈壁〉‘に'羽目板を張る
seraph	最高位の天使(聖書の中の人の形をした3対の翼のある天使)
letterbox	=mailbox
opener	開幕試合|缶切り|栓抜き
overcompensate	(〜に対して)補償し過ぎる《+『for』+『名』》
nonproductive	(土壌・畑・鉱山などが)生産物を産出しない|生産能力のない|生産と直接関係のない
unseasonable	時候(季節)はずれの|不順の|時を得ない|その場にふさわしくない
satiny	しゅすのような;(しゅすのように)つやつやした|なめらかな
cookout	野外で料理して食べること(集い)|野外料理会の
trailblazer	先駆者|開拓者
uracil	ウラシル(核酸の加水分解で得られる針状結晶)
marmot	マーモット
thenceforward	thenceforth
rattler	ガラガラヘビ
schoolmate	学校友達
synergism	神人協力説(回心には人間の意思と聖霊が協力し合うとする説)|(薬物などの)共力作用|相乗作用
grownup	『成長した』|成人した|『おとならしい』|おとなに適した|『おとな』
yowl	長く悲しそうに叫ぶ|遠吠えする|物悲しい鳴き声
varmint	害虫|有害動物|(話)下劣なやつ
tetrad	テトラド|4つぞろい|数字の4|(植)四分子(減数分裂で母胚種から生じた4個の娘細胞)|(化学)4価の元素(原子|基|イオン)|(分布地図の)2キロ平方区域
tuba	チューバ(低音金管楽器)
unedited	未編集の
handlebar	ハンドルバー|(二輪車の)ハンドル|操作レバー
propulsive	推進力のある|推進する
scriptwriter	(映画・テレビ・ラジオなどの)脚本家|シナリオ作者
outbid	により高い値をつける
loafer	のらくら者(idler)|浮浪人(tramp)
heartiness	元気よさ|熱心
wetsuit	(保温用の|ぴったりした)潜水服
braze	〈金属〉'を'はんだづけ(ろうづけ)する
acropolis	〈C〉(古代ギリシア都市の)城さい|《the A-》アクロポリス(アテネの昔の城さいでパルテノン(Parthenon)神殿その他の遺跡がある)
expressionist	表現主義
syne	以前の 
splotch	染み|汚れ|斑点|汚れがつく|染みがつく|染みの原因になる|に染みをつける|を汚す
deliriously	やたらに|精神が錯乱して|非常に|夢中になって|無性に
unseasonably	時候(季節)はずれに;時(場所)をわきまえず
witchery	=witchcraft|魅力(charm)
herbarium	植物標本集|植物標本室
seaborne	海上[輸送]の