tortious	of or pertaining to the nature of a tort; "tortious acts"|of or pertaining to the nature of a tort
frothy	泡の
omnidirectional	全方向
ummah	ウンマ
kook	変人|ばか
thalassemia	サラセミア
patrolman	巡視人
augur	易者|占い者|占う|前兆となる|予測する
housemate	同居人
wolfhound	ウルフハウンド(大型の猟犬で昔オオカミ狩りに用いた)
easygoing	気楽な|暢気な
amphotericin	an antibiotic and antifungal agent
plunk	ポンと放り出す|ドシンと腰を据える|(弦楽器を)ポロンとかき鳴らす
flirtation	(男女の)ふざけ|いちゃつき|浮気
unbleached	not artificially colored or bleached; "unbleached blonde hair"; "her hair is uncolored"; "undyed cotton"|not artificially colored or bleached
unevenly	不同
colonist	(海外)移住民|入植者|植民地開拓者
schoolwide	occurring or extending throughout a school; "schoolwide support for the team"|occurring or extending throughout a school
banister	手すり
abdominoplasty	cosmetic surgery of the abdomen to remove wrinkles and tighten the skin over the stomach
ivp	X-ray picture of the kidneys and ureters after injection of a radiopaque dye|performing pyelography with intravenous injection of a contrast medium
dwindle	だんだん小さくなる|減少する|衰える
throwaway	使い捨て
earthbound	地球から離れない|(宇宙船など)地球に向かう|俗事にとらわれた
unrequited	報酬のない|報いられない
utilitarianism	功利説(主義)(「最大多数の最大幸福」を主義とする倫理学説)
laze	怠ける
blubber	鯨の脂肪|泣きじゃくる
immunoreactive	免疫反応性
gingivitis	歯肉炎
precis	略筆|一通り|要覧|略叙|ひと通|大抵|ひと通り|概論|荒筋|概略
nanak	Indian religious leader who founded Sikhism in dissent from the caste system of Hinduism; he taught that all men had a right to search for knowledge of God and that spiritual liberation could be attained by meditating on the name of God (1469-1538)|Indian religious leader who founded Sikhism in dissent from the caste system of Hinduism|he taught that all men had a right to search for knowledge of God and that spiritual liberation could be attained by meditating on the name of God (1469-1538)
weightless	無重力の
plexiglas	a light transparent weather resistant thermoplastic
vibrancy	(色・光などの)輝き|活気|生き生きしていること
substratum	基体
saracen	サラセン人
biter	かむ人(年);かみつく動物(特に犬)
covertly	ひそかに|密かに|こっそりと
nucleoplasm	核質
cattail	ガマ(沼地に生える背の高いアシに似た植物)
medullary	延髄(の)|髄質(の)|髄(の)
nigella	any plant of the genus Nigella
forebode	の前兆となる
favoritism	偏愛|えこひいき
tailing	the act of following someone secretly
stoichiometry	化学量論
feeding	摂食
imipramine	イミプラミン
fortuitous	偶然の|思いがけない|幸運な
shuck	(皮･殻･さや)を取る(むく)|さや
autumnal	秋の
hurray	フレー|万歳
caliphate	カリフ(caliph)の地位(統治[する国])
freon	フロン(冷媒・エアロゾールなどに用いる)
despotic	専制的な|独裁的な|横暴な
adoptable	suitable or eligible for adoption; "a shortage of adoptable babies"|suitable or eligible for adoption
crooner	低い声で感傷的に歌う歌手|クルーナー
intermolecular	分子間
dicky	ぐらぐらする;(物事が)あぶなっかしい
militaristic	軍国主義の|軍国主義者の
beholden	恩義を受けて|世話になって
seawall	防波堤;岸壁
nimitz	ニミッツ
amoral	道徳性のない|道徳に関係のない
temptress	誘惑する女|妖婦
blacktop	アスファルト道路|アスファルト(で舗装する)
pharynx	咽頭
saddler	馬具屋
plf	a terrorist group formed in 1977 as the result of a split with the Popular Front for the Liberation of Palestine; became a satellite of al-Fatah; made terrorist attacks on Israel across the Lebanese border|a terrorist group formed in 1977 as the result of a split with the Popular Front for the Liberation of Palestine|became a satellite of al-Fatah|made terrorist attacks on Israel across the Lebanese border
smallish	小さめの
diffusive	spreading by diffusion
osteosarcoma	骨肉腫|骨原性肉腫
disablement	障碍|障害|身体障害|不具|障礙
portent	きざし|前兆|兆し
limbic	辺縁系
oedema	浮腫|水腫|水症
gorse	ハリエニシダ
wilfully	勝手に
bluster	怒号|荒れ狂う|猛り狂う|どなりちらす
organelle	細胞器官
scylla	スキュラ
lobelia	ロベリア(キキョウ科の観賞用植物)
disavow	否認する|拒否する|(責任を)否認する|(for|of|With)
punctuate	に句読点を打つ|(言葉を仕草などで)中断する
kinesis	動性
pharyngeal	咽頭の
replant	植直す|植えなおす|植え直す
safflower	ベニバナ (サフラワー油がとれる)
hypercholesterolemia	高コレステロール血症
accredit	信任する。功績とする
stonework	石造物
deviousness	the quality of being oblique and rambling indirectly|the quality of being deceitful and underhanded
placemat	プレースマット(食卓で各人用食器類の下に敷く小型のマット)
dragnet	地引き網|底引き網(=trawlnet)|(警察の)捜索網
edutainment	entertainment that is intended to be educational
misbehave	不作法な行いをする|無作法に振る舞う|不正を働く
ineligibility	不適格|不適当
hedonic	devoted to pleasure; "a hedonic thrill"; "lives of unending hedonistic delight"; "epicurean pleasures"|devoted to pleasure
anthropomorphic	擬人観(神･動植物などあらゆるものがその形･性質において人間に似ている)
emulsifier	乳化剤
crankcase	(自動車などの内燃機関の)クランク室(《英》sump)
betcha	bet you (間違いない|賭けてみろ|口語)
extremal	極値
emanation	〈U〉発散|放射|〈C〉発散物
agrobacterium	土壌細菌|アグロバクテリウム|グラム陰性菌に属し植物に病原性を持つものの総称|植物細胞に感染しDNAを送り込む(形質転換)性質があり植物のバイオテクノロジーで利用される
xxxiv	being four more than thirty
herniate	脱腸する
obediently	従順に|すなおに
layover	旅行途中の一時的滞在
nevus	母斑
vivace	(音楽で)活発に|速く|(音楽が)活発な|速い
ruthenium	ルテニウム(金属元素;化学記号は『Ru』)
vesuvius	ヴェスヴィオ
kameez	a long tunic worn by many people from the Indian subcontinent (usually with a salwar or churidars)
knockdown	ノックダウン|現地組立(製造用部品セット)|組み立て式|圧倒的な
disembody	〈霊魂・精神など〉‘を'肉体から分離(離脱)させる
hippodrome	バラエティーショー劇場|演芸場|競技場|曲馬場|馬術演技場
procurator	(古代ローマの)[皇帝の]代官|行政長官
paleolithic	旧石器時代の
nape	襟首|首筋|項(うなじ)
impolite	無礼な|失礼な
domine	a clergyman; especially a settled minister or parson|a clergyman|especially a settled minister or parson
enchilada	ボス|重要人物|大物|エンチラーダ|肉を詰めたトウモロコシパン(メキシコ料理)
rundle	横さん
involution	込み入っていること|複雑さ|もつれ|回旋(物)
imbue	にたっぷりしみ込ませる|(思想などを)吹き込む|に浸透させる
immunoblotting	免疫ブロット法
furor	熱狂|興奮|大騒ぎ|激情|激怒|激しい怒り(fury)|熱狂的賞賛|熱狂的流行
immunize	免疫にする
teleportation	瞬間移動
zoologist	動物学者
mannitol	マニトール
creditworthiness	trustworthiness with money as based on a person's credit history; a general qualification for borrowing|trustworthiness with money as based on a person's credit history|a general qualification for borrowing
grimly	厳格に|残忍に|気味悪く
pyrophosphate	ピロリン酸
patentee	専売特許権所有者
oomph	(俗)性的魅力|元気
tortellini	トルテッリーニ
spongy	海綿状の|吸収性の|スポンジのような
abracadabra	呪文|たわごと
monger	商人|～屋|売る|行商する
specious	見かけのよい
chequer	=checker
whiten	白くする|を白くする|白くなる
juxtapose	並列する
infliction	〈U〉(苦痛・打撃・罰などを)与えること|〈C〉苦痛|罰|やっかいなもの
atomizer	噴霧器|香水吹き
screwball	風変りな|シュート(変化球|和製英語)
intervenor	(law) a party who interposes in a pending proceeding|a party who interposes in a pending proceeding
stranglehold	締め付け
centerfield	(野球で)センター|中堅
diplomate	(特に)医師の資格取得者
endangerment	生死にかかわる危険にさらすこと
medicago	a genus of herbs that resemble clover
sumpter	駄獣
dipstick	計深棒(内燃機関内の油の深さを測る棒)
wader	水(どろ|雪)の中を歩いて渡る人|=wading bird|《複数形で》(釣り人がはく腰まである)防水長靴
litigant	係争当事者
scimitar	偃月刀|三日月刀|彎曲刀
uninterested	無関心な
cavalcade	パレード|行列
indignity	軽蔑|侮辱|侮辱的言動|冷遇
hematocrit	ヘマトクリット|ヘマトクリット
arthroscopy	関節鏡検査
encase	包む|入れる
adulation	追従|お世辞
dastardly	卑劣な
fishbone	フィッシュボーン
unwitting	無意識の
expiratory	呼気の
avarice	どん欲|強欲|貪欲
pointedly	しんらつに
apocrypha	アポクリファ|聖書外典|外典|出典の疑わしい文書
hanuman	in Hinduism, the monkey god and helper of Rama; god of devotion and courage|in Hinduism, the monkey god and helper of Rama|god of devotion and courage|langur of southern Asia; regarded as sacred in India|langur of southern Asia|regarded as sacred in India
hangup	こだわり|コンプレックス|悩みの種|(天井･壁などに吊るす)飾り
excitable	興奮しやすい
zinger	元気(威勢)のいい人|気のきいた返答|あっといわせること
masseuse	女マッサージ師
airgun	空気銃|エアガン
thrip	アザミウマ
ecumenism	a movement promoting union between religions (especially between Christian churches)|(Christianity) the doctrine of the ecumenical movement that promotes cooperation and better understanding among different religious denominations: aimed at universal Christian unity|the doctrine of the ecumenical movement that promotes cooperation and better understanding among different religious denominations: aimed at universal Christian unity
personhood	being a person; "finding her own personhood as a campus activist"|being a person
autoimmunity	自己免疫
ranchero	農場主
insipid	味のない|風味のない|無味乾燥な|おもしろみのない
reservist	予備(後備)兵|在郷軍人
dewberry	キイチゴ;その実
photometer	光度計;(写真の)露出計
unfathomable	深さが測れない
whitener	漂白剤
empiricism	経験論
jut	突き出る|突起|突出部
effeminate	男らしくない|優柔不断な|めめしい|柔弱な
claustrophobic	閉所恐怖症の
vainly	むなしく|むだに|うぬぼれて
exacta	a bet that you can pick the first and second finishers in the right order
lodgepole	shrubby two-needled pine of coastal northwestern United States; red to yellow-brown bark fissured into small squares|shrubby two-needled pine of coastal northwestern United States|red to yellow-brown bark fissured into small squares
venereal	(vəní(ə)riəl)|性交によって伝わる|性病の|venereal disease性病
occultation	掩蔽(えんぺい)|ある天体が他の天体の間を通過するため|その天体が隠される現象
mercifully	情け深く|寛大に
malcontent	不満の|不満な|不平家(分子)
centrepiece	センターピース|センターピース
schoolcraft	スクールクラフト
millage	(不動産などの)税率(1ドル当たりをミル(mill)という単位で計算する)|ドル当たりミル数
chanter	reed pipe with finger holes on which the melody is played
merganser	アイサ(水に潜って細い口ばしで魚を捕る海ガモ)
truism	自明の理|わかりきったこと
romantically	ロマンチックに
turndown	(えりなどが)折り返しの
handcuff	手錠|(=manacleあまり使われない)|手錠をかける
coherently	in a coherent manner; "she could not talk coherently after the accident"|in a coherent manner
abortive	失敗に終わった|失敗に終わる|実を結ばない|むなしい
embarkation	搭乗|積載(物)
cronyism	縁故主義|(任命などで)知人を引き立てること
firefight	(軍隊の)前哨(ぜんしょう)戦|小ぜり合い(skirmish)
valent	(chemistry) having valence; usually used in combination|having valence
meningioma	髄膜腫
muggle	ハリー･ポッターシリーズの中で|いわゆる「普通の人間」
tope	酒びたりになる|〈酒〉‘を'ひどく(常に)飲む
ablution	《複数形で》(宗教上の儀式としての)沐浴(もくよく)
doldrums	沈滞状態
conformist	遵法者
angstrom	オングストローム|1000万分の1mm
premeditate	〜‘を'前もって考える(計画する)
topically	局所的
neomycin	ネオマイシン
upwardly	上方へ|上向きに
poliomyelitis	小児麻痺
backplate	後板
snead	スニード
proteinuria	蛋白尿
grozny	the capital of Chechnya in southwestern Russia; center of extensive oil fields|the capital of Chechnya in southwestern Russia|center of extensive oil fields
sentimentality	感傷的なこと|感傷的な考え|感傷癖
tenable	持続できる
chaplet	頭飾りの花輪|小さなじゅず|(一般に)ビーズ飾り|玉飾り
triumphantly	勝ち誇って
deionized	脱イオン
trendsetter	流行仕掛け人|流行の最先端にいる人
perpetuation	(〜を)不朽にすること|永続させること《+『of』+『名』》
indole	インドール|花のような香りがあり|天然ジャスミン油等に含まれる|室温では固体で排泄物臭を発散する|名前は植物由来の染料のインディゴに由来
infantryman	歩兵
frig	冷蔵庫|ダラダラと時を過ごす|急いで去る|出て行く|せんずりをかく|オナニーをする
scrim	スクリム(綿または麻の目のあらい織物;旗・カーテン用)
shiitake	シイタケ
jubilant	喜ぶ|歓呼する
tup	雄羊
bludgeon	こん棒(でなぐる)
continuo	(17|8世紀音楽での)通奏低音
calorimetry	熱量測定
transfix	釘付けになる|立ちすくませる|を突き刺す
readymade	既製[品]の|(思想・意見などが)独創性のない|受け売りの
discernable	識別可能
backgrounder	a press conference or interview in which a government official explains to reporters the background of an action or policy; "the secretary gave us a backgrounder on public health issues"|a press conference or interview in which a government official explains to reporters the background of an action or policy
windbreaker	防風林|風避け|(商品名)ウインドブレーカー
tercel	雄のハヤブサ
hydrogenation	水素化
diluent	(液体を)薄める|希薄用の|希釈剤
minoxidil	ミノキシジル
dyad	二人組|ペヤ|ペア|対|ペアー
neuropeptide	ニューロペプチド|神経ペプチドといい|神経が分泌するホルモンなどの総称
syphon	=siphon
espy	見つける|発見する|偵察する
ruffian	悪党|ごろつき|やくざ者
snog	キスする|愛撫する|キス|愛撫
alarmingly	驚くほどに
hoagland	ホーグランド
bloodless	血の気のない|無血の
scammer	山師|詐欺師|ぺてん師|不徳漢
carcinoid	カルチノイド
foxglove	ジギタリス(釣り鐘状の紅紫色または白色の花をつける;葉は強心剤に用いる)
definitional	定義の
sapling	苗(木)|若木|若者|青年
rumbling	ガラガラ(ごろごろ)なる音|不平不満の声
bronchodilator	気管支拡張剤
biome	a major biotic community characterized by the dominant forms of plant life and the prevailing climate
nightmarish	悪夢のような
unbeknownst	without someone's knowledge; "unbeknownst to me, she made all the arrangements"|without someone's knowledge|(usually used with `to') occurring or existing without the knowledge of; "a crisis unbeknown to me"; "she had been ill for months, unbeknownst to the family"|occurring or existing without the knowledge of
suppressive	抑圧(抑制)する|隠蔽(いんぺい)する|発禁にする
auxin	オーキシン|成長を促す作用を持つ植物ホルモン|天然に存在するオーキシンとしてはインドールが知られている
matterhorn	a mountain in the Alps on the border between Switzerland and Italy (14,780 feet high); noted for its distinctive shape|a mountain in the Alps on the border between Switzerland and Italy (14,780 feet high)|noted for its distinctive shape
transmittance	変速機|伝導|伝達|透過率|透過|伝承|伝搬|伝播|送信|トランスミッション
nepotism	(就職の際などの)縁者びいき|縁故採用
icbm	ICBM|大陸間弾道弾|大陸間弾道ミサイル|ＩＣＢＭ
feeler	触手|さわってみる人|触知者|探り|打診|(動物の)触角
industrialist	産業主義者|実業家|資本家
expressionist	表現主義
sepharose	セファロースはアガロース(agorose)の商品名
tortuous	曲がりくねった|曲りくねった
buccal	舌下錠|頬側|頬の|頬側の|口の|口内の
polycrystalline	多結晶性の|多結晶の
learning	学問|学識学習
seafaring	海と深くかかわる|海に生きる|船乗りの|(またseagoing)海上旅行の|船乗り業|海上旅行
showboat	ショーボート|(俗)自己宣伝家
jittery	神経過敏の
rootstock	根茎
aspirate	気息音の|帯気音の|気音で発音する
selfishly	身勝手に
dray	(4輪で台の低い)荷[馬]車|〜‘を'荷[馬]車で運ぶ
coulda	could haveの縮約形
drudgery	苦役|退屈な骨折れ仕事|単調でつまらない仕事
jangle	けんか|じゃんじゃん鳴る
impartially	偏らずに|公正に|平等に
imperfectly	不完全に|不十分に
ultramarine	群青(ぐんじょう)(明るい空色をした顔料)|群青色|群青色の
slanderous	中傷的な
interminable	果てしのない|限りのない|長たらしい|だらだらと続く
grosbeak	any of various finches of Europe or America having a massive and powerful bill
izzard	ゼロ
indomitable	不屈の
unseemly	無作法な
peon	労働者|日雇い人
lytic	溶解性の|溶菌性の|溶解薬|溶菌
godlike	神のような
prosodic	韻律的
pmol	ピコモル|濃度を表す方式|溶液1L中の溶質をモル数を使って表した単位1mol/L|その10(-12乗)mol=1pmol 
ovulate	(生物学)排卵する|卵を産出し|放出する
pogrom	組織的･計画的虐殺|ユダヤ人虐殺
thermography	サーモグラフィー
ubiquinone	ユビキノン
doge	総督
meadowlark	マキバドリ属の鳴鳥;北米産
topcoat	〈C〉軽い外とう|合いオーバー|〈C〉〈U〉仕上げ塗り
merriment	浮かれ騒ぎ|陽気な賑わい|歓楽
retinitis	網膜炎
nonvolatile	不揮発性
thetis	(Greek mythology) one of the 50 Nereids; mother of Achilles by Peleus|one of the 50 Nereids|mother of Achilles by Peleus
naturopath	自然療法医
ringmaster	サーカス団長|演技主任|曲馬団長|構内作業係長|操作場係長|指揮する|取り仕切る|切りまわす
subsidiarity	secondary importance
ticonderoga	タイコンデロガ
analogously	in an analogous manner; "analogously, we have a variable"|in an analogous manner
elvish	=elfish
huntress	狩りの女神|狩猟用の雌馬|女性狩猟家
soulless	無情な
dumpling	ゆでだんご
redeye	a night flight from which the passengers emerge with eyes red from lack of sleep; "he took the redeye in order to get home the next morning"|a night flight from which the passengers emerge with eyes red from lack of sleep
mamba	マンバ(アフリカ産の毒ヘビ)
frontispiece	本の口絵
vivacious	活気のある|陽気な
bloodshot	充血した
forsooth	真に|ほんとうに|いかにも
actualize	〜'を'実現する;〜'を'行動に表す
geordie	a native of Newcastle-upon-Tyne|the nonstandard dialect of natives of Newcastle-upon-Tyne
spurn	を踏みつける|を拒絶する|拒否する
forefinger	人差し指
deathbed	死の床|臨終
tricolor	三色旗|トリコロール
modernise	近代化|発展|見直し
indefensible	弁明の余地のない
quantile	変位値|分位点|(統計の代表値の一種)
brutish	獣のような|野蛮な|肉欲的な
computerization	コンピューター化|電算化
photoreceptor	感光体
kob	an orange-brown antelope of southeast Africa
matriarch	女家長
hackle	(おんどりなどの首回りの)細長い羽毛|(怒ったときなどに逆立つ犬などの)毛
bitterroot	showy succulent ground-hugging plant of Rocky Mountains regions having deep to pale pink flowers and fleshy farinaceous roots; the Montana state flower|showy succulent ground-hugging plant of Rocky Mountains regions having deep to pale pink flowers and fleshy farinaceous roots|the Montana state flower
medicate	〈人・病気・傷など〉‘を'薬で治療する|〜‘に'薬を加える|薬剤を投入(添加)する
borax	硼砂
symmetrically	対称|対称的
amyloidosis	アミロイド症
megabit	ミオグロビン|メガビット
yearlong	1年続きの|1年を通じた
tipi	a Native American tent; usually of conical shape|a Native American tent|usually of conical shape
breccia	角礫(かくれき)岩(角ばった岩片から成る岩石)
relegate	追放する|左遷する
trazodone	トラゾドン
sashimi	刺身
monotheism	一神教(論)
basketry	かご細工の技術|(また『basketwork』)《集合的に》かご細工
psychopathic	精神病の
crummy	(俗)うすよごれた|安っぽい|哀れな|貧弱な
smorgasbord	スモーガスボード|バイキング料理|寄せ集め料理|(日本ではバイキングと呼ぶが|英語では Viking といわない)
congratulatory	祝賀の
ppk	クルド労働者党
shofar	ショーファ|雄羊の角から作られる古代音楽用のホーン
extrajudicial	法廷外の;裁判権外の
melodious	施律の美しい
capsaicin	カプサイシン|唐辛子の辛味をもたらす主成分|アルカロイド(Alkaloid)のうちカプサイシノイドと呼ばれる化合物のひとつ
multiyear	多年にわたる
rhodopsin	視紅|ロドプシン
iditarod	an important dogsled race run annually on the Iditarod Trail
sanitize	衛生的にする
organismal	of or relating to or belonging to an organism (considered as a whole); "the organismic theory of the state"|of or relating to or belonging to an organism (considered as a whole)
silverback	an adult male gorilla with grey hairs across the back
bellarmine	ベラルミーノ
religiosity	信心深さ|熱狂的信心|にせの信心|えせ信仰
swashbuckler	(特に映画や物語の中で)向こうみずを自慢する人(冒険家|軍人など)
conjugal	夫婦の;婚姻上の|結婚の
bilaterally	with the involvement of two parties or governments; "they worked out an agreement bilaterally"|with the involvement of two parties or governments|so as to involve two sides or parts
underclass	(社会の)最下層
nightlight	終夜灯(寝室・病室などで夜通しつけたままにしておく明かり)
vesper	《詩》|夕暮れ|夕べ|夕べの祈りの鐘|《複数形で》《単数扱い》夕べの祈り|晩祷|《V-》よいの明星(夕方見える金星(Venus)のこと)|夕べの|晩の;晩祷の
unsaved	救われない
dogfish	primitive long-bodied carnivorous freshwater fish with a very long dorsal fin; found in sluggish waters of North America|primitive long-bodied carnivorous freshwater fish with a very long dorsal fin|found in sluggish waters of North America|any of several small sharks
rightmost	最右端の
assuage	和らげる|緩和する|鎮める|静める
gunk	べたべた(ぬるぬる)した不潔なもの|汚物(《英》gunge)
breakeven	損益分岐
deliverer	引渡人|救助者|交付者|釈放する人|配達人
staph	ブドウ球菌|ブドウ状球菌|staphylococcus
galax	tufted evergreen perennial herb having spikes of tiny white flowers and glossy green round to heart-shaped leaves that become coppery to maroon or purplish in fall
stimulatory	刺激
acetonitrile	アセトニトリル|分子式CH3CNと表される最も単純なニトリルである|化学工業製品の原料や溶媒として用いられる
immaculately	in an immaculate manner; "gone was the casually dressed Canadian she had thought a backwoodsman--this man was immaculately tailored"|in an immaculate manner
peremptory	決定的な|断固とした|横柄な|独断的な
apatite	リン灰石(リン酸肥料の製造に用いる)
aggro	(informal British usage) aggravation or aggression; "I skipped it because it was too much aggro"|aggravation or aggression
crucify	責め苦しめる|虐待する
morphogenetic	形態形成の
scrawl	なぐり書きにする|走り書きする|走り書き|(～を)なぐり書きする
unrecorded	actually being performed at the time of hearing or viewing; "a live television program"; "brought to you live from Lincoln Center"; "live entertainment involves performers actually in the physical presence of a live audience"|actually being performed at the time of hearing or viewing
undiluted	希釈していない
tussle	と激しく格闘する|激しい格闘
acoustically	音響学上|音響上|音響的には|音響的に
airless	風通しの悪い|風のない
methylated	メチル化された
powerlessness	非力|不能|非力さ|無力さ|無力
overage	標準年齢(適齢)を過ぎた
dissimilarity	似ていないこと|相違点|不同性
naively	素朴に|純真に|単純に
nominative	指名(任命)の|主格(の)|主語
boozer	大酒飲み
kapok	カポック|パンヤ|絹綿(クッション・まくらの詰め物にする)
induct	(正式に)(〜に)〈人|特に僧〉‘を'就任させる《+『名』〈人〉+『into』+『名』》|(〜に)〈人〉‘を'入会させる|軍隊に入れる《+『名』+『into』+『名』》
shibboleth	シボレテ(聖書で|ギレアデ人がshの音を発音できないエフライム人を区別する目的で発音させた言葉);ある集団を特徴づける習慣・言葉遣い・昔は重要であったが現在では重要性のない表現や習慣
lief	快く|喜んで
minaret	(イスラム寺院の)尖塔
alchemical	related to or concerned with alchemy
eavesdrop	盗聴する|盗み聞きをする
ceilidh	an informal social gathering at which there is Scottish or Irish folk music and singing and folk dancing and story telling
thusly	次いで|こうして
pasteurize	低温殺菌する
commutator	電流転換器|整流子
forgettable	忘れられがちな
unrepentant	悔い改めない
mucin	ムチン
generalise	一般化|俗了
kinesin	キネシン|真核生物の細胞質中のモータータンパク質(Motor protein)の一種|アデノシン三リン酸(ATP)の加水分解で生じるエネルギーを運動に変換するタンパク質
mimicry	ものまね|模倣|模造品|擬態
derailment	脱線
exfoliation	鱗片|鱗
exhaustively	徹底的に
dunce	劣等生|できの悪い生徒|うすのろ
carper	someone who constantly criticizes in a petty way
peacekeeper	平和維持軍
watercress	オランダガラシ|クレソン
ludo	さいころ遊びの一種
literati	複知識階級|文学者たち
perigee	《通例単数形で》近地点(衛星や宇宙船などが地球に最も近づく位置)
hungrily	飢えて|がつがつと
immaturity	未熟(性)
yurt	ユルト(中央アジアの遊牧民が使う円形の移動式テント)
plastid	プラスチド(色素体)|植物や藻類に見られ|光合成等の同化作用|糖や脂肪などの貯蔵|様々な化合物の合成などを担う細胞小器官の総称|葉緑体が代表的
astride	にまたがって|に跨って
dichotomous	二分する
introvert	内向する|内へ向ける|内省させる|内向的な人
glitzy	けばけばしい|派手な
dermatologic	皮膚科学的
railroader	鉄道従業員|鉄道職員
isoleucine	イソロイシン
occlusive	閉塞性|破裂音|停止|閉塞性
rapt	心を奪われた|うっとりした
conjunctive	結合(接合)の|結合する|(文法で)接続[法]の|接続詞;〈U〉接続法
bittern	サンカノゴイ(サギの一種)
petiole	(葉の)葉柄（ようへい）・（動物）柄部
thematically	with regard to thematic content; "thematically related"|with regard to thematic content
halter	端綱(をつける)|絞首台|絞首刑(にする)|ホールター(婦人用のドレス)|抑制する
seamount	an underwater mountain rising above the ocean floor
resuspended	再懸濁
suborder	亜目
clozapine	クロザピン|統合失調症の治療薬|非定型抗精神病薬である
mung	リョクトウ
monaural	片耳用の|(レコードなどが)モノラルの(音響再生を1チャンネルでする)
cineplex	映画ビル
genteel	生まれのよい|家柄のよい|しつけのよい|上品な|しとやかな|気取った|上品ぶった|気どった
secondarily	二次的に
jellybean	ゼリービーン(豆形のゼリーに糖衣をかぶせたキャンデー)
lout	ぶこつ者|いなか者
deign	親切に～する
rapeseed	seed of rape plants; source of an edible oil|seed of rape plants|source of an edible oil
jawbreaker	舌を噛みそうな語|非常に固い飴玉
hypercube	超立方体(特に四次元の超立方体(tesseract)を指すこともある)
intramolecular	分子内
unipolar	単極
frilly	ふさ状の
homeroom	ホームルーム
ampoule	アンプル
embryogenesis	胚発生
warmonger	戦争挑発者|戦争屋|主戦論者
valse	ワルツ|円舞曲(waltz)
lodgement	=lodgment
spiteful	悪意のある
cubist	立体派の芸術家(画家・彫刻家)
stabiliser	安定器|スタビライザー
headspace	ヘッドスペース
dopey	意識がもうろうとした|ばかな
deviously	in a devious manner; "he got the promotion by behaving deviously"|in a devious manner
inexorable	冷酷な|無情な|容赦のない|変えられない
harmoniously	調子よく|釣り合いよく;打ち解けて|円満に
coalfield	炭田|石炭埋蔵地帯
coolly	よそよそしく|涼しく|冷たく|冷静に|冷淡に
tweet	小鳥がさえずる|チッチッと鳴く|さえずる|呟く|tweetする
cottonseed	綿実
bunkhouse	(鉱夫・労務者などの)小屋|飯場
osteomyelitis	骨髄炎
leery	用心深い
beekeeper	養蜂(ようほう)家
betaine	ベタイン
gravure	グラビア印刷法
whoosh	(空気･水などの)ヒュー(シュー)という音
subhead	小見出し
overgrowth	〈C〉一面におい茂ったもの|〈U〉繁茂;育ち過ぎ
prosody	作詞法|詞形論|韻律学
committal	=commitment
theremin	テルミン
elfin	小妖精の(ような)|いたずらな|ちゃめな
punchy	パンチを受けてフラフラの|力強い|イライラした
grabber	ひったくり|欲張り者|人の心を強くとらえるもの|度胆を抜くもの
swallowtail	ツバメの尾;先が深く二つに割れたもの|《話》=swallow-tailed coat|アゲハチョウ
evidential	証拠となる|証拠に基づいた|証拠の
demystify	の神秘(あいまいさ)を除く|なぞを解く
hutu	フツ
otic	of or relating to near the ear
antipathy	反感|嫌悪|毛嫌い|大嫌いなもの|不一致|対立
spasticity	the quality of moving or acting in spasms
undertow	あとびき|引き波|下層流|逆流
madhouse	精神病院|《話》《単数形で》(混乱して)てんやわんやの場所
influent	流入液
iconoclast	聖像破壊者|因襲打破を唱える人
pratique	検疫済み入港許可証
calabash	ヒョウタン(製品･打楽器)
recurve	curve or bend (something) back or down
tongan	a Polynesian native or inhabitant of Tonga|the Polynesian language spoken by the Tongan people|of or relating to the island monarchy of Tonga or its people; "Tongan beaches"|of or relating to the island monarchy of Tonga or its people
brigantine	ブリガンチン(2本マストの帆船)
jumpy	イラ立つ(nervous)|ビクビクする(afraid)
neurospora	パンカビ属
rioter	暴徒|暴民
harpist	ハープ奏者
recombine	再結合する
bubbler	噴水式の水飲み口
bundesbank	the central bank of Germany
empathetic	共感的な
waster	駆逐艦|破壊者
sphagnum	ミズゴケ(沼の表面にはえる柔らかいコケ)
stroma	ストロマ|間質 (赤血球等の蛋白繊維の支持組織|the supporting tissue of an organ)|(植物)葉緑体(chloroplast)中の液状支持組織
infighting	内輪もめ|内紛
hotelier	ホテル経営者
intermezzo	(劇・歌劇などの)幕合いの曲|間奏曲
dextran	デキストラン|グルコースのみからなる多糖類の一種|乳酸菌が作る|デキストリンと類似物質|歯垢(プラーク)にも含まれる
bordello	売春宿
flanker	側面にある物(人)|(米式フットボールで)フランカー(攻撃側の最前線両端の競技者の外側に並ぶ競技者)
genitive	(文法)属格(英語の所有格など)|所有格|属格の|所有格の
noggin	頭|脳|バケツ|手桶|酒を飲むこと|小型ジョッキ|少量|ばか|愚か者|鈍い奴
cuteness	かわいらしさ
testy	怒りっぽい
impel	かりたてる|推進する|無理に～させる
workaholic	働き中毒の人|仕事中毒の人|仕事中毒(の)
bruiser	a large and strong and heavyset man; "he was a bull of a man"; "a thick-skinned bruiser ready to give as good as he got"|a large and strong and heavyset man
clamour	=clamor
hairdo	女性のヘアースタイル|髪の結い方
brewpub	地ビールレストラン
reorient	再設定する
unconvincing	説得力のない
tallis	タリス
icebox	冷蔵庫|アイスボックス
scouter	偵察
chemotherapeutic	化学療法薬
methicillin	メチシリン
abhorrent	嫌悪すべき|大嫌いな
belatedly	(手紙･報告書など)遅れて到着した|時代遅れの|おそすぎた
nij	the law enforcement agency that is the research and development branch of the Department of Justice
gonadal	生殖腺の
cotillion	コティヨン(18世紀に始まった活発な社交ダンス)
pullback	〈U〉引き戻すこと|《複数形で》撤兵|撤退
inhumanity	残酷(な行為)|不人情(な行為)
chastise	せっかんする|厳しく非難する|叱責する|厳しく罰する
courtesan	(おもに昔の)貴族・金持ち相手の娼婦
caiman	カイマン|小型のワニ|caymanとも綴る
impeccably	非の打ち所なく
mononucleosis	伝染性単核球症または伝染性単核症|ウイルス感染によって生じる急性感染症|ディープキス等の唾液感染による|「キス病」とも言われる
nitrocellulose	ニトロセルロース(硝化綿)|セルロースを硝酸と硫酸で処理し作る|用途は塗料|接着剤|火薬(白煙を出す黒色火薬に比し無煙火薬と呼ばれる)|樟脳と作られたセルロイドは世界初の熱可塑性合成樹脂
puce	暗褐色(の)
recommender	推薦者;助言者|魅力的にする物(要素)
sympathetically	同情して|共感して
tempura	天ぷら
lasix	フロセミド
emptor	購買者|買手|買い主|購入者|バイヤー|買い手|買い方|バイアー|買主|買方
floatation	=flotation
kersey	カルゼ織り(地の粗いあや織りの毛織物)
overleaf	裏ページに
taxman	タックスマン|収税吏
digitisation	conversion of analog information into digital information
seeder	播種機|播種機|播種機
bobsleigh	=bobsled
backstop	(野球)バックネット(和製英語)
breakable	破れ(壊れ)やすい|もろい|壊れやすいもの|割れもの
stealer	盗む者|どろぼう
preppy	良家のお坊ちゃん
rollick	ふざける|はしゃぎ回る|陽気に騒ぐ
windlass	巻き上げ機;(船の)いかり巻き上げ機
telethon	テレビ長時間番組(放送)
kisser	キスをする人
paramagnetic	of or relating to a paramagnet
memorise	覚込む|暗記|憶込む|憶える|おぼえ込む|覚えこむ|覚える|憶え込む|覚え込む|記憶
offhand	即席に|準備なしに|そっけなく|ざっくばらんに
transpiration	(秘密などの)露見|発覚|《話》発生|(水分の)蒸発|発散
rustler	牛泥棒
bashful	はにかみやの|内気な|人見知りをする
albacore	ビンナガ|ビンナガ
schoolbook	教科書|教科書的な
cognitively	with regard to cognition; "cognitively skillful"|with regard to cognition
monomeric	単一遺伝子性の|単量体の|(反)multimeric|polymeric
infix	接中辞|差し込む|組みこむ|挟みこむ|挟みいれる|挟み入れる|組込む|挟み込む|組み込む|差入れる|組入れる
opportunism	便宜主義|日より見主義
groundnut	《米》地下の豆状の部分が食物になるマメ科植物の総称;特にpeanut|《英》=peanut
runyon	ラニヨン
absorptive	吸収性のある
footman	(制服の)従者
serologic	of or relating to serology
acetaldehyde	アセトアルデヒド
grenadine	(カクテル用)石榴のシロップ|赤黄色(の)
gunboat	小型砲艦|砲艦|(俗)大きな靴
preeclampsia	子癇前症
acetylation	アセチル化|有機化合物中にアセチル基が導入されること|(逆に有機化合物からアセチル基が除かれる反応は脱アセチル化)
gingko	銀杏|鴨脚樹|イチョウ|公孫樹
uracil	ウラシル(核酸の加水分解で得られる針状結晶)
welterweight	ウェルター級|(welterは波やうねりのこと)|ボクシングでは約63|5-66|7kgと最も平均的な体格で|競争率が高い
sightseer	観光客
outsmart	を打ちまかす
tacitly	それとなく
dint	(堅いものの表面に打ってできた)くぼみ|へこみ(=dent)
salience	特徴|突極性
sawfish	ノコギリエイ
mulatto	白人と黒人の第1代混血児
rookery	みやがらす(rook)の群居する所(森);ミヤマガラスの群れ|アザラシ(オットセイ|ペンギンなど)の繁殖場
transmute	(性質・外観などを)変える(into)|(根本的に|より高度なものに)変える
thrombus	血栓
eyesore	目障りなもの
citronella	〈U〉〈C〉シトロネラ(南アジア産の植物;石けんなどの香料となる)|〈U〉シトロネラ油
straightway	直ちに|即刻(at once)
infante	インファンテ(男性形)|インファンタ(infanta女性形)|スペイン|ポルトガル王国の王族に授けられた称号と身分|王子|王女|親王|内親王|語源は幼児を意味するinfant
impressionable	影響を受けやすい|感じやすい
gingerly	きわめて慎重な･に|大変用心深い･く
intersex	二形|双成り|雌雄モザイク|半陰陽
conjunct	結合した
subzero	(特に)華氏零度以下の|氷点下の
pintail	オナガガモ
delimitation	境界|限界
bewilderment	当惑
repatriate	本国へ帰す|本国へ送還する|引揚者
chlorpyrifos	a common organophosphate insecticide
loveliness	すばらしい|愛らしさ
surficial	pertaining to or occurring on or near the earth's surface; "a surficial geologic deposit"|pertaining to or occurring on or near the earth's surface
kingfish	ヒラマサ(魚)
bookmobile	移動図書館
acanthus	アカンサス|ハアザミの類|(柱頭の)アカンサス葉飾り
wallboard	壁張り用材
baloney	たわごと|ばかげたこと
intelligibility	よく理解できること|明りょうなこと
jeer	あざける
idiomatic	芸術家に独特の|ある言語独特の
footing	(しっかりした)基礎|(確固たる)地位|足がかり|足場|加算|総計
cataclysm	大変革|(政治的社会的)大変動|大洪水|地殻変動
slav	スラブ
kurta	a loose collarless shirt worn by many people on the Indian subcontinent (usually with a salwar or churidars or pyjama)
lightship	灯台船
baste	(焼くとき)〈肉など〉‘に'バターをぬる|油(たれ)をかける
financing	融資
dyskinesia	ジスキネジア
warder	番人|見張り|《英》(刑務所の)看守(jailer)
prestressed	(コンクリートが)補強鋼線入りの
thresher	麦打ちする人|(また threshing machine)脱穀機|(また thresher shark)オナガザメ
unshielded	非シールド
pangaea	パンゲア
idolize	偶像化する|偶像を崇拝する|溺愛する
falafel	ファラフェル
cower	畏縮する|ちぢこまる|すくむ|かがむ
histologically	組織学的に
airbase	空軍基地
banishment	追放|国外追放|島流し
pothole	(車などによる路面の)くぼみ
fallacious	誤った|虚偽の|人を惑わす|あてにならない
morsel	一口|少量|ひと口分|1片|特においしいもの|気持ちのよい人|ごちそう
curvilinear	曲線の|曲線美の|盛飾式の|華麗な
leniency	手加減|酌量|寛大さ
pizzazz	the activeness of an energetic personality
imbecile	精神薄弱の|低能な|低能の|愚鈍な
scrupulous	良心的な|几帳面な|実直な|きちょうめんな|周到で|綿密|細心の
thinner	シンナー|薄くするもの|(植木･果実の)間引き職人
hegemon	a leading or paramount power
schematically	模式的に
fountainhead	水源|《通例単数形で》(情報・霊感などの)源泉《+『of』+『名』》
dermatological	皮膚科学的
biodefense	procedures involved in taking defensive measures against attacks using biological agents
pressing	さし迫った|押す|緊急の|差し迫った|熱心な|懇願する
stockpot	スープなべ|ソースなべ
taxol	タキソール|がん化学療法で用いられる有糸分裂阻害剤の一つ|セイヨウイチイの樹皮から単離|肺がん|卵巣がん|乳がん|進行性カポジ肉腫患者他の治療に用いられる
eider	ケワタガモ(鳥)|ケワタガモの綿羽
fice	a nervous belligerent little mongrel dog
clumsily	無器用に
uncompress	解凍|展開|伸長
antimalarial	抗マラリア薬
interline	(語句などを)〈本の行間〉‘に'書きこむ《+『名』+『with』+『名』》
thruway	《米》高速道路
banksia	バンクシア
turpentine	テレピン油(松科の木から採る精油
borrelia	cause of e.g. European and African relapsing fever
somersault	宙返り|前転する|とんぼ返り
spork	スポーク
actualization	現実化|実現|具体化
chlorpromazine	クロルプロマジン|ソラジン|クロールプロマジン
subjugation	支配下に置くこと(置かれていること)|服従させること(していること)
nodular	節(ふし)の[ような]
unquestionable	全く確かな|疑う余地のない|確かな|申し分のない
borate	硼酸塩|硼酸エステル
deputation	〈U〉代理委任|〈C〉代表団
pragmatist	プラグマティスト|現実主義者|実務家|実用主義者|世話焼き|おせっかいな人
morphologically	形態学的に
mutilate	骨抜きにする|手足を切断する|切断する|不具にする
stepdaughter	継娘|配偶者の連れ子である娘
marjoram	マヨラナ(ハッカに似た植物);〈U〉(香料として料理・調剤に用いる)マヨラナ
isotonic	等張の(2種の溶液の浸透圧が等しい)
aplenty	たくさんの･に|豊富
titian	赤褐色|金褐色
moisten	湿らせる|潤す
bossy	親分風をふかせる|いばりちらす
subterfuge	口実|言い訳
highball	ハイボール
tracheostomy	気管切開
aetiology	《英》=etiology
epitaxy	growing a crystal layer of one mineral on the crystal base of another mineral in such a manner that its crystalline orientation is the same as that of the substrate
spineless	背骨の弱い|刺のない
idyll	田園詩|牧歌|物語詩|田園文学
neuropsychiatric	神経精神医学的
physic	《古》医薬|(特に)下剤|〜‘に'薬を飲ませる
concoct	(スープなど)を作り上げる|でっち上げる|調合する
daphnia	ミジンコ
bulbous	球根状の
anteater	アリクイ|ant-eater
parasitism	(生物)寄生|寄生生活|(反)symbiosis共生
whist	ホイスト|しっ!
biogeographic	of or relating to or involved with biogeography
swill	がぶがぶ飲む|痛飲
exhilaration	ウキウキした気分
neckwear	えりもと服飾品(ネクタイ・スカーフなど)
lockbox	貸し金庫
fastening	留め具|締まる
comfrey	ヒレハリソウ(毛ばだった葉のムラサキ科の植物)
inexact	不正確な
polder	(特にオランダの)干拓地|低地帯
eidolon	幻・幽霊・幻想・理想像
ketch	2本マストの小型帆船
gloat	満足げに眺める|ほくそえむ|さも満足そうに眺める|ほれぼれと見る
intensifier	増圧器|(文法)強度語
dopa	ジヒドロキシフェニルアラニン
treeless	樹木のない
resourcefulness	才覚|臨機応変
stearic	of or relating to or composed of fat
distemper	社会不安|騒乱|熱性疾患|不機嫌|病的にする|目やに等が出る犬のジステンパーウィルス|Canine distemper)
aground	座礁して
splendidly	立派に
electrocution	感電死
avocet	ソリハシセイタカシギ(長脚でくちばしが長く河口・海岸に住む水鳥)
inattention	油断|不注意
integrally	in an integral manner
recuse	忌避する
untagged	非標識
moselle	モーゼル
miscalculation	誤算|見込み違い
uncategorised	not categorized or sorted
malathion	マラチオン
crudely	粗野に
boucle	a fabric of uneven yarn that has an uneven knobby effect
testamentary	遺言の|遺言による
ciliary	睫毛(まつげ=lash)の|繊毛の
bayberry	月桂樹の実|ヤマモモの実
wobbler	something that wobbles
otherworldly	別世界の
profuse	気前のよい|豊富な|大量の|物惜しみしない|金遣いの荒い|贅沢な
gazer	見詰める(凝視する)人
vincristine	ビンクリスチン
airlock	エアロック|圧力容器内の気圧低下を防ぎ人間や物体を圧力容器の内外に通過させる装置|日本語で気閘(きこう)と言う
rickets	くる病|(背骨が弓なりに曲がって体が前かがみになる病気)
horology	時計学|測時学
knighthood	騎士道
shf	ＳＨＦ
elicitation	(事実・返事などを)引き出すこと
donatello	ドナテッロ
dural	of or relating to the dura mater
penniless	一文なしの|ひどく貧乏な|まったく金がない
lapin	ウサギ(の毛皮)
thromboembolism	血栓塞栓症
germline	生殖細胞系列
diadem	王権|主権|頭上に輝く光栄|王冠
kingship	王政|王位|王の身分|王権
interrogative	疑問の|不審そうな|疑問詞(what|when|whereなど)|疑問構文
tamarindo	タマリンド|タマリンド
arcadian	牧歌的
vastness	巨大さ
amniocentesis	羊水採取(胎児の性別・染色体異常診断のために羊水を調べる方法)
burdock	ゴボウ
externality	外界|外観|外的影響|外部効果|外面(性)|客観性|形式主義|予期せぬ結果
sabot	サボ(フランス・オランダなどで農夫などがはいた木靴|または木底靴)
precipitous	切り立った|険しい|絶壁の|崖のような
darter	突進する人(物)|ヤウオ(米国産のスズキ科の小さな淡水魚)
thereabouts	おおよそその辺に|大体そのころ;およそ〜ぐらい
weald	森林地帯
unexploded	still capable of exploding or being fired; "undischarged ammunition"; "an unexploded bomb"|still capable of exploding or being fired
explicate	詳細に説明する
zygote	接合子|接合体
dicey	あぶなっかしい
hocus	に薬を一服盛る|でっち上げる|偽造する|水増しする|詐欺|薬入りの飲み物|酔っぱらった
prenuptial	relating to events before a marriage; "prenuptial agreement"|relating to events before a marriage
sameness	同一性
disraeli	ディズレーリ
arapaho	a member of a tribe of Plains Indians formerly inhabiting eastern Colorado and Wyoming (now living in Oklahoma and Wyoming)|the Algonquian language spoken by the Arapaho
hotness	暑さ
dowdy	流行遅れの|だらしない|むさくるしい|野暮な|時代遅れの|みすぼらしい
tomographic	断層
cheviot	シェビオット織り(粗いあや織りの毛織物)
recklessness	無関心
allspice	オールスパイス(熱帯アメリカ産の低木;その実から香辛料をとる)
thunderstruck	びっくり仰天した
surreptitiously	(特に|不正な理由で)人目を忍んで行な|内密の|こそこそとする
finery	華美な装飾品|美服|美装
crybaby	泣き虫|弱虫
tiro	=tyro
dibble	ディブル(地面に穴をあける先のとがった園芸用具)|〈地面〉‘に'ディブルで穴をあける;〈植物〉‘を'ディブルで穴を掘って植える|ディブルで穴をあける
lindane	リンデン
horsetail	馬の尾(昔トルコで軍旗として用いた)|トクサ(シダ植物トクサ属の多年草の総称)
technicality	専門的に
physicochemical	物理化学的
histopathological	組織病理学的な
tanner	なめし皮工
cenozoic	新生代
plenipotentiary	(特に外交使節などが)全権を有する|全権大使(使節)
simpleton	だまされやすい人|ばか
scribbler	三文文士|へぼ作家
spurge	any of numerous plants of the genus Euphorbia; usually having milky often poisonous juice|any of numerous plants of the genus Euphorbia|usually having milky often poisonous juice
dilly	特に目立つもの|優れたもの
workup	ごみ(印刷用語で詰め物などによる汚れのこと)
allude	ほのめかす|それとなく言う
circumferential	周辺の
folky	フォーキー|フォークソング的な
centromere	動原体|セントロメア
rooibos	ルイボス
wrangle	口論する|口論
reappraisal	再評価
unsavory	(道徳的に)かんばしくない|いやな味(におい)がする|うまくない|不快な
parenthetical	挿入句
deservedly	当然|正当に
souk	an open-air market in an Arabian city
uveitis	ブドウ膜炎
tdt	(astronomy) a measure of time defined by Earth's orbital motion; terrestrial time is mean solar time corrected for the irregularities of the Earth's motions|a measure of time defined by Earth's orbital motion|terrestrial time is mean solar time corrected for the irregularities of the Earth's motions
gangrene	壊疽(えそ)|脱疽|柔らかい組織の死滅状態
chipboard	チップボード(材木くずを再加工した新建材の一種)
purplish	紫色がかった
strafe	地上掃射する|猛爆撃(する)
sorb	吸い上げる|吸いとる|吸取る|吸い取る
glycolysis	解糖系|生体内に存在する生化学反応の名称|グルコースをピルビン酸などの有機酸に分解(異化)し|グルコースの高い結合エネルギーを生物が使いやすい形に変換する代謝過程
fracas	けんか|騒ぎ|どなり合い
myopathy	any pathology of the muscles that is not attributable to nerve dysfunction
grudgingly	いやいやながら
bawdy	みだらな|わいせつな|下品な|艶笑の
hyperlipidemia	脂肪血症|高脂血症
bole	木の幹(=trunk)
unafraid	恐れない
hypermarket	大スーパーマーケット
perturb	かき乱す|を不安にする|を混乱させる
psoriatic	乾癬(かんせん)の
launder	洗たくする|洗たくしてアイロンをかける
glioblastoma	グリア芽腫
defroster	(冷蔵庫の)霜取り装置;(自動車・飛行機の前面ガラスに取りつける)防氷装置
omnipotence	全能|全能の神|無限力
irresponsibility	無責任
weatherly	(of a sailing vessel) making very little leeway when close-hauled
multistage	(ロケットが)多段式の
conscientiously	誠実に
transiently	一時的に
vulvar	産卵口
beaut	美人(俗)
agitate	扇動する|激しく動かす|かきたてる
weedy	雑草の多い|ひょろひょろとした
saleable	=salable
ultrasonics	超音波学
granulation	肉芽組織
hooter	フクロウ|汽笛|警笛|号笛|ラッパ|サイレン|やじ|鼻|一杯|少量|マリファナ|コカイン
craw	(下等動物の)胃袋　
thespian	悲劇の|(一般に)演劇の|悲劇役者|(しばしばおどけて)俳優|役者
foursquare	(特に建物が)正方形の|断固たる
victimisation	食い物|搾取
superstring	a hypothetical particle that is the elementary particle in a theory of space-time
interject	差しはさむ|(言葉などを)不意にさしはさむ
backflip	後ろ宙返りをする|バク転をする|態度をころりと変える|後ろ宙返り|態度の反転
frittata	Italian omelet with diced vegetables and meats; cooked until bottom is set then inverted into another pan to cook the top|Italian omelet with diced vegetables and meats|cooked until bottom is set then inverted into another pan to cook the top
wedgie	a shoe with a wedge heel
receptivity	感受性|感受性が強いこと|受容性|理解力
agoraphobia	広場(空間)恐怖症(広い場所にいることをこわがる神経症)
sarcastically	皮肉たっぷりに
reverent	うやうやしい|敬けんな
druggist	=pharmacist|ドラッグストアの経営者|薬屋
unquestioned	疑う余地のない
migrator	遊走生物
estrus	発情(期)
afoul	からまって|衝突して
savagely	獰猛に|無作法に|野蛮に|猛然
divot	(ゴルフクラブでそぎ取られた)芝生の小さな塊
meridional	(特にヨーロッパ諸国で)南部の
seance	セッション
micronutrient	a substance needed only in small amounts for normal body function (e.g., vitamins or minerals)
magnoliophyta	comprising flowering plants that produce seeds enclosed in an ovary; in some systems considered a class (Angiospermae) and in others a division (Magnoliophyta or Anthophyta)|comprising flowering plants that produce seeds enclosed in an ovary|in some systems considered a class (Angiospermae) and in others a division (Magnoliophyta or Anthophyta)
opalescent	(オパールのように)にじ色に変化する
contemptuous	軽蔑を示す|人を馬鹿にした|人をばかにした|軽蔑して
reorientation	a fresh orientation; a changed set of attitudes and beliefs|a fresh orientation|a changed set of attitudes and beliefs
instate	(地位などに)〈人〉‘を'つける|任命する
bataan	コレヒドール島
corynebacterium	コリネバクテリウム属
toxicologist	毒物学者(専門家)
ersatz	代用品|模造品|イミテーション|代用の
deconvolution	逆重畳積分|デコンボリューション|たたみ込み(convolution)からもとの関数を求めること|(たたみ込みは画像処理を実行するときに最も頻繁に用いられる計算のひとつ)
moribund	停滞した|瀕死の|消滅しかけている
killdeer	フタオビチドリ
plagioclase	斜長石
frivolity	軽薄|浅薄|軽々しい言動|くだらないこと
channelize	進路を取る|チャネル化する|運輸|送配|渡す|輸する|移送|送致|運搬|運送|運ぶ|搬送|チャネル化する
prothrombin	プロトロンビン|血しょう中のタンパク質で|トロンビンの不活性前駆体と呼ばれる
vermiculite	バーミキュライト|ひる石(熱するとふくれ|防音・断熱材として用いられる)
unavoidably	必定|勢
eichmann	アイヒマン
dele	(印刷物の校正で)〜'を'削除する|削除記号
commissar	コミッサール|共産党統制委員|人民委員
plod	こつこつ働くこと|とぼとぼ歩く(こと)|ゆっくり進む|こつこつ取り組む
menial	くだらない|つまらない|熟練のいらない|卑屈な|召使の
clayey	粘土の|粘土質の
gamecock	闘鶏
biddy	めんどり(hen)|おしゃべりな老女
temazepam	a frequently prescribed benzodiazepine (trade name Restoril); takes effect slowly and lasts long enough to help those people who wake up frequently during the night|a frequently prescribed benzodiazepine (trade name Restoril)|takes effect slowly and lasts long enough to help those people who wake up frequently during the night
dogfight	空中戦|乱闘
morphologic	形態学的な
synchronously	同時
amenorrhea	無月経
nucleolus	核小体
ineffectiveness	非有効性
picea	トウヒ属
disjunctive	(文法)離接的な|離接接続詞
dutiful	従順な
vehement	熱烈な|熱狂的な|激しい
gordian	extremely intricate; usually in phrase `Gordian knot'|extremely intricate|usually in phrase `Gordian knot'
edification	教化
causally	因果
unquote	引用終わり
deadpan	無表情な(で)
xxxvii	being seven more than thirty
intestate	遺言を残していない
affaire	通常|情事|不適な関係に使われる
excavate	掘る|掘削する|穴を掘る
fatten	太(らせ)る|(土地を)肥やす
insincere	不真面目な|偽善的な|言行不一致の
aventurine	サンストーン
privet	イボタノキ(垣根などに用いる常緑低木)
uncompensated	補償されていない
reasoner	論証者
acculturation	文化変容
brainwash	洗脳
eldritch	薄気味悪い|奇奇怪怪|この世のものとは思えない|底気味わるい|気味わるい|きみ悪い|底気味悪い|うす気味悪い|怪奇|不気味
raffia	〈U〉ラフィア)ラフィアヤシの葉の強い繊維;帽子・かごなどを作る|〈C〉ラフィアヤシ(raffia palm)
bicker	言い争う|口論(する)
trusteeship	〈C〉〈U〉受託者(評議員|理事)の地位|〈U〉(国連の)信託統治|=trust territory
positivism	実証主義|積極性|明確性
begone	立ち去る|消えうせる
flamethrower	火炎放射器
lucidity	明快さ|わかりやすさ
refractometer	屈折計
counterfactual	going counter to the facts (usually as a hypothesis)
toque	(tóʊk)|トーク(つばなしの小型の婦人帽)|羽かざりのついたビロードの帽子
retractor	開創器
martes	martens
arctan	アークタンジェント
lateness	遅いこと|遅れ|遅刻
synchronise	同期|同期|同期化|同調|シンクロナイズ|シンクロさせる|同期させる
cajole	甘言でだます|丸め込む
repulse	反撃|反論|ひじ鉄|を反駁する|を撃退する|を反撃する|を拒否する
formalwear	アフターダーク|夜会服|イブニングドレス
allegretto	(音楽の演奏の指示で)やや急速に(な)|アレグレット|やや急速な調子の楽章
changeling	鈍ま|ひょうろく玉|低能者|たわけ|戯者|二本棒|ぼんくら|知恵遅れ|おたんちん|取替え子
crosswind	(進行道向に対し)直角に吹く風|横風
nunnery	女子修道院
entangle	もつれさせる|からませる|(もめ事など)に巻き込む
diverticulitis	憩室炎
celibate	(宗教的理由による)独身者|独身主義者|(一般的な独身者|男bachelor|女spinster|a bachelor girl)
chinaberry	センダン|センダン
schistosomiasis	住血吸虫病
disturbingly	不安なこと
soaker	土砂降り|大雨|豪雨|どしゃ降り|ヘビードリンカー
faultless	過失のない;欠点のない|申し分のない
awkwardness	不器用さ|ぎこちなさ|気まずさ
nonfinancial	非金融
praiseworthy	賞賛に値した|賞賛に値する