plaintive	悲しげな|哀調に満ちた|哀れな|憂鬱な
disreputable	評判の悪い|悪評の|不評の
strikeout	三振
seraph	最高位の天使(聖書の中の人の形をした3対の翼のある天使)
cartwheel	(荷馬車･荷車の)車輪|側転|(口)大型硬貨
thymic	胸腺の
frill	フリルを付ける|フリル
reaffirmation	再確認
noradrenaline	ノルアドレナリン|ノルエピネフリン
bookclub	a club that people join in order to buy selected books at reduced prices
hemangioma	血管腫
dollop	(dάləp)|塊|ちょっぴり|ひとさじ分|少量|たっぷり塗る|どっさり配る
neutralizer	中立化させる人;中和剤
exudate	浸出液
smokescreen	煙幕|(一般に)隠す(ごまかす)ためのもの
afterimage	(心の中に残った)残像
gook	(俗)ごみ|泥|ねっとりした液|まぬけ|東洋人
hedonistic	快楽主義の
ballade	バラード|物語詩|譚(たん)詩(フランス詩の一形式)|(音楽の)バラード|譚詩曲
skimp	けちけちする|ちびちび与える
tyro	初心者|ビギナー
harpy	ハーピー(顔と体が女で鳥の翼とつめを持った貪欲な怪物|ギリシア神話)
yellowtail	ブリ
outshine	に光り勝つ
obsessively	しきりに
handily	手近に
untruth	虚偽
ponderous	非常に重い|重々しい|重苦しい
ribozyme	リボザイム|リボ核酸 (RNA)の一種で|触媒としてはたらく酵素の名
scrupulously	良心的に|注意して|細心に|実直に
technobabble	technical jargon from computing and other high-tech subjects
blat	(羊がメーメー|犬がクンクン)鳴く|騒々しい音(を立てる)|を大声でしゃべりまくる|うっかりしゃべる
blurt	口を滑らす|うっかり口に出す
carbonaceous	炭素質の;炭素を含む
quixotic	ロマンチック|ロマンティック|浪漫的|ローマン的|空想的
panicum	キビ属
underperform	perform less well or with less success than expected; "John consistently underachieves, although he is very able"; "My stocks underperformed last year"|perform less well or with less success than expected|perform too rarely; "Her plays are underperformed, although they are very good"|perform too rarely
athleticism	運動競技熱|スポーツ熱
deride	あざ笑う|あざける|あざわらう|ばかにする
antipasto	(食事の主品の前に出る)前菜
sustainer	someone who upholds or maintains; "firm upholders of tradition"; "they are sustainers of the idea of democracy"|someone who upholds or maintains
nasopharyngeal	鼻咽頭
marginalize	relegate to a lower or outer edge, as of specific groups of people; "We must not marginalize the poor in our society"|relegate to a lower or outer edge, as of specific groups of people
relaxer	any agent that produces relaxation; "music is a good relaxer"|any agent that produces relaxation
nother	その他の何もない|Ex|nother thing just occurred to me
unequaled	類ない|無類|類の無い|又ない|並び無い|類いない|又無い|類のない|並びない|類い希
plucky	勇気のある|元気な|断固たる
eusebius	エウセビオス
untidy	だらしない
loggia	ロジア(片側に壁のない柱廊)
baobab	バオバブ(の木)|マダガスカル|豪|アフリカに分布|高さ30ｍ|直径10ｍになり|年輪が無いが樹齢数千年とされる|果肉|若葉は食用|種子は油|樹皮は編んで強靭なロープになる
subluxation	亜脱臼
multicellular	多細胞の
cedarwood	durable aromatic wood of any of numerous cedar trees; especially wood of the red cedar often used for cedar chests|durable aromatic wood of any of numerous cedar trees|especially wood of the red cedar often used for cedar chests
workroom	仕事部屋|作業室
phlebotomy	瀉血
rubus	キイチゴ属
unjustifiable	incapable of being justified or explained
boor	オランダ人小作農|小百姓|粗野な男|田舎者|不作法者
pedant	学者ぶる人|衒学者
vetch	ソラマメ|ヤハズエンドウ|カラスノエンドウ
shuffler	足を引きずって歩く人|(配る前に)カードを切る人
goiter	甲状腺腫
dramatize	脚色する|劇にする|戯曲化する|劇的に表現する
microscopically	顕微鏡で;顕微鏡で見るように
defibrillation	電気的除細動
animism	アニミズム(自然物・自然現象などに霊魂があるとする信仰)|精霊説(人および物の活動はすべて霊の力によるとする信仰)
conciliatory	懐柔的な|なだめるような
credibly	信用できて|確かな筋から
syncytial	合胞体|複数の核を含んだ細胞のこと(動物に見られる)
psalmist	賛美歌作者
nefertiti	ネフェルティティ
runnel	小川(runlet)
hemerocallis	east Asian rhizomatous clump-forming perennial herbs having flowers on long leafless stalks; cosmopolitan in cultivation: day lilies; sometimes placed in subfamily Hemerocallidaceae|east Asian rhizomatous clump-forming perennial herbs having flowers on long leafless stalks|cosmopolitan in cultivation: day lilies|sometimes placed in subfamily Hemerocallidaceae
filtrate	ろ過水|ろ過液|=filter
plantae	植物界
pyre	(pάɪɚ) (火葬用の)積み薪|(一般の)積んだ薪
twiddle	もてあそぶ|ひねり
basswood	=bass
patrimony	世襲財産|伝承|遺伝
downtrodden	踏みにじられた
strix	owls lacking ear tufts
reflexion	返照|反映|反射|照り返し|反照|リフレクション|照りかえし|表われ|エキスプレッション|顕れ|反映|表現|現れ|現われ|表れ|エクスプレッション|顕われ|熟考|潛心|思索|思慮深いこと|観照|観想|黙想|深慮|黙考|沈思|反射|鏡像|写|映像|倒影|映像
demerol	メペリジン
amanita	genus of widely distributed agarics that have white spores and are poisonous with few exceptions
croup	クループ|上気道のウイルス感染による疾患|小児の15%が一度は感染し|生後半年から6歳までの小児に多く10代や成人の感染例はまずない
scrawl	なぐり書きにする|走り書きする|走り書き|(～を)なぐり書きする
lintel	まぐさ(楣|入り口･窓の上の横木|建築用語)|楣石|リンテル
humperdinck	フンパーディンク
broadcloth	幅広の黒ラシャ|ブロード(緻密な木綿・絹・レーヨンなどの生地で|ワイシャツ・パジャマ・婦人服などに用いる)
disuse	不使用|廃止
nock	印す|銘打つ|刻む|標す
ineptitude	不適当|愚かさ
classless	平等主義の
alkaloid	アルカロイド(Alkaloid)|窒素原子を含み|塩基性を示す天然由来の有機化合物の総称|微生物|真菌|植物|動物等の生物によって生産され|他の生物に対し有毒である
glittery	キラキラ輝く
vicariously	代理に|身代わりに
amendatory	effecting amendment; "added amendatory phrases to the text"|effecting amendment
handedness	利き手|側性
esthetician	a worker skilled in giving beauty treatments (manicures and facials etc.)|a philosopher who specializes in the nature of beauty
thermoset	熱硬化性
psychoanalyst	精神分析学者
appealable	capable of being appealed especially to a higher tribunal; "decisions...appealable to the head of the agency"- New Republic|capable of being appealed especially to a higher tribunal
waw	the 6th letter of the Hebrew alphabet
garish	ぎらぎら光る|けばけばしい|派手な|ごてごて飾りたてた
pappa	パパ|お父ちゃん|父っつぁん|ちゃん|父ちゃん
hcfc	ハイドロクロロフルオロカーボン
toupee	(はげ隠し用)男性かつら
baronet	准男爵|従男爵(英国世襲位階の最下級でbaronの下knightの上)
atresia	閉鎖
bombastic	誇大な|大げさな|大言壮語の|豪語する
turnoff	分岐点
remount	〜に再び乗る|再び登る|〈軍隊など〉‘に'新馬を供給する|新馬を入れる|〈絵・写真など〉‘を'新しい厚紙に貼りかえる|再び馬(自転車など)に乗る|新馬|補充馬;新馬の補充
blowback	バックファイア
circumpolar	北極(南極)周辺の|(星が)天極の回りを円を描いて回る
unearthly	この世のものとも思われない|気味悪い
bacteremia	菌血症
predestination	運命・ 宿命; 【神学】（運命）予定説・宿命論(この世のすべての事は神の予定によるとする考え)
aalto	アルヴァ・アールト
fiducial	relating to or of the nature of a legal trust (i.e. the holding of something in trust for another); "a fiduciary contract"; "in a fiduciary capacity"; "fiducial power"|relating to or of the nature of a legal trust (i.e. the holding of something in trust for another)|used as a fixed standard of reference for comparison or measurement; "a fiducial point"|used as a fixed standard of reference for comparison or measurement|based on trust
alberti	アルベルチ
regulus	レグルス|レグルス
dishevel	〈髪など〉‘を'ぼさぼさに垂らす;〈着物など〉‘を'だらんと着る
extramarital	婚外性交の
reclassify	再分類
trichloroethylene	トリクロロエタン
carcase	枝肉
languid	不活発な|だるい
sympathise	気の毒に思うこと|同情|共鳴する
anachronistic	時代錯誤の
starkly	全く
ratty	ねずみのような
fearfully	すごく
fingerless	not having or having lost fingers
phalaenopsis	コチョウラン
boatyard	a place where boats are built or maintained or stored
musketeer	銃兵
unhindered	not slowed or blocked or interfered with; "an outlet for healthy and unhampered action"; "a priest unhampered by scruple"; "the new stock market was unhampered by tradition"|not slowed or blocked or interfered with
upstage	舞台の後方の|内気な
smokestack	重工業の
homogenization	均質化
pilaf	ピラフ
neurofibromatosis	神経線維腫症
fondle	かわいがる|愛撫する
scree	小石|砂利
lithe	しなやかな|柔軟な
humanely	思いやりをもって|人道的
uncoordinated	lacking in cooperative planning and organization ; "uncoordinated scheduling often resulted in conflicting games"|lacking in cooperative planning and organization |lacking the skillful and effective interaction of muscle movements; "his movements are uncoordinated"; "an uncoordinated toddler"|lacking the skillful and effective interaction of muscle movements
teletype	teletypewriterの商標名|テレタイプ社|テレタイプで送る
incompletely	不完全に
phrasal	句の|句からなる
sigmoid	curved in two directions (like the letter S)|of or relating to the sigmoid flexure in the large intestine
neuroma	神経腫
gaiety	はで|陽気
gadolinium	ガドリニウム
azonic	not restricted to any particular zone or region
frangipani	インドソケイ|プルメリヤ|プルメリア
uttermost	最も遠く離れた|最もはずれの|最大限の|極度の|最大限度|極限
squib	爆竹|導火爆管|小花火|(政治家攻撃)機智に富んだ文|風刺
gladiolus	グラジオラス|グラジオラス
microbrewery	地ビールの醸造所
aeolian	a member of one of four linguistic divisions of the prehistoric Greeks|the ancient Greek inhabitants of Aeolia|of or pertaining to Aeolus, the Greek god of the winds; relating to or caused by the wind|of or pertaining to Aeolus, the Greek god of the winds|relating to or caused by the wind|of or relating to Aeolis or its ancient Greek people
gunny	(袋などを作る)目のあらい麻布
lave	〜‘を'洗う(wash)|浸す|〈流れなどが〉〈岸〉‘を'洗う
headstock	主軸台
crabgrass	オイシバ(ヒメシバ属)の草
porker	(食用に肥らせる)子豚|《おどけて》豚
dugong	ジュゴン(インド洋に住むイルカに似た水生哺乳(ほにゅう)動物)
monoculture	モノカルチャー
trie	順序の付いた木構造 (データ構造)の一種|トライ木(Trie)|語源は|検索 retrievalの単語の真ん中(trie)に由来|発音はtriː に近い
phoney	=phony・〔話〕 にせの; 〔話〕 にせ物; 〔話〕 いかさま師
sheepish	(羊のように)内気な|恥ずかしがる|気の弱い|おどおどした
encephalomyelitis	脳脊髄炎
decimate	10人に1人をくじで殺す|殺す|倒す|多量に殺す
incestuous	近親相姦の|排他的な
antic	おどけた(しぐさ)|風変わりで滑稽な|怪奇な
abed	就床して
nubile	年ごろで性的魅力のある|(女性が)結婚適齢期の
dreadfully	すごく
uncool	格好悪い
contemptible	侮べつに値する|いやしむべき
dentin	象牙質|象牙質
crosstown	across a town or city; "he traveled crosstown"|across a town or city|going or extending across a town or city; "the crosstown bus"; "crosstown traffic"|going or extending across a town or city
unfailing	尽きることのない|絶えない|信誉できる|不変の|一定の
untoward	都合の悪い|困った|不幸な
kludge	クラッジ
acrylonitrile	アクリロニトリル
chlorite	緑泥石
bonehead	(俗)ばか
erving	アービング
synonymy	〈U〉同義[性]|〈U〉同義語(類語)研究|〈C〉同義語集|類語表|〈U〉(強調のため)同意語を重ねて用いること
neutralise	片付ける|抹殺|中和|中和|消滅|中和
threader	a blunt needle for threading ribbon through loops
zakat	ザカート
dolmen	ドルメン
theorize	理論づける|理論をたてる|空論にふける
hybridoma	ハイブリドーマ|ハイブリードマ
muzzleloader	(銃口から装てんする)前込め砲|前装砲
defloration	花の散らすこと;美(新鮮さ)を奪うこと|処女を奪うこと
maildrop	a drop where mail can be deposited
metaphase	(生物学用語)中期(核分裂の)|細胞分裂で染色体が赤道板状に並んだ時期
labile	変りやすい|不安定な
cushy	楽しい
indeterminacy	不確定(性)
playfulness	茶目っ気|遊び心
irrationality	不合理
pastiche	(仏語)文体を模写すること (音楽の)替え歌|パスティーシュ
whodunit	推理(探偵(たんてい))小説(映画)|ミステリーもの
confluent	合流する|支流
mistrial	誤審|裁判での誤った判決|無効審理
loaner	someone who lends money or gives credit in business matters|a car that is lent as a replacement for one that is under repair
gunfighter	銃(ピストル)を用いる決闘者
impingement	差し響き|インパクト|感化|差響き|差しひびき|影響|差響|さし響き|嵌入|衝突
chamfer	〈板〉‘の'かどをそぐ;〈板〉‘に'みぞをつける|(板・角材の)そがれたかど;板につけたみぞ
beckon	手招きする|(身振りで)招く|差し招く
pickpocket	スリ
grappa	グラッパ
haunting	絶えず心に浮かぶ
conglomeration	集塊|凝塊|かたまり|集まること
rejoinder	答弁|返答|応答|言い返し
lanolin	ラノリン|ラノリン
immunocompromised	免疫不全の
autoradiography	オートラジオグラフィー(放射線写真法)|放射性物質のベータ線やガンマ線で画像(autoradiograph)を作る手法|放射性物質はreceptor(受容体)や酵素や核酸に結合する
willet	large North American shorebird of eastern and Gulf Coasts
overzealous	熱心過ぎる
stuntman	スタントマン(映画などで危険な場面の代役をする人;女性はstunt woman)
gilt	金メッキする|金の|金箔の
sapper	工兵隊員|敵前工作兵
hydrazine	ヒドラジン
incommunicado	(特に囚人が)他との連絡を断たれた
fossilize	石化|化石|化石
unheated	not having been heated or warmed; "an unheated room"; "unwarmed rolls"|not having been heated or warmed
chitin	キチン質(節足動物の殻などを構成する角質の成分)
nihil	ニヒル
ovine	of or pertaining to or of the nature of or characteristic of a sheep or sheep
unsay	〈言ったこと〉‘を'取り消す|撤回する|言わなかったことにする
maleate	マレイン酸塩
steelwork	鋼鉄製品;鋼鉄部品
lanky	やせ気味の
reave	分捕る|奪い取る|掠め奪う|押取る|略取|押し取る|寇掠|略す|掠める|収奪
turnbuckle	引き締めねじ|締め金具
waterhole	水たまり|泉|パブ|ホテル
globalism	グローバリズム(孤立主義に対し|一国が国際関係に積極的にかかわること)
axially	軸方向
officiant	祭式執行者
familiarization	the experience of becoming familiar with something
collude	共謀する
emirate	アラビアの首長の権限(身分)
frontrunner	(競技で)先頭を走る選手(馬など);ペースメーカー
ermine	鼬|オコジョ|鼬鼠
inventiveness	the power of creative imagination
corroboration	裏付け|確証する|補強する
steinman	スタインマン
refract	〈水・ガラスなどが〉〈光〉‘を'屈折させる
cottontail	ワタオウサギ(綿毛のような白い毛のウサギ;米国産)
socialise	仲良く交際する|交際する|社会化|社会化|社会化
capitulation	条件付降伏|降伏|降伏文書
tuning	音合|音合わせ|音合せ|チューニング|音取|調律|音取り|調弦
formalise	儀式張る|儀式張る
pestis	ペスト|疫癘
thyrotropin	甲状腺刺激ホルモン
banality	陳腐さ|ありふれていること
downdraft	下降気流
dryad	ドリュアス(ギリシア神話の樹木の精)
fallible	誤りに陥りがちな|誤りを免れない
pantheism	汎神(はんしん)論(神と自然とを同一視する)|多神教;自然崇拝
ploughshare	=plowshare
incalculable	数え切れない
hierarch	高僧|主席主教|貴僧|主席司教|高位聖職者
figurehead	船首像|名目上の頭首|表看板|名目上の頭主
pearlescent	真珠光沢のある
mammy	ママ|黒人の乳母|(mummyもママの意味がある|ミイラの意も)
organon	a system of principles for philosophic or scientific investigations; an instrument for acquiring knowledge|a system of principles for philosophic or scientific investigations|an instrument for acquiring knowledge
bloodstock	(競走馬としての)サラブレット
colorimetric	of or relating to colorimetry
shindig	にぎやかな社交の集まり|(陽気な)パーティー|宴会|舞踏会
cheapen	安くなる(する)|見くびる
indolent	無精な|怠惰な|なまける
whitefly	minute insect that feeds on plant juices; related to scale insects|minute insect that feeds on plant juices|related to scale insects
quayside	波止場地域|(quay|波止場)
meandering	蜿々たる|蜒々たる|蜿蜒たる|蜿蜿たる|蜒蜒たる|曲がりくねった
banns	結婚予告(教会での挙式前に新郎新婦の名前を公表し|その結婚に対いる異議の有無を問う)
subsidization	下付金|交附|下げ渡し|供与|附与|施与|下渡し|恵賜|交付金|付与
fixative	固定液
asparagine	アスパラギン(アミノ酸のひとつ)
ennui	(仏語)倦怠|退屈|手持ちぶさた|アンニュイ
daystar	夜明けの明星|一つ星|明の明星
drome	空港|ドローム|エアポート|飛行場
intentionality	expressive of intentions
accusative	accusative case対格|名詞がもつ格のひとつ|他動詞の直接目的語を示す(ご飯を作る|など)|対格はすべての印欧語族に存在
pusey	ピュージー
cohesiveness	結合力のあること|結合の緊密さ|結合|纏り|纏まり
verdigris	緑青
expunge	消し去る|抹消する|ぬぐい取る|破壊する|絶滅させる|(語など)を削除する|抹殺する
employable	(人を)雇用できる;(物が)使用できる
hydrography	水路学|水路測量術
equilibration	平衡
exigent	(事情などが)切迫した|緊急の|(人が)しつっこい|しきりにせがむ
breadwinner	(一家の生計を支える)稼ぎ手|大黒柱
bactericidal	殺菌の
carbamate	カルバメート
spacing	間隔|スペーシング
feverishly	無我夢中で
ventriloquist	腹話術師
hairball	毛球(猫などが飲み込んだ毛が腸の中で球状になったもの)
forecourt	フォアコート|前庭
molest	妨害する|苦しめる|乱暴する
tailpiece	終りの部分|末端のもの;終りの付加物|(書物の章末・巻末の)装飾図案
porgy	タイ|鯛(sea bream)|タイの類
persuasively	説得力のある
walloon	a member of the French-speaking people living in Belgium|a dialect of French spoken in Belgium and adjacent parts of France
patisserie	a bakery specializing in French pastry
septicemia	=blood poisoning
squalor	不潔さ|むさ苦しさ|卑劣
lyophilize	凍結乾燥
peristaltic	(腸壁などの)蠕動(ぜんどう)運動の[ような]
violative	violating or tending to violate or offend against; "violative of the principles of liberty"; "considered such depravity offensive against all laws of humanity"|violating or tending to violate or offend against
clincher	決定的な決め手|理由
painlessly	without pain; "after the surgery, she could move her arms painlessly"|without pain
legwork	足を使った詳しい調査|取材
ebon	=ebony
chanticleer	おんどり
mesmerize	催眠術をかける
filbert	ハシバミ;ハシバミの実
bougainvillea	ブーゲンビリア|熱帯性の低木で美しい密集した花をつける
paraplegia	対麻痺(ついまひ)(病気による両下肢(し)の麻痺)
triticum	コムギ
dinge	discoloration due to dirtiness|make a dent or impression in; "dinge a soft hat"|make a dent or impression in|make dingy
fluorocarbon	フッ化炭素|フルオロカーボン|過フッ化炭化水素
valiantly	果敢に
infallibility	絶対無謬性
varmint	害虫|有害動物|(話)下劣なやつ
actinide	アクチノイド
glutton	大食家|凝り屋|熱心家|クズリ(イタチ科)
ipv	ソークワクチン
adamantly	頑として|頑固に
kennan	ケナン
neoliberalism	新自由主義
unscripted	(ラジオ・テレビ放送で話題・談話が)台本なしの|草稿なしの
catchphrase	標語|キャッチフレーズ
herbivore	草食動物
pappy	おやじ|ドロドロの|パン粥状の|柔らかな
suppository	座薬
neurotrophic	神経栄養
tanka	短歌
seesaw	シーソー遊び|変動する
frighteningly	驚くほど恐ろしい
flaccid	たるんだ|だらけた|弛緩した|弛緩性の|ゆるんだ
drier	ドライヤー|乾いた
putrid	腐った|悪臭を放つ
necropsy	検死|部検
collinear	堂一直線上にある
obliteration	消すこと|抹殺(まっさつ)|削除;消滅
internist	内科医
partita	パルティータ(17・18世紀ごろのヨーロッパの器楽組曲)
downstate	州の南部|州南部へ(で)|州南部の|州南部特有の
carpetbagger	渡り政治屋|山師
womanly	女らしい|婦人にふさわしい
ringleader	張本人|首謀者|発頭人
cooter	large river turtle of the southern United States and northern Mexico
rightist	右翼の|右派|保守主義者
chorizo	チョリソ
judiciously	慎重に|賢明に
pneumothorax	abnormal presence of air in the pleural cavity resulting in the collapse of the lung; may be spontaneous (due to injury to the chest) or induced (as a treatment for tuberculosis)|abnormal presence of air in the pleural cavity resulting in the collapse of the lung|may be spontaneous (due to injury to the chest) or induced (as a treatment for tuberculosis)
hypersensitive	過敏な
photosensitive	感光性の
scavenge	清掃する|あさる
severable	分離可能
overpay	に払いすぎる
fibroid	(腫瘍などが)線維から成る|線維状の
penstemon	ペンステモン
leathery	革のような|(革のように)頑丈な|(肉などが)固い
extradite	送還する|引き渡す
packing	パッキング|包装
sophist	《しばしばS-》ソフィスド(古代ギリシアの一般教養・修辞・政治などを教えた教師)|詭弁(きべん)家|理屈屋
carburettor	キャブレター
guardsman	監視人|州兵|近衛兵|衛兵
trivialize	つまらなくする|平凡化する|矮小化する
subvention	(政府などからの)補助金|助成金
unbecoming	似つかわしくない|不適当な;(〜に)似つかわしくない《+to(for)+名》
deject	〜'を'落胆させる|がっかりさせる
parotid	relating to or located near the parotid gland
comely	美しい|みめよい|顔立ちのよい|器量のいい|ふさわしい
prow	船首
sprig	小枝|子孫
kerfuffle	騒動|言い争い(about)
empathic	showing empathy or ready comprehension of others' states; "a sensitive and empathetic school counselor"|showing empathy or ready comprehension of others' states
ovate	(特に葉が)卵形の
tinea	infections of the skin or nails caused by fungi and appearing as itching circular patches|type genus of the Tineidae: clothes moths
bonefish	ソトイワシ
genotypic	遺伝子型
gazpacho	ガスパーチョ|スペイン料理とポルトガル料理の冷製スープ
fiberboard	ファイバーボード|繊維板
seismological	of or concerned with seismology
comparably	同等に
plaything	遊び道具|玩具|おもちゃ(にされる人)
unoriginal	not original; not being or productive of something fresh and unusual; "the manuscript contained unoriginal emendations"; "his life had been unoriginal, conforming completely to the given pattern"- Gwethalyn Graham|not original|not being or productive of something fresh and unusual
pravastatin	プラバスタチン
calfskin	子牛の皮|カーフ(子牛のなめし皮)
underdevelopment	state of inadequate development; "much poverty can be traced to the underdevelopment of industry"|state of inadequate development|(photography) inadequate processing of film resulting in inadequate contrast|inadequate processing of film resulting in inadequate contrast
camping	キャンプ生活|野営
insignificance	つまらないこと|些細|取るに足りないこと|卑しい身分|無意味|(度量の)小ささ
miniaturization	小型化
mezuzah	メズーザー
surmount	を克服する|に登る|の上に置く
moderato	(曲の演奏で)モデラートの|ほどよい速さの|モデラートで|ほどよい速さで
pissy	(俗)小便臭い|つまらない|劣った|不快な|いやにぶった
nanticoke	ナンティコーク|ナンティコーク
untangle	のもつれを解く|(紛糾)解決する
imaginatively	想像力を働かせて
satirist	風刺作家|皮肉屋
katha	(サンスクリット語)story|speechの意
uncollected	not brought together in one place; "uncollected garbage in the streets"|not brought together in one place
isoproterenol	イソプロテレノール
malabsorption	吸収不良
telemarketer	テレマーケティングをする人
collimate	平行
gullet	食道
vegetal	野菜の|植物[性]の
indirection	間接|遠回し|間接的な行動
unequalled	類ない|無類|類の無い|又ない|並び無い|類いない|又無い|類のない|並びない|類い希
chrism	聖香油(教会で洗礼などの儀式に用いる油)
cabbie	(俗)タクシー運転手
mimetic	模倣の(好きな)|身振り描写の|擬態の
hemochromatosis	ヘモクロマトーシス|血色素沈着症|血色素症
visualiser	one whose prevailing mental imagery is visual
rubbery	ゴムのような|強い|硬い|弾性のある
temperamental	気性からくる|気質上の
mirabilis	four o'clocks
nauseous	吐き気を催させるような
mesoderm	中胚葉|動物の発生初期の細胞群の名称|外胚葉と内胚葉の間に発達し|筋肉や体腔などを作る
liquorice	=licorice
settlor	(law) a person who creates a trust by giving real or personal property in trust to a trustee for the benefit of a beneficiary; a person who gives such property is said to settle it on the trustee|a person who creates a trust by giving real or personal property in trust to a trustee for the benefit of a beneficiary|a person who gives such property is said to settle it on the trustee
paleontological	of or relating to paleontology
parallelogram	平行四辺形
osteotomy	surgical sectioning of bone
justinian	ユスティニアヌス1世
stoichiometric	of or relating to stoichiometry
dobbin	農耕馬
riz	ご飯
redbird	the male is bright red with black wings and tail|crested thick-billed North American finch having bright red plumage in the male
usurpation	強奪|奪取|権利侵害
coquette	男たらし|あだっぽい女
eucalypt	ユーカリ|ユーカリノキ
vermouth	ベルモット酒|ベルモット(カクテル用ブドウ酒)
innards	内臓|(ものの)内部|内部機構
cochlea	Cochlea(kóʊkliə)(内耳の)蝸牛管|渦巻管
cobweb	クモの巣
spica	穂状花序
masterwork	傑作
knucklehead	甚六|驢馬
totter	よちよち歩く|よろよろ歩く|よろめく|ぐらぐらする
punctually	時間(期限)どおりに
sinew	腱|筋肉|力
cretin	クレチン病患者|《俗》白痴(はくち)
unwillingly	いやいや
sequester	を隠退させる|を隔離する
undoubted	疑う余地のない|確かな|本物の
cholecystectomy	胆嚢切除
formless	無定形
marabou	ハゲコウ(アフリカ産のコウノトリの一種)|マラブー(ハゲコウの翼や尾の下の羽毛;婦人帽などの装飾用)
doubtfully	in a doubtful manner; "Gerald shook his head doubtfully"|in a doubtful manner
acetal	アセタール
capsize	〈特にボート・船が〉転覆する|〈特にボート・船〉'を'転覆させる
typhus	発疹チフス(typhusは発疹チフスで|腸チフス|パラチフスとは全く異なるが|混同されている)
reticent	言葉が控え目の|無口な
welter	転がる|のたうち回る|罪に身をひたす|混乱(状態)|ごった返し|(ボクシング)ウェルター級(約63|5-66|7kg)
entailment	暗示|含み|内含|含意|含蓄
brushy	ブラシのような|やぶの茂った
hopscotch	石けり遊び
invective	激しい非難|毒舌|非難|罵倒|侮辱的言辞
advertize	《米》=advertise
retentive	保持する力がある
lovastatin	ロバスタチン
tallapoosa	river that rises in northwestern Georgia and flows southwest through central Alabama to join the Coosa River near Montgomery and form the Alabama River
teepee	=tepee
alarmist	心配症の人|人騒がせな人
portend	の前兆となる
realizable	はっきり理解できる|実現できる|利益が得られる|《英》換金できる
housatonic	フーサトニック川
stomatitis	口内炎
masher	軟派|マッシャー
concomitantly	付随して
cowpea	ササゲ|ササゲ|ササゲ
neatness	きちんとしていること|整然|手ぎわのよいこと|器用
valuer	評価をする人|鑑定人;《英》価格査定官
featherbed	〈仕事〉‘を'水増し雇用で行う・フェザーベッディングの・水増し雇用を要求する
storekeeper	商店経営者
unbeliever	不信心者|懐疑的な人
crabmeat	カニ|蟹
faustus	ファウスト
showgirl	ショーガール(米国映画のタイトル名)
biogen	バイオジェン社|米国|生物学的製剤の研究|開発を行っている
spaz	無能な
unconvinced	納得できない
supremo	the most important person in an organization
hyperparathyroidism	副甲状腺機能亢進症
fugu	フグ
gamin	浮浪児
sulcus	溝
aldactone	スピロノラクトン
pseudoscience	疑似科学
neurogenic	arising in or stimulated by nerve tissues
epigram	警句|エピグラム|寸鉄詩|寸鉄的表現
immunoblot	免疫ブロット(免疫測定法の手法)
multiethnic	involving several ethnic groups
theocratic	神政の
drinkable	飲める|飲用に適した
toff	上流階流のしゃれ者
pejorative	軽蔑的な|非難の意を含む|軽蔑語|悪口
imu	a terrorist group of Islamic militants formed in 1996; opposes Uzbekistan's secular regime and wants to establish an Islamic state in central Asia; is a conduit for drugs from Afghanistan to central Asian countries|a terrorist group of Islamic militants formed in 1996|opposes Uzbekistan's secular regime and wants to establish an Islamic state in central Asia|is a conduit for drugs from Afghanistan to central Asian countries
midden	こやしの山|ごみの山|貝塚
callosum	脳梁(のうりょう)|左右の大脳半球をつなぐ(交連線維の)太い束
squiggle	短くくねくねした線
speculator	投機師|思索家|投機家
impatiens	ホウセンカ
confection	婦人用服店|菓子|ジャム|(candy などの)糖菓
groggy	グロッキーの|意識がもうろうとした
valvular	(特に心臓の)弁の
dander	ふけ|(口)怒り|He got his dander up|彼は癇癪を起こした
listless	気乗りしない|物憂げな|だるい|無関心な
federate	〜‘を'連邦制度にする;〜‘を'連合させて(〜を)作る《+『名』+『into』+『名』》|連邦化する|連合する
shelve	(問題など)を棚上げする|延期する|を棚にのせる|を解雇する
wheaten	小麦の;小麦[粉]製の
arugula	ルッコラ
copperas	緑礬(りょくばん)(青緑色の結晶で毛染め・インクの材料)
equalisation	the act of making equal or uniform
gastrin	ガストリン
professorial	教授の|教授らしい|学者ぶった|独断的な
ceramide	セラミド|細胞膜にある細胞シグナル伝達物質|分化|増殖|アポトーシス(細胞死)を制御し「細胞死のメッセンジャー」と呼ばれる|その合成障害でアトピー性皮膚炎などを生じる
ducal	公爵(duke)の|公爵らしい|公爵領の
dyadic	of or relating to a dyad or based on two
downcast	意気消沈した|伏し目の|落胆した
metatarsal	中足骨の|中足骨
sweatband	びん皮(帽子の内側に付ける汗よけの帯);(腕や額にまく)汗よけ用バンド
bloodstone	血玉髄|血石(玉髄に赤い斑点のある石)
destabilise	不安定化|不安定化
tedium	退屈|あきあきすること
seamanship	航海術|操船術
itraconazole	イトラコナゾール
orthogonality	垂直
sooth	(suːθ)真実|事実|現実|in sooth本当に|本当の|柔らかい|甘美な (soothe慰める|は別語)
sportive	遊び戯れる|ふざける(playful)
harmonium	ハルモニウム(オルガンに以た足踏み式の鍵盤楽器)
sirdar	an important person in India
lasagne	ラザーニャ(平たい麺(めん)を肉・チーズ・トマトで調理したイタリア料理)|= lasagna
latrine	便所|トイレ
informality	非公式|略式|形式ばらないこと
unexplainable	not to be accounted for or explained; "perceptible only as unaccountable influences that hinder progress"; "an unexplainable fear"|not to be accounted for or explained
beeline	最短コース
axil	葉腋
buttonhole	ボタン穴|《英》ボタンの穴に入れる花|〈衣服〉‘に'ボタン穴をつける|〈人〉'を'引きとめて長話をする
misadventure	不運|不運な出来事
isocyanate	イソシアン酸塩|イソシアネート
flyway	(繁殖地と越冬地の間の)渡り鳥の飛路
antiterrorism	テロ対抗策|テロ対抗措置
inhomogeneity	不均質性
electromagnet	電磁石
stinker	碌でなし|与太|惑い者|まどい者|芋虫|芋虫
abovementioned	《名詞の前にのみ用いて》上記の|前述の
servile	奴隷の(ような)|従順な|卑屈な|自主性のない
kudu	弘道
benzoic	ベンゾイン樹脂の|安息香[酸]に関する
rickety	倒れそうな|ぐらぐらした|よろよろの|くる病の|せむしの
roamer	流れ者|渡り者|放浪者|渡り鳥
marzipan	マジパン(すりつぶしたアーモンドで作る菓子)|マーチパン
unselected	選択されていない
capuchin	イエバトの一種|カプチン会修道士|フード付き女性用外套
gneiss	片麻岩
cycler	自転車に乗る人
prosaic	散文的な|趣のない
kilter	好調
sportswriter	スポーツライター
tush	牙|長くとがった歯|白黒混血児|お尻|危険な|好戦的な|上流の|チェッ!
anoxic	relating to or marked by a severe deficiency of oxygen in tissues or organs
okey	an endorsement; "they gave us the O.K. to go ahead"|an endorsement
flory	United States chemist who developed methods for studying long-chain molecules (1910-1985)
tittle	ごくわずか|小点|点画|みじんも|少しも|ささやく|しゃべる
imprudent	無分別な|軽率な|不謹慎な
foliation	葉飾り
bimodal	二峰性の
hospitalise	入院
humerus	(人・動物の)上腕骨
turboprop	ターボプロップエンジン(航空機)
friesian	ホルスタイン種
arsonist	放火犯|放火魔
sporulation	単性|胞子形成
undersized	小型の
variate	確率変数|変量
canticle	(聖書の文句からとった)聖歌|《the Canticles》(聖書の)雅歌|ソロモンの歌
chastisement	せっかん|懲罰
unmitigated	やわらげられない|軽減されない|純然たる|全くの
skink	alert agile lizard with reduced limbs and an elongated body covered with shiny scales; more dependent on moisture than most lizards; found in tropical regions worldwide|alert agile lizard with reduced limbs and an elongated body covered with shiny scales|more dependent on moisture than most lizards|found in tropical regions worldwide
stratagem	戦略|計略
foxhound	キツネ狩り用猟犬
lafitte	ラフィート
striatal	線条体
dinucleotide	ジヌクレオチド|核酸を構成する塩基|アデニン･グアニン･シトシン･ウラシル(A|G|C|U)のうち|シトシンの次にグアニンが現れるタイプの2塩基配列
equanimity	沈着|平静|落ちつき|あきらめ|運命の甘受
radiographer	レントゲン技師
ceiba	パンヤ
stowage	積み込み|積み込みの余地|荷積み料
subclinical	無症状性
glamor	うっとりさせる魅力|魅惑|(glamourの綴りが圧倒的)
humanize	を人間らしく(親切に･情け深く)する
fancier	(花･鳥･犬などの)愛好家|(商業的)飼育者
subjunctive	仮定法|仮定法の|叙想法の
thz	テラヘルツ
chon	100 chon equal 1 won in South Korea|100 chon equal 1 won in North Korea
underemployed	不完全雇用の|能力以下の仕事に従事して(いる)
counterintuitive	直観に反した
noiseless	making no sound; "th' inaudible and noiseless foot of time"- Shakespeare|making no sound
extensional	伸展性
goshawk	オオタカ
worshipful	信心深い|尊い|名誉ある(敬称)
sizzler	非常に暑い日
determiner	決定詞(辞)|限定詞(辞)(a|the|your|this|some|anyなど名詞の意味を限定する語)
recant	取消す
percale	パーケール織(平織りの綿織物)
hecatomb	《文》大逆殺|(古代の)雄牛100頭のいけにえ
elope	(男女が)駈落ちする
legalese	難解な法律文体
midstream	流れの中ほど
immunogenicity	免疫原性
heathland	a tract of level wasteland; uncultivated land with sandy soil and scrubby vegetation|a tract of level wasteland|uncultivated land with sandy soil and scrubby vegetation
zealander	a native or inhabitant of Zealand
musculature	(身体･器官の)筋肉組織(構成)|筋肉系
ulnar	relating to or near the ulna
incrimination	罪を負わせること(負わされること)有罪にすること|(されること)
palaeontology	古生物学
excitability	興奮性
subpopulation	(科学･機械工学用語他)部分母集団|分集団
vagus	迷走神経
diarist	日記をつける人|日誌係|日記作家
glazier	ガラス切り
yogic	of or relating to yoga; "yogic exercises"|of or relating to yoga
pharmacogenetics	the branch of genetics that studies the genetically determined variations in responses to drugs in humans or laboratory organisms
thickener	=thickening1
grimy	垢じみた
postpaid	郵便料金前払いの|郵便料金前払いで(《英》は{形}{副}ともpost-free)
sonogram	an image of a structure that is produced by ultrasonography (reflections of high-frequency sound waves); used to observe fetal growth or to study bodily organs|an image of a structure that is produced by ultrasonography (reflections of high-frequency sound waves)|used to observe fetal growth or to study bodily organs
lascivious	みだらな|淫らな
recalculation	再計算
headword	見出し語|(文法)主要語
policewoman	婦人警官
dispassionate	冷静な|公平な
haman	ハマン
deadhead	能なし|役立たず
unionization	非イオン化
stepparent	まま親
unrecoverable	incapable of being recovered or regained
charmingly	魅力的
schist	片岩(葉片状の変成岩)
doughboy	油で揚げたパン状の練り粉の塊|(第一次世界大戦時の)米軍歩兵|(doughはこね粉|パン生地)
disfavor	気に入らないこと|きらう|疎外
bathymetric	of or relating to measurements of the depths of oceans or lakes
neuroanatomy	神経解剖学
deprecation	不賛成|反対|非難
hornpipe	ホーンパイピの踊り(特に水夫が一人で踊る);その舞曲
virion	ビリオン
carrel	書庫内閲覧席
odonata	dragonflies and damselflies
corticosterone	コルチコステロン|副腎皮質で合成される副腎皮質ホルモンのうちのステロイド系ホルモン
synergistically	相乗的に
inscribe	石碑|金属板|紙|心|記憶に記す|銘記する|(署名して)贈る|名を名簿に登録する|(幾何)内接させる|株式|債券を発行する|株を売る|買う
gynecomastia	女性化乳房
diagrammatic	図表(図式)で表した|図表(図式)の
spheroid	回転楕円体(面)
sectarianism	宗派(党派)心;派閥主義
fusible	capable of being melted and fused
anarchic	無政府の
presentational	表象的
donnybrook	荒々しい口論;けんか騒ぎ|乱闘
glomerulus	糸球体(しきゅうたい)は脊椎動物の腎臓内でボーマン嚢に囲まれた毛細血管の塊|腎臓循環の細動脈から血液が流れ込み|濾過する働きをする
miniaturize	縮小化する|小型化する
endive	キクヂシャ;チコリ(サラダに用いる)
rowboat	ボート|こぎ舟
baklava	バクラバ(蜂蜜とクルミをはさんだ中近東諸国のバイの一種)
destabilization	不安定化|不安定化
unspent	(of financial resources) not spent; "unexpended funds"; "his unspent allowance"|(of financial resources) not spent
advisability	勧めるに足ること|事の当否
tendinitis	腱炎
prearrange	前準備をする
heritable	遺伝性の
automat	自動販売式食堂
cowbird	ムクドリ(モドキ科の鳥;米国産)
loamy	ローム土壌の
proclivity	傾向
haploid	半数体|体細胞の染色体数が半数になっている細胞
echocardiogram	心エコー図
triumvirate	三人連合政治･政府|三人委員会
lysander	Spartan general who defeated the Athenians in the final battle of the Peloponnesian War (died in 395 BC)
colorize	色つけ|染める|色付け|色取る|絵どる|色取|着色|色付|彩色|染めつける
bullfight	闘牛
sociopath	社会病質者
unimpeded	not slowed or prevented; "a time of unimpeded growth"; "an unimpeded sweep of meadows and hills afforded a peaceful setting"|not slowed or prevented
apolitical	政治に無関心の
chickamauga	a Confederate victory in the American Civil War (1863); Confederate forces under Braxton Bragg defeated Union forces|a Confederate victory in the American Civil War (1863)|Confederate forces under Braxton Bragg defeated Union forces
sambo	(ロシア語)サンボ|柔道とレスリングを合わせたようなロシアの格闘技
windowsill	窓の下枠|窓台(幅の広い台状で植木鉢などを置く)
diatonic	全音階の
wrasse	ベラ(海水魚の一種)
contusion	打ち身|挫傷|打撲傷
angiogram	血管造影図
wherewithal	～に要する資力wherewith|必要な資力|手段
triamcinolone	トリアムシノロン
paperboy	=newsboy
ominously	気味悪く
apiary	ミツバチ飼養場
cackle	やかましいおしゃべり|きゃっきゃっと鳴く|クワックワッ|めんどりの鳴き声
rickettsia	リケッチアRickettsia属の微生物の総称|ダニ等の節足動物を媒介とし|発疹チフスや各種リケッチア症を引き起こす|ウイルスと同様|細胞外で増殖できない
palmar	手の平(の)
demure	控えめな|まじめな|上品ぶった|modest
cephalic	頭蓋(ずがい)の
vacuous	内容の乏しい|空の|空虚な目的のない
coherency	=coherence
equilateral	等辺の
comorbid	併存
dichroism	二色性
machinegun	機関銃の|〜‘を'機械掃射する
waken	の目を覚まさせる|を奮起させる|気付かせる
gazillion	巨大な数(誇張して)|何億兆
handstand	さか立ち
teary	しょっぱい|塩気のある|悲しい|涙に濡れた|涙の|涙をたたえた
relearn	learn something again, as after having forgotten or neglected it; "After the accident, he could not walk for months and had to relearn how to walk down stairs"|learn something again, as after having forgotten or neglected it
sower	種子をまく人(機械)|(うわさ・紛争などを)まき散らす人
haft	(ナイフ・短刀などの)柄|つか
polonaise	ポロネーズ(ポーランド起源のダンス;その曲)|18世紀末の婦人用ドレス
gangway	(劇場･講堂･バス･列車などの座席間の)通路|舷門(げんもん|船の乗降口)
serfdom	農奴の身分(境遇)|農奴制
ailey	エイリー
clod	土|(土などの)塊
wallflower	壁の花(舞踏会で相手のいない女性)　(植物)ニオイアラセイトウ
uncritical	無批判な
infatuate	〈人〉‘を'夢中にする|有頂天にする《+『名人』〈人〉+『with』+『名』》
macadam	〈C〉(またmacadam road)(砕石を敷いた)マカダム道路|〈U〉その砕石
tollway	有料道路
humourous	可笑しい|面白可笑しい|おかしい|滑稽|ユーモラス|面白おかしい|面白い
winnow	ふるいにかける|精査する
cygnet	白鳥のひな
rhythmically	リズミカルに
tonsil	扁桃腺
demigod	半神半人
riotous	暴動を起こす
silico	in silico(イン・シリコ)|in vivoやin vitroなどから派生した用語で|シリコン内での意味から「コンピュータを用いて」の意|バイオインフォマティクスなどで頻繁に見られる
enfold	(〜で)〜‘を'くるむ|包む《+『名』+『with』+『名』》|(〜に)〜‘を'包む《+『名』+『in』+『名』》|〜‘を'抱く|抱きしめる|〜‘を'畳む
anticholinergic	抗コリン
embitter	〈人〉‘に'つらい思いをさせる|‘を'悲しませる
unleavened	パン種を入れない|《比喩的に》新たな影響を受けていない;改善されない
nucleolar	核小体の|核小体
stockade	防御柵で囲いをする|をさくで囲う|防御柵
determinable	決定できる
clinker	〈U〉〈C〉硬質れんが|〈U〉〈C〉(溶鉱炉の中の)金くそ|(セメントのもとになる)焼塊|〈C〉《俗》失敗作
strawman	わら人形|わら人形|案山子|かかし|痩せっぽち
biphasic	二相性の
colorist	カラリスト|彩色者
downriver	流れを下って|下流に向かって|下流に|流れに沿って
penman	字のうまい人|書く人;著者|作家
microsystem	マイクロシステム
declassification	〈書類などを〉機密情報のリストから落とすこと，機密指定から解くこと
freepost	配達された郵便物料金をその会社が支払うという制度
henchman	信頼できる部下|子分|共犯者
basilisk	バシリカ|蛇・トカゲに以た伝説上の怪物;その息や眼光で人を殺したといわれる|イグアナ科Basiliscus属のトカゲの総称;熱帯アメリカ産
popularize	普及する
balderdash	猥褻な言葉|戯言|ごたまぜ酒
fearlessly	without fear; "fearlessly, he led the troops into combat"|without fear
lavalier	jeweled pendant worn on a chain around the neck
ajar	半開きの|ドアが半開きの
coalescence	合体|合同|(骨が)くっつくこと
untrustworthy	信用できない
copperplate	〈C〉〈U〉銅版|〈C〉銅版刷り
moonwalk	月面歩行
pku	a genetic disorder of metabolism; lack of the enzyme needed to turn phenylalanine into tyrosine results in an accumulation of phenylalanine in the body fluids which causes various degrees of mental deficiency|a genetic disorder of metabolism|lack of the enzyme needed to turn phenylalanine into tyrosine results in an accumulation of phenylalanine in the body fluids which causes various degrees of mental deficiency
unabashedly	恥ずかしがらずに
myoglobin	ミオグロビン
lanthanum	ランタン(希土金属元素;化学記号は『La』)
stocky	ずんぐりした
octroi	a tax on various goods brought into a town
elastin	エラスチン
stander	an organism (person or animal) that stands; "a crowd of sitters and standers"|an organism (person or animal) that stands
strenuously	精力的に
wildness	野生|荒廃|乱暴
synergism	神人協力説(回心には人間の意思と聖霊が協力し合うとする説)|(薬物などの)共力作用|相乗作用
doorstop	戸止め|戸当たり金具
ignitor	ライト|電灯|火切り|ライタ|とぼし|ともし火|火鑽り|点火装置|ライター|点火器
laxity	緩み
deathly	死人のような|致死の|致命的な|(詩)死の
timesaving	(方法・方策などが)時間節約の
chickweed	ハコベ(白い小さな花の咲くナデシコ科の低木)
fairyland	おとぎの国
paraplegic	下半身不随
wog	《禁句》(特に黒色人種の)外国人|異人;くろんぼ
vitis	ブドウ科植物の属名
reinterpret	interpret from a different viewpoint
industrially	産業上|工業上
cathouse	浮世茶屋|亡八|忘八|置き屋|妓楼|倡楼|娼家|揚げ屋|青楼|曖昧宿
intervertebral	椎間
noncompetitive	非競合的
brainless	頭の悪い|脳のない
annihilator	a total destroyer
enkephalin	エンケファリン
jarrah	マルバユーカリノキ|マホガニーゴムノキ|オーストラリア西部産の木目の美しい硬い木|アボリジニ語に由来
caduceus	(ギリシア神話の)ヘルメス(Hermes)のつえ(2匹のヘビが往きついて頂上に双翼がある;平和と医術の象徴とされる)
cayuse	(米西部で)インディアンの小馬
constrictor	括役筋・周縮筋|獲物を締め殺す大蛇(ボアなと)
exonerate	免除する|の容疑を晴らす|解放する
immunochemistry	免疫化学
decoction	煎じ薬
coeducational	男女共学[制]の
ocelot	オセロット|ヒョウネコ
dramatization	脚色
fount	泉|源泉
ambidextrous	両手利きの|非常に器用な|多芸多才な|二枚舌の|ずるい
poacher	密猟者|侵入者
invisibly	目に見えないように|目につかないほどに
covariate	共変量
anser	typical geese
himmler	ヒムラー
bicyclist	自転車に乗る人|競輪選手
certifiable	証明できる|認定できる|保証できる
adjunctive	付属的な
payola	(レコードなどを宣伝してもらうように)ディスクジョッキーに払う謝礼金|わいろ
washbasin	=washbowl
shopaholic	a compulsive shopper; "shopaholics can never resist a bargain"|a compulsive shopper
ontogeny	(生物体の組織における)個体発生
blustery	天候の荒れた
courtier	機嫌取りの人
vaporization	気化
nanogram	ナノグラム
impetuous	猛烈な|性急な|激しい|衝動的な
paroxysmal	発作性
dopant	電磁効果を上げるため半導体に加える少量の不純物
uncaring	無分別|心無い|無思慮|心ない
ambergris	リュウゼン香(マッコウクジラから得られる香料)
sanatorium	療養所|保養地
nosh	(主に米国)間食|間食する|(主に英国)(食べる|飲む)
clearness	明白さ|明快さ|明確さ|透明
proration	the proportional limitation of production or distribution of something (e.g. crude oil or natural gas) to some fractional part of the total capacity of each producer
toadstool	(特に)毒きのこ
hubbub	騒音
unchangeable	変わらない|不変の;変えられない
choroid	脈絡膜|眼球壁の中間層の薄い組織|強膜(眼球の外側の層)と網膜(眼球内部の後方の神経組織層)の間にある|血管が通り|眼球への酸素と栄養の運搬を行う
plonk	どすんと落ちること
prox	in or of the next month after the present; "scheduled for the 6th prox"|in or of the next month after the present
footlocker	(身の回り品を入れておく)小型トランク
magisterial	行政長官の|治安判事の|厳然とした|権威のある
droopy	うなだれた|意気消沈の|疲れ果てた|垂れ下がった
bulla	小疱|水疱
helminth	蠕虫
postoperatively	after the operation; "remove postoperatively"|after the operation
privation	欠乏|不自由|喪失
meteoric	流星の(ような)|一時的にはなばなしい
rheological	流体力学的
arithmetical	計算力の|＜Arithmetic|(一般的な計算力|読み書きそろばんの類で|科目ではない)|Math|Algebra|Geometry図形|Calculus微積分が科目名
royally	王らしく|堂々と|壮麗に|《話》すばらしく|りっぱに
dative	(文法)与格(間接目的語など)
cheever	チーバー
acclamation	喝采
bleomycin	ブレオマイシン|グリコペプチド系抗生物質|抗癌剤などに使用される
swordplay	剣術(fencing)
floriculture	草花栽培[法]|花作り
minocycline	ミノサイクリン
eyewash	目薬|洗眼液
syllogism	三段論法(大前提|小前提|および結論から成る推論)
silverfish	紙魚
dishonorable	下劣な
hayride	干し草を積んだ馬車に乗って出かけるピクニック
guzzler	大酒飲み|大食漢
frosting	アイシング
heterogenous	ヘテロジニアス|ヘテロジーニアス
impregnation	妊娠|受精|浸透
anthurium	ベニウチワ|アンスリウム
printing	印刷する
silicosis	珪(けい)肺症|珪粉症(石工などがケイ酸の微粒子を吸い込むことによって起こる肺の病気)
retrievable	取り戻せる|回復できる;償い得る
skanky	極めて不快な|醜い
maltose	麦芽糖
chromatogram	クロマトグラム
immolation	いけにえ(犠牲)にすること
broadsword	《古》《文》(突き刺すのでなく切るための)広刃の刀|だんびら
blaxploitation	the exploitation of black people (especially with regard to stereotyped roles in movies)
inconsistently	一貫性なく
chromo	多色石版刷りの絵
blankly	茫然と|ぽかんとして|きっぱりと
chairlift	リフト
tinkle	ちりんちりんと鳴る|チリンチリン|鈴の音|(幼児語)おしっこをすること
chantry	(冥福を祈ってもらうための教会への)寄進|寄進によって建てられた礼拝堂
brinton	United States anthropologist who was the first to attempt a systematic classification of Native American languages (1837-1899)
spiritualize	give a spiritual meaning to; read in a spiritual sense|give a spiritual meaning to|read in a spiritual sense|elevate or idealize, in allusion to Christ's transfiguration|purify from the corrupting influences of the world; "During his stay at the ashram he was spiritualized"|purify from the corrupting influences of the world
cloudless	暗影のない|雲のない|晴れ渡った
fondant	フォンダン(口に入れるとすぐ溶けるキャンデーの一種)
atheneum	アシニーアム|アテネウム|学術振興会|図書館
marksmanship	射撃技量|射撃術|弓術
displease	のきげんを損じる|不快にする
vestige	痕跡|跡|ほんのわずかの跡|(まれ)足跡
seedless	種なしの|種のない|無核の
wino	(wάɪnoʊ)|ワイン中毒者|飲んだくれ|ブドウ摘みの働き手
arteritis	動脈炎
cheerfulness	快活|上機嫌
egoism	利己主義;自分勝手|うぬぼれ
transshipment	(乗客・貨物を)他の乗り物に移すこと|(〜の)積み換え《+of+名》
rimbaud	ランボオ
fatherless	having no living father|not having a known or legally responsible father
acclimation	順化
seer	見る人|千里眼の人|予言者
cretan	a native or inhabitant of Crete
capsular	カプセルの|カプセルに入った
evangelicalism	福音主義(儀式や教会よりも罪の自覚とキリストによる神の救いを強調する)
pageantry	壮観
snowplow	プルークボーゲン|除雪車
verboten	(法律などにより)禁じられた
jacaranda	ジャカランダ(熱帯アメリカ産の樹木)
phraseology	ことばづかい|熟語集|表現|専門語
chessboard	チェス盤
zedong	毛沢東
morass	沼地|低湿地|難局|泥沼
deuteron	重陽子(重水素の原子核)
kinesthetic	of or relating to kinesthesis
ewer	広口の水差し
tailback	渋滞している車の列
agha	title for a civil or military leader (especially in Turkey)
pinkie	小指|小さい|安物の(赤)ワイン|白人|アルコール常用者
bine	蔓
tasse	one of two pieces of armor plate hanging from the fauld to protect the upper thighs
encumber	妨げる|の足手まといになる|苦しめる
graviton	重力子
warble	(小鳥が)声をふるわせてさえずる|美しい声で歌う|ヨーデルを歌う|さえずり|(川など)さらさらと音を立てて流れる|ウシバエの幼虫(による家畜の背の腫れもの)
membranous	膜の;皮膜に似ている
ammeter	電流計
nonfederal	非連邦(の)
hobgoblin	悪鬼|鬼|幽霊
undercoat	(動物の長い毛の下の短い)下毛|(仕上げ塗り前の)下塗り
tuberous	こぶのある|結節(状)の|(植物)塊茎(状)の|塊茎のある(a tuberous root|サツマイモなどの塊根)
calligraphic	書道の|能筆の
divorcee	離婚者
bandleader	バンドリーダー
prayerful	祈りを込めた|信心深い
synthesise	合成
undercarriage	(自動車などの)車台|(飛行機の)着陸用装置(車輪)
perspex	a transparent thermoplastic acrylic resin
tref	not conforming to dietary laws
unwary	不注意な|軽率な
cubit	腕尺(古代の尺度で|ひじから中指の先まどの長さ;45‐56センチ)
groundless	根拠(理由)のない
tubercle	結節|結核(結節)|小塊茎
amelioration	改良|改善|向上
repetitious	(けなして)繰り返しの多い|くどい
hairbrush	ヘアブラシ|毛製ブラシ
sulfonate	スルホン酸塩
amplicon	(生化学) アンプリコン|増幅産物(amplify増やす)
unbind	のバンドを外す|束縛を解く|ほどく|釈放する
colostomy	結腸人工肛門造設術
novena	(カトリックで)9日間の祈り(修業)
extractable	capable of being extracted
enthrone	〜‘を'王位につかせる|〈人〉‘を'あがめる
mycelium	菌糸体
vinca	ビンカ
penetrator	ペネトレーター
hybridize	雑種を作る|かけ合わせる
hyperfine	extremely fine or thin, as in a spectral line split into two or more components; "hyperfine structure"|extremely fine or thin, as in a spectral line split into two or more components
alacrity	活発|敏活|敏活さ|機敏さ|積極性|乗り気|機敏
interconnectedness	相互連結|相互接続
stanchion	スタンチョン|仕切り棒|支柱|支柱をする|スタンチョンにつなぐ|支柱を設ける
drawbridge	はね橋|(城の堀の)つり上げ橋
locative	the semantic role of the noun phrase that designates the place of the state or action denoted by the verb
anoxia	無酸素症
tureen	ふた付きの深皿
hypodermic	皮下の
percolate	ろ過する|浸透する
nonequilibrium	非平衡性|非平衡
waxwing	レンジャク(連雀)属の鳥
epicentre	震源地
symbiont	共生生物
isolationist	孤立主義者
wirehaired	(特に犬が)針金のような堅い毛の
uncivil	無礼な|不作法な
dehydratase	脱水酵素
nondescript	これといった特徴のない|目立たない
azathioprine	アザチオプリン
howsoever	たとえ〜でも
nystagmus	involuntary movements of the eyeballs; its presence or absence is used to diagnose a variety of neurological and visual disorders|involuntary movements of the eyeballs|its presence or absence is used to diagnose a variety of neurological and visual disorders
drogue	海錨(びょう)(船首を風の方向に保つため海中に投じるカンバスの袋)|(飛行機が引く射撃練習用の)吹き流し
niobrara	ニオブレラ川
unsympathetic	思いやりがない
retread	新しい踏み面|再生タイヤ|返り咲いた人|再召集兵|古い物を改作する人|蒸返し|時代遅れな奴|に踏み面を付け直す
nationhood	独立国家
condescension	恩着せがましい態度|(目下に対する)謙遜|気さくさ
cellulitis	an inflammation of body tissue (especially that below the skin) characterized by fever and swelling and redness and pain
calvados	カルバドス
otherness	別個
haver	くだらない話|戯言|持っている人|所有者|野生のオート麦|くだらないおしゃべりをする|ぐずぐずする|戯言を言う|躊躇する
skipjack	カツオ|コメツキムシ
denotation	(語句の)意味|辞書的学習法|(医療現場等であいまいな伝達を避けるため|難解でも意味が明瞭な専門語を使うこと|反|conotation)
tiber	タイバー川|テベレ川
uncertified	lacking requisite official documentation or endorsement
interdict	妨げる|禁止する|止める|阻止する
gobbler	雄の七面鳥
psychotherapeutic	of or relating to or practicing psychotherapy; "psychotherapeutic sessions"|of or relating to or practicing psychotherapy
skilfully	うまく|巧みに|熟練して|上手に
vaporize	揮発する|気化する|気化させる|蒸気化する|蒸発する|させる|蒸発気化する|蒸発させる