cometary	of or relating to or resembling a comet
cunningly	狡猾|陰険
wristlet	(装飾用)腕輪
linguine	リングイーネ
stoma	気孔(葉・茎の表皮にあって気体の出入りに役立つ小さな穴)
nonuniform	不均質
freeloader	(米語)人にたかる人|居候
exeunt	退場する
privatise	私用
turbid	(液体が)濁った|不透明な|(煙・雲などが)濃い・厚い|(感情・思考などが)混乱した
iskcon	a religious sect founded in the United States in 1966; based on Vedic scriptures; groups engage in joyful chanting of `Hare Krishna' and other mantras based on the name of the Hindu god Krishna; devotees usually wear saffron robes and practice vegetarianism and celibacy|a religious sect founded in the United States in 1966|based on Vedic scriptures|groups engage in joyful chanting of `Hare Krishna' and other mantras based on the name of the Hindu god Krishna|devotees usually wear saffron robes and practice vegetarianism and celibacy
sifter	調査官|ふるい|ふりかけ器
amyl	アミル
televise	テレビで放送(受像)する
righty	右利き(の人)|(野球)右腕投手
teratogenic	催奇性|催奇形性
constitutionalism	立憲立義
compressibility	圧縮性|圧搾できること
donee	受益者|受贈者
cryptogram	暗号;〈C〉暗号文
quackery	いんちき療法
villainy	極悪非道|悪事|悪行
irk	うんざりさせる|嫌にならせる
semifinalist	one of four competitors remaining in a tournament by elimination
legroom	(自動車などの座席で)足を楽にのばせる空間
ebonite	エボナイト
systemically	全身的に
habituation	慣らす(慣れる)こと
unlearn	〈学んだこと〉‘を'忘れる;〈考え・習慣など〉‘を'捨て去る
doodlebug	《米》アリ地獄|《英話》V1号爆弾
vaccinium	スノキ属(酢の木属)|ツツジ科|常緑または落葉の低木|ブルーベリー|クランベリー|コケモモ|ハックルベリーなど|酸性土壌を好む
perfectionism	完全主義(道徳的・精神的に人間は完全になりうるという考え)・(何事も完全でないと満足できない)完全主義
methodism	the religious beliefs and practices of Methodists characterized by concern with social welfare and public morals
cerium	セリウム(金属元素;化学記号はCe)
curler	カーラー|カーリングの競技者|カーリングをする人|カールクリップ|毛髪を巻く人
fiberoptic	of or relating to fiber optics
amun	アーメン
fumigant	燻蒸(くんじょう)剤(消毒・殺虫剤用の化合物)
tealeaf	茶の葉;茶がら|《英俗》泥棒
preparative	調製用
interline	(語句などを)〈本の行間〉‘に'書きこむ《+『名』+『with』+『名』》
startlingly	驚くほどに
alliteration	頭韻
erosive	浸食性の
unrefined	not refined or processed; "unrefined ore"; "crude oil"|not refined or processed|(used of persons and their behavior) not refined; uncouth; "how can a refined girl be drawn to such an unrefined man?"|(used of persons and their behavior) not refined|uncouth
inimical	敵意のある|反目して|不和な|不利で|有害な
thyroiditis	甲状腺炎
imperious	横柄な|差し迫って|重要な
adjudicative	concerned with adjudicating
slaver	よだれを流す|奴隷売買者
egocentric	自己中心の|利己的な|個人中心の
histrionic	劇場の|俳優の|演劇上の|演劇めいた|芝居じみた
unpaired	対になっていない
monetization	establishing something (e.g. gold or silver) as the legal tender of a country
nandrolone	ナンドロロン
asphyxia	(血液中の酸素不足のために起こる)失神状態|窒息
hebridean	of or relating to the Hebrides
oversubscribe	〈公債・寄付など〉‘を'募集額以上に申し込む
heterosexuality	異性愛者(同性愛者に対し)|正常性癖|異性愛的な人
legate	(特にローマ教皇の)使節
catecholamine	カテコールアミン|多くの神経伝達物質等(アドレナリン|ドーパミン他)及び関連薬物の基本骨格になっている|カテコラミンとも呼ばれる
outbid	により高い値をつける
flutist	フルート奏者
structuralism	構造主義
vexation	〈U〉いらだたしさ|腹立ち|悩み|〈C〉《しばしば複数形で》悩みの種|しゃくの種
herniation	ヘルニア|脱腸
immobility	不動(性)|固定|静止
restaurateur	料理屋の主人
broodmare	a female horse used for breeding
scrimshaw	細工|細工物|手工品を作る
nonexempt	(of goods or funds) subject to taxation; "taxable income"; "nonexempt property"|(of goods or funds) subject to taxation|(of persons) not exempt from an obligation or liability
jetliner	ジェット(定期)旅客機
raper	強姦者
extraterritorial	治外法権の|治外法権地域の
grappler	相撲取り|レスラー|鉤縄
oceanographer	海洋学者
whoopee	興奮の叫び声|ばか騒ぎ(をする)
dentate	(植物・動物が)歯のある|歯状突起のある
toroid	トロイド|トーラス
disrepute	悪評|汚名
implacable	無情な|なだめがたい|無慈悲な|和解しにくい|執念深い|不倶戴天の
uninspiring	depressing to the spirit; "a villa of uninspiring design"|depressing to the spirit
degradable	(化学的に)分解できる
halitosis	口臭
contortionist	(体を自由自在に曲げる)軽わざ師|曲芸師
cybercafe	インターネットカフェ
spoonbill	ヘラサギ(長く平たいくちばしの渉禽(しょうきん)類の鳥)
toady	ごますり(人)|ごまをする
pliant	曲げやすい
magnetron	磁電管
reappearance	再現|再発
backbeat	a loud steady beat
alluvium	沖積層|沖積土(河川によって運ばれてきた地層)
crabapple	野生のりんご
stargaze	星を観測する|空想にふける|夢想する
catabolic	(生物学)異化作用の(生物が外界から摂取した物質を化学的に分解し|より簡単な物質に変える反応)|(反)anabolic
emaciate	〜‘を'やせ衰えさせる|やつれさせる
wiggler	揺れ動く人(物)|うねりくねって進むもの|ぼうふら
millimetre	粍|ｍｍ|ミリメータ|ミリ|mm|ミリメートル
manse	館|大邸宅
picador	機知に富む人|巧みな論客
catechesis	oral religious instruction (as before baptism or confirmation)
plasterboard	プラスターボード(石膏(せっこう)を芯(しん)にした板紙;壁・天井用)
endearment	愛情を示す行為|親愛|愛情(表現)
labial	唇音|唇の|陰唇の
quinidine	キニジン
pock	あばた
unknowing	知らない|気づかない
blithely	朗かな|快活な|陽気な|きさくな|のんきな
frameshift	フレームシフト(遺伝子を読み込む際のズレ|読み込み不能を招く)
positivist	実証主義者|実証主義者
governorship	governorの職(地位・任期)
fashionably	in a fashionable manner; "his voice had no trace of the drawl that you would expect to find in a fashionably dressed young man"|in a fashionable manner
coeliac	of or in or belonging to the cavity of the abdomen
vasculature	血管系
virginal	処女の|処女にふさわしい;汚れのない|純潔な
phenomenally	並外れて
hyssop	ヒソップ|ヤナギハッカ(芳香のあるハッカ属の草)|ヒソプ(聖書で|この小枝を水に浸して清めの儀式に用いた)
reputedly	評判では
schlock	くだらないもの|低俗なもの|安物|くだらない|低俗な
midazolam	ミダゾラム
homebuilder	someone who builds houses as a business
billfish	サンマ
hoagy	爆撃機
bicameral	(議会が)二院制の
chapeau	帽子(hat)
kickapoo	a member of the Algonquian people formerly inhabiting southern Wisconsin and northern Illinois|the Algonquian language of the Kickapoo
obnoxiously	in an obnoxious manner; "he said so in one of his more offensively intellectually arrogant sentences"|in an obnoxious manner
micronized	微粉化
fieldstone	自然石
megaton	100万トン|メガトン(核爆弾の爆発力を測るときに使う単位;TNT火薬100万トンに相当する)
motorcade	自動車行列
lobotomy	前頭葉切除
immobilize	の流通を止める|固定する|固定資本化する|不動にする
maraud	襲撃(する)
cynically	皮肉なことに
estrangement	仲たがい|離間|疎外|疎遠
bizarrely	奇妙に
incontinent	自制心のない|自制のできない|抑えきれない|失禁の|淫乱な
serendipitous	偶然
interurban	都市間の
sulcus	溝
metabolize	新陳代謝させる
nonconformist	プロテスタント|国教を信奉しない人|体制などに従わない人|非国教徒|非協調の
carotenoid	カロテノイド|カロチノイド
tattersall	タッターソール(格子じま模様の毛織物)
excommunication	破門|除名
procreate	繁殖する|産む|生ずる
florid	血色のよい|赤らんだ|桜色の|健康な|華やかな
fatalism	運命論
gazillion	巨大な数(誇張して)|何億兆
sensitize	敏感にする|に感光性を与える
mahalo	（ハワイの言葉で）ありがとう・マハロ
retread	新しい踏み面|再生タイヤ|返り咲いた人|再召集兵|古い物を改作する人|蒸返し|時代遅れな奴|に踏み面を付け直す
roquefort	French blue cheese
brawler	あばれん坊
nonunion	労働組合に加入しない|労働組合員を雇っていない
steric	立体的
directionality	指向性
durabolin	ナンドロロン
snowdrop	ユキノハナ(早春に白い花をつける草;欧州産)
hillock	小山|塚
crawly	=creepy
precariously	危なっかしそうに|不安定に|危険に|不確実で
prattle	無駄話をする|(大人が～について)子どものようにしゃべる|取るに足りない話|片言
hubcap	ホイールキャップ(和製英語)
colonialist	植民地主義者
schizoid	精神分裂症(の)
lawfulness	合法性|適法|合法
rectilinear	直線に進む|直線の|直線的な
bandeau	ヘアバンド(婦人の頭に巻き|造花などを付ける細いリボン)
physicality	物性
combinational	able to or tending to combine
invulnerable	不死身の|難攻不落の
archeologist	=archaeologist
babysit	子守
sebaceous	脂濃い|脂っ濃い|油っこい|脂ぎった|油濃い|オイリー|油っ濃い|脂っこい
diwan	a Muslim council of state|a collection of Persian or Arabic poems (usually by one author)|a Muslim council chamber or law court
vasodilation	血管拡張
sirocco	シロッコ(北アフリカから南ヨーロッパ地方に吹きつける乾燥したほこりっぽい熱風)|(一般に)うっとうしい熱風
geocentric	地球を中心とした|地球の中心から見た|天動説|(反)the heliocentric (Copernican) system(theory)
absorbable	吸収性
moult	=molt
hideously	恐ろしいほどの
mycobacterial	マイコバクテリアの
motherly	母の|母のような|優しい
antiphon	応答詩歌;(教会で)交唱(2組の聖歌隊が交互に歌う詞篇・賛美歌)
reticular	網状の
wispy	小さく束ねた|ひと握りの|ほんの少しの|か細い
borderland	国境地
gnarly	used of old persons or old trees; covered with knobs or knots; "gnarled and knotted hands"; "a knobbed stick"|used of old persons or old trees|covered with knobs or knots
propoxyphene	a mildly narcotic analgesic drug (trade name Darvon) related to methadone but less addictive
vexatious	いらだたしい
girlish	少女らしい
woolworth	ウルワース
sociobiology	社会生物学
attentiveness	配慮|気配り|考慮|配意|顧慮|心遣い|関心|留意
rhetorically	修辞
neuropsychiatry	神経精神医学
kanamycin	カナマイシン|1957年に梅澤濱夫により日本で最初に発見された抗生物質|細菌性のリボソームと反応し|毒性を発揮する|この毒性は真菌類には発揮されない
vasoactive	血管作動性の
douse	(水)を浴びせる|(火･明かり)を消す
upstanding	直立した;りっぱな体格の|(性格が)まっすぐな|りっぱな|正直な
lilium	ユリ
rhus	deciduous or evergreen shrubs and shrubby trees of temperate and subtropical North America, South Africa, eastern Asia and northeastern Australia; usually limited to nonpoisonous sumacs (see genus Toxicodendron)|deciduous or evergreen shrubs and shrubby trees of temperate and subtropical North America, South Africa, eastern Asia and northeastern Australia|usually limited to nonpoisonous sumacs (see genus Toxicodendron)
trifolium	any leguminous plant having leaves divided into three leaflets
shamefully	恥ずかしくも|不面目に
herculean	大力を必要とする|非常に困難な|《しばしばHerculean》(特に|力や勇気などの点で)ヘラクレスのような
legislatively	法的
disinterest	無関心|公平無私
pleura	ろく膜|胸膜
defoliation	落葉
rubidium	ルビジウム(金属元素;化学記号は『Rb』)
thrombolysis	血栓溶解
shisha	an oriental tobacco pipe with a long flexible tube connected to a container where the smoke is cooled by passing through water; "a bipolar world with the hookah and Turkish coffee versus hamburgers and Coca Cola"|an oriental tobacco pipe with a long flexible tube connected to a container where the smoke is cooled by passing through water
griot	グリオ
spawner	a female fish at spawning time
solvation	ソルベーション|溶媒和|溶質が電離して生じたイオンと溶媒分子が静電気力や水素結合によって結びつき|溶質が溶媒中に拡散すること
clx	being ten more than one hundred fifty
sandbag	砂袋|土のう(水害・銃撃のときの防壁用;また凶器にも用いられる)|(防御手段として)〜‘に'砂袋(土のう)を積む(置く)|〜‘を'砂袋で打ち倒す|《米話》〈人〉‘に'(〜を)強制する《+『名』〈人〉+『into』+『名』(do『ing』)》
triune	三者一体の;(体に神が)三位一体をなす
domineer	(〜に)いばりちらす|おうへいにふるまう《+『over』+『名』》
neut	(=neutron bomb)中性子爆弾
classwork	学業
tapir	バク(貘)
trackable	capable of being traced or tracked; "a traceable riverbed"; "the traceable course of an ancient wall"|capable of being traced or tracked
eosinophilic	of or relating to eosinophil
sawyer	木びき
chirality	キラリティー(chirality)は3次元の図形や物体や現象がその鏡像と重ね合わすことができない性質(例|左右の手)|キラリティがあることをキラル(chiral)という
obtrusive	押しつけ
paradigmatic	模範となる|典型的な|語形変化(表)の
uncontaminated	汚染されていない
handloom	手織機|手織りばた
wiry	やせているが筋骨たくましい|針金の|しなやかで強い
hedonist	快楽主義者
tarantella	タランテラ(2名で踊る活発なイタリウ南部の踊り);〈C〉〈U〉タランテラの曲
duffer	ばか|あほ|間抜け|愚か者|鈍い奴|(ゴルフ好きなのに)下手な人|よくダフる人
marquetry	(家具などの)はめこみ細工|象眼細工|寄せ木
jealously	油断なく
hemorrhoid	痔(通例-s複数扱い) (=piles)
millwright	水車大工
stylise	様式化
allover	(模様など)全面にわたる
presidium	a permanent executive committee in socialist countries that has all the powers of some larger legislative body and that acts for it when it is not in session
tapis	a heavy textile with a woven design; used for curtains and upholstery|a heavy textile with a woven design|used for curtains and upholstery
sinless	罪のない|潔白な
deary	かわいい人
astrophysicist	天体物理学者
nobly	貴族らしく|気高く|立派に|堂々と
deka	decaの異形
absolutism	専制政治
disambiguate	state unambiguously or remove ambiguities from; "Can you disambiguate this statement?"|state unambiguously or remove ambiguities from
astrometry	暦数
anaphylactic	アナフィラキシー(性)の|過敏症(性)の
bunko	いかさま|ぺてん|かたり
flirtatious	浮気(好き)な
parathion	パラチオン(殺虫剤として用いる)
infuriate	激怒させる
antiarrhythmic	抗不整脈薬
furore	ブーム|カルト|熱狂
delimit	範囲(境界)を定める
glower	にらむ|苦い顔をする|(His glower made me shiver|彼ににらみつけられて私はぞっとした)
sharer	共にする人|共有者|参加者|配給者|分配者
perihelion	《通例単数形で》近日点(太陽系の天体が太陽に最も近づく位置)
cauda	any taillike structure
wakefulness	寝ずの番|眠らないでいること
fishtail	(車の後部などが)左右に横滑りする|(飛行機が)尻振り滑空する
militarization	動員|軍事化
skint	文なしの|すかんぴんの・= flat-ass broke
luteal	黄体(卵巣中の組織)の
tumorigenesis	腫瘍形成
contrition	痛恨
spermatogenesis	精子形成
snakeskin	ヘビの皮|ヘビ革
unsuspected	疑われていない|思いもよらない
crevasse	氷河の割れ目
splicer	スプライサー(フィルム・録音テープなどの接合器)
pharmacopoeia	薬局方|調剤書|薬物類
pollinate	に受粉する
lansa	East Indian tart yellow berrylike fruit
rearward	後方の|後方へ(に)
capriccio	狂想曲
peaceably	平和に;安らかに
taxidermist	剥製師
leucocyte	白血球
twinge	苦痛|ずきんとする痛み|激痛|刺すような痛み
toynbee	トインビー
baycol	an oral drug (trade name Baycol) to reduce blood cholesterol levels
candlewick	ろうそくの芯(しん)
tuckahoe	perennial herb of the eastern United States having arrowhead-shaped leaves and an elongate pointed spathe and green berries
groover	かっこいい人|溝を付ける道具［人］、すてきな人
legalise	法律化|合法化|合法化する
breathlessly	息を切らして
crasher	クラッシャー
sparsity	希薄
gild	金めっきする|粉飾する|に金をかぶせる|金色に塗る
naturalness	the quality of being natural or based on natural principles; "he accepted the naturalness of death"; "the spontaneous naturalness of his manner"|the quality of being natural or based on natural principles
distractor	気を散らすもの|誤った選択肢.
enteritis	腸炎
tusker	(きばのある)象
unhook	かぎからはずす|のホックをはずす
tippy	(used of boats) inclined to heel over easily under sail
irritably	怒りやすく|過敏に
oldtimer	古兵|老練家|老巧|ベテラン|練れ者|ヴェテラン|ベデラン|古強者|古豪|古参|古狸
peekaboo	いないいないバー
gorgeously	華やかに
noonday	=noon 1|正午の|正午(真昼)に起こる
courteously	礼儀正しく|うやうやしく|丁重に
kumquat	キンカン(植物名)
sinuous	しなやかな|曲がりくねった
trichloroethane	トリクロロエタン
paymaster	ボス|会計課長|部長|給与支払係|雇用者|支払主任|主計官|親方
coleus	サヤバナ(はなやかな色の葉と青い花の観賞用植物)
triode	三極真空管
repot	〈植山〉‘を'他の植木鉢に植えかえる
meekly	おとなしく;いくじなく
anthropometric	人体計測
disenchantment	魔法を解くこと;迷い(夢)を覚ますこと
transposable	転位可能な
saccharin	サッカリン
wilder	惑わせる|道に迷わせる
overtone	付帯的な意味|(思想･言葉など)含み|含蓄|(音楽)倍音
golgotha	a hill near Jerusalem where Jesus was crucified
effendi	エフェンディ(トルコなどで用いた男性の敬称)
insubstantial	実体のない
hurtle	激しくぶつかる|突進する|音をたてて行く|急速に進行する|衝突する
tuberculous	結核（性）の・ゲッカコウ(月下香)(ヒガンバナ科の球根植物)
homburg	ホンブルグ帽|狭いつばが両側でややそり上がり山の中央がへこんだ男性用のフェルト帽
jammy	ジャムのような|(ジャムで)べたつく|混乱した|ラッキーな|儲かる|愉快な|容易な
persuader	someone who tries to persuade or induce or lead on
handshaking	握手|ハンドシェーク
olio	〈U〉ごった煮|〈C〉ごた混ぜの物|(寄せ集めの)文集|詩文選;メドレー曲集
gruelling	苦しい|難しい|きつい|ヘビー|辛い|ハード|しんどい|つらい|ヘビイ|困難
wrasse	ベラ(海水魚の一種)
glia	神経膠
fuze	=fuse2
serous	漿液(しょうえき)状の|漿液を含む|水のような|希薄な
gravimetric	重量測定の
galvanize	電気治療する|急に刺激する|亜鉛メッキする
straightforwardly	素直に
crumple	しわくちゃにする|くちゃくちゃにする
rhombus	ひし形|斜方六面体
supercede	入代わる|とって代わる|取って代わる|入れ替る|入れ代る|入代る|入れ代わる|入替わる|取ってかわる|入れ替わる
seafarer	船乗り
whelp	(犬・オオカミ・猫・ライオンなどの動物の)子供|《軽べつして》がき|小僧|〈動物が〉子を生む
refectory	(修道院･大学などの)食堂
hoth	ホス
verbalize	話す|発語|申述べる|申し上げる|おっしゃる|陳じる|物いう|仰っしゃる|仰る|弁ずる|言い出す|おっしゃる|吐く|話す|謂う|発言|言い現す|言い表す|云う|言う|洩らす|話す
unaccustomed	に不慣れの|異常な|慣れない
unbelieving	信じない;懐疑的な|信仰心のない
luminary	(知的)指導者|有名人|(月･太陽など)発光体
congressionally	議会
purser	事務長（事務だけでなく|乗客サービスも担当する乗務員）
furtive	ひそかな|こそこそする|内密の|ごまかしの|うさんくさい
mutuality	相互関係|相関;相互依存
fugly	(slang) extremely ugly|extremely ugly
durian	ドリアン(果物)　(古代ギリシャのドリス(人)はDorian)
premenopausal	閉経前の
enchantress	魔女|魅力的な女
virologic	ウイルス学
disenfranchisement	特権の剥奪
gnocchi	ナキ(小麦粉・じゃがいも・チーズ・卵を蒸しだんごにしたイタリア料理)
pruritus	掻痒(そうよう|=かゆみ)
proscribe	追放|禁止する|追放する
wonderment	〈U〉不思議|驚き|〈C〉不思議な物
stagecraft	skill in writing or staging plays
morbidly	病的
palfrey	乗用馬
cryptanalysis	暗号学
densitometry	濃度測定
flowerpot	植木鉢
jawbone	顎骨|(特に)下顎骨
jejunum	空腸(小腸の一部で十二指腸に続く小腸の前半約5分の2を言う)
mealy	(míːli)(mealier|-iest)粉状の|粉(こ)を吹いた(mealy potatoes粉吹きジャガイモ)|食事を含んでいるか食事でできている(containing meal or made of meal)
vitiate	価値を低下させる|そこなう|不純にする|腐敗させる
zilch	(俗)ゼロ|無
latitudinal	《名詞の前にのみ用いて》緯度の
incinerate	焼いて灰にする|焼却する
rumpus	[がやがやした]騒ぎ|騒音
leptospirosis	レプトスピラ症
dereliction	〈U〉〈C〉(職務)怠慢|〈U〉放棄|遺棄
bollard	《英》(街路中央にある横断着用)保護柱|繋船(けいせん)柱|(街路にある車通行禁止を示す)柱
detent	爪
disfigurement	美観を損なうこと|美観を傷つけるもの
rydberg	リュードベリ定数
airfreight	空輸貨物|貨物空輸[料金]
signaler	someone who communicates by signals
exactness	正確|厳密
suckle	乳を飲む|授乳する|を育てる
monotheistic	believing that there is only one god
diversionary	注意をほかにそらす|気晴らしの|(軍事行動が)陽動の|牽(けん)制の
silurian	シルル紀
skirmisher	小ぜり合い(小論争)をする人;(軍隊で)散兵|前衛
evacuee	避難者|疎開者
offprint	(雑誌などの)抜き刷り
biochip	バイオチップ
spasmodic	けいれん性の|発作的な|断続的の
shariah	シャリヤ|シャリア|イスラム法|イスラム聖法|シャリーア
augmentative	increasing or having the power to increase especially in size or amount or degree; "`up' is an augmentative word in `hurry up'"|increasing or having the power to increase especially in size or amount or degree|intensifying by augmentation and enhancement
quietude	静けさ|平穏|落ち着き
saunter	ぶらつく|のんびり散歩する|ぶらつくこと|逍遥
roundly	丸く|円形に|勢いよく|活発に|激しく|十分に|完全に
lowlife	碌でなし|与太|惑い者|まどい者
advertorial	an advertisement that is written and presented in the style of an editorial or journalistic report
antiproton	反陽子
dermabrasion	removal of scars or tattoos by anesthetizing the skin surface and then sanding or scraping off some of the outer skin layer
camembert	カメンベール
atrioventricular	relating to or affecting the atria and ventricles of the heart; "atrioventricular disease"|relating to or affecting the atria and ventricles of the heart
tearoom	ティールーム|喫茶店
winless	having no wins; "the team had a very disappointing winless season"|having no wins
mollusk	軟体動物
wildfowl	野禽|猟鳥
constipate	〈人〉'を'便秘させる
unilateralism	単独主義
reseau	レゾー|レゾー
untroubled	悠々自適|セキュア|安全|心丈夫|安泰|大丈夫|安心|無事|確か|悠々自適
divertimento	ディベルティメント|嬉(き)遊曲(数楽章から成る軽快な器楽合奏曲)
sheepishly	in a sheepish manner; "sheepishly he handed her back the money"|in a sheepish manner
adverbial	副詞の|副詞的な
shikoku	the smallest of the four main islands of Japan; to the south of Honshu and to the east of Kyushu; separated from Honshu by the Inland Sea; forested and mountainous|the smallest of the four main islands of Japan|to the south of Honshu and to the east of Kyushu|separated from Honshu by the Inland Sea|forested and mountainous
pawnshop	質屋
pharyngitis	咽頭(いんとう)炎
whiteface	ヘレフォード|ヘレフォード種|ヘレフォード種の牛
warily	用心して|油断なく
aflame	燃えて
phonetically	音声学
aright	《文》正しく|まちがいなく
dolt	まぬけ|とんま
googly	a cricket ball bowled as if to break one way that actually breaks in the opposite way
resect	surgically remove a part of a structure or an organ
mestizo	(スペイン語)メスティーソ|混血の人
studious	勉強好きな|熱心な|勉強する
eyck	アイク
patellar	near or relating to the patella or kneecap; "patellar tendon"|near or relating to the patella or kneecap
fineness	見事さ|美しさ|立派さ|上品さ|優良|細かさ|繊細|精密さ|鋭敏さ|公差|純度
collectivism	集産主義(体制)
immunocytochemistry	免疫細胞化学
pharisee	パリサイ|パリサイ
schadenfreude	シャーデンフロイデ(独|Schadenfreude)|他者の不幸|失敗を見た時の快感|ドイツ語で「恥知らずの喜び」|「様を見ろ」や「隣(他人)の不幸は蜜の味」の意
nortriptyline	ノルトリプチリン
boatload	最大積載量
grammarian	文法学者
mussorgsky	モデスト・ムソルグスキー
existentialist	実存主義(者)
piperazine	ピペラジン
amicably	友好的に|平和に
ecologic	生態学的
penalise	処罰|成敗|罰する|懲らす|罪する|懲罰|誅罰|仕置|処分|仕置き
schmooze	馬鹿話|ばか話|気楽な話|楽しく会話をする
logjam	行き詰まり|渋滞|流れに停滞した丸太群
straitjacket	精神病者・囚人などに着せる丈夫な拘束服
haemophilia	血友病
clumber	a thickset spaniel with longish silky hair
nihilistic	虚無的な
minicomputer	ミニコン|ミニコンピューター
lawyering	弁護士業
gleeful	大喜びの|上機嫌の|楽しい|うれしい
sprightly	元気な|快活な|活発(陽気)な|活発(陽気)に
grindstone	回転砥石
roofer	a craftsman who lays or repairs roofs
quinone	キノン
sacredness	神聖
reword	〜‘を'言い直す|書き替える
intermarriage	(血族)結婚
demodulation	復調
haply	多分
misclassification	誤判別
enrage	ひどく怒らせる
trounce	(人を)うんとなぐる|こらしめる|こきおろす|けなす
tinder	火口(昔 点火に用いた燃えやすい物質)
backfield	(アメリカンフットボールで)後衛
gadgetry	(家庭用などの)小道具･機械類|(器具類の)がらくた
omniscience	全知|全知の神|博識
shakily	震えて|よろよろして
streambed	a channel occupied (or formerly occupied) by a stream
leaden	重い|鉛色の
pizzicato	ピチカートの(弦楽器の弦を指ではじく奏法)|ピチカートで|ピチカートで演奏される部分
advantageously	有利に
masochistic	自虐的な
jolson	ジョルソン
iglu	イグルー
cheapskate	しみったれ|けちんぼ
liposome	リポソーム
chauvinism	盲目的愛国心|ショービニズム(盲目的な愛国主義)
fastidious	好みのむずかしい|潔癖な|細心の|気難しい
ensconce	落ち着かせる|隠す|忍ばせる|安置する|定着させる
flabbergast	(人を)びっくり仰天させる|(受身)めんくらう
spectrometric	分光測定
exonuclease	核酸を鎖の末端から逐次的に加水分解する酵素がエクソヌクレアーゼ|(反対に鎖の内部から切断していく酵素がエンドヌクレアーゼ)|遺伝子組換え技術の中核となる酵素
sagacity	賢明
limey	英国人|英国人移民|英国水兵|英国船|英国の
tonsillitis	扁桃腺炎
drachma	ドラクマ(現代ギリシアの貨幣単位);(古代ギリシアの)ドラクマ銀貨
disown	を自分のものだと認めない|に責任がないという|(子)を勘当する
cutesy	かわい子ぶった
polychrome	多色の
sessile	(植物が)無柄(へい)の|(動物が)固着した|定着性の(イソギンチャクなどについていう)
liger	ライガー(雄のライオンと雌のトラの間に生まれた子)
agitprop	アジテーションとプロパガンダ|アジ宣伝の
scrutineer	検査官;(特に)開票検査人
battler	戦士|武者|闘士|戦闘員
wistfully	物欲しそうに
pillbox	ピルボックス|ピルボックス形婦人用帽子|マッチ箱のような家|丸薬入れ|小型の乗り物
disloyal	不実の
potentate	有力者|勢力家|君主|支配者
nisus	苦労|ご苦労|労苦|骨折り
counterinsurgency	対ゲリラ(活動)|対ゲリラ計画|対反乱計画
philander	(男が)戯れに恋をする|(女に)言い寄る|いちゃつく
polemical	論争の
normalise	ノーマライズ|ノーマライズ
neighborly	exhibiting the qualities expected in a friendly neighbor
culebra	クレブラ島
defector	離反者|離党者|脱党者|脱落者|亡命者
ohmic	of or relating to or measured in ohms
wrinkly	皺(しわ)になりやすい|皺の寄った
typesetter	植字工|植字機
hornbill	サイチョウ|(熱帯林の樹上で生活する|くちばしの大きな派手な色彩の鳥)
intraepithelial	上皮内の
oleo	=oleomargarine
radiotelephone	無線電話|無線電話機
lansoprazole	ランソプラゾール
lasher	ラッシャ
hemodynamics	the branch of physiology that studies the circulation of the blood and the forces involved
unrecognised	無認識|気づかれていない
piteous	哀れな|悲しそうな
sadhu	(ヒンズー教の)聖者
perfunctory	いい加減な
parsec	パーセク
pitta	ヤイロチョウ
calcine	〜'を'焼いて生石灰にするか焼(かしょう)する|焼いて生石灰になる|生石灰
daub	塗りつぶす|塗料|塗る|塗りつける
falsetto	裏声
puissance	(国王の)権力|勢力
muesli	ミューズリー(穀物・豆・乾燥果物など;朝食でミルクとまぜて食べる)
osmium	オスミウム(金属元素;化学記号は『Os』)
criminalization	legislation that makes something illegal; "the criminalization of marijuana"|legislation that makes something illegal
perfidy	不誠実
centralisation	セントラリゼーション|中央集権化|中央集権|セントラリゼイション
meaner	意地悪な|卑しい
psalter	詩篇
comsat	コムサット(大陸間の通信衛星;communications satelliteの略)
insubordination	不服従|不従順|反抗
dilator	a muscle or nerve that dilates or widens a body part|a drug that causes dilation|a surgical instrument that is used to dilate or distend an opening or an organ
fnma	a federally chartered corporation that purchases mortgages
impious	神を敬わない|不信心な
dishonored	suffering shame
festschrift	記念論文集
dilaudid	ヒドロモルフォン
myalgia	筋肉痛
coextensive	(空間的・時間的に)同一の広がりを持つ
phenylpropanolamine	an adrenergic drug used in many preparations to relieve allergic reactions or respiratory infections; "drugs containing phenylpropanolamine are being recalled"|an adrenergic drug used in many preparations to relieve allergic reactions or respiratory infections
unrealised	of persons; marked by failure to realize full potentialities; "unfulfilled and uneasy men"; "unrealized dreams and ambitions"|of persons|marked by failure to realize full potentialities
stiffly	堅く
patristic	of or relating to the writings of the early church fathers
nastiness	意地の悪さ
festivity	祭典|お祭り騒ぎ
interloper	免許営業者|もぐり商人
ischaemia	虚血
processional	行列の
lacrimal	=lachrymal|涙腺(るいせん)の近くにある
afire	(叙述的)燃えて
reformulate	再開発
louver	ルーバー
clench	くいしばる|こぶしを握り締める
sabertooth	剣歯虎
groundswell	(世論などの)盛り上がり
prude	きわめて慎み深い女|慎み深さを装う女|淑女ぶる女
intertwine	絡み合わせる|絡み合う
immensity	広大|無限
halacha	Talmudic literature that deals with law and with the interpretation of the laws on the Hebrew Scriptures
medroxyprogesterone	メドロキシプロゲステロン
uncharacteristically	柄にもなく
scatterplot	散布図
hogwash	豚のえさ(残飯などに水を加えたもの)|くだらないもの|ナンセンス
pheochromocytoma	褐色細胞腫
wyler	ワイラー
buttercream	バタークリーム
goy	a Christian as contrasted with a Jew
predestine	《しばしば受動態で》〈神が〉(〜に)〈人〉‘を'運命づける|‘に'宿命を負わせる《+『名』+『for』+『名』|(〜するよう)〈人〉‘を'運命づける《+『名』+『to』 do》
therapeutically	治療上
spacewalk	宇宙遊泳|宇宙遊泳する
arsenide	a compound of arsenic with a more positive element
hesitantly	しぶしぶと
saturnia	type genus of the Saturniidae: emperor moth
unkempt	(髪が)くしを入れてない|もじゃもじゃの|だらしのない|乱れた
healing	ヒーリング|回復する|治療の|回復|治癒|治療
adjudicatory	concerned with adjudicating
thuja	red cedar
siltstone	シルト岩
wringer	強奪者|絞り手
humorously	滑稽
victoriously	勝ち誇って|勝って
legitimation	準正|合法化
lubeck	リューベック
overstuff	stuff too much; "The pillow was overstuffed"|stuff too much
trioxide	三酸化物、三酸化の、3酸化・化合物の中の酸素数が3個のもの。一酸化=monoxide。二酸化=dioxide。三酸化=trioxide。四酸化=tetroxide。五酸化=pentoxide
acceptably	in an acceptable (but not outstanding) manner; "she plays tennis tolerably"|in an acceptable (but not outstanding) manner
astrolabe	(昔の)天体観測儀
undertone	基調
microcrystalline	微結晶性
hermeneutic	interpretive or explanatory
sorb	吸い上げる|吸いとる|吸取る|吸い取る
paternalistic	温情主義の|家族主義的な
bushmaster	熱帯アメリカ産の大形の毒ヘビ
undernourish	〜‘に'十分の栄養を与えない|‘を'栄養不足にする
croaker	the lean flesh of a saltwater fish caught along Atlantic coast of southern U.S.|any of several fishes that make a croaking noise
iatrogenic	医原性
kaki	柿|柿
cavy	テンジクネズミ(南米産)
decease	死亡する|死亡
tactful	気転のきく
friable	(岩などが)砕けやすい|もろい
cytological	細胞学的な
dismember	手足を切り離す|国土をバラバラにする
secessionist	脱退(党)論者;《しばしばSecessionist》(米国南北戦争当時の)分離論者|脱退の|脱退(党)賛成の;脱退主義の|脱党論の
steganography	符号化
watchword	合い言葉
endocrinologist	内分泌学者
knower	a person who knows or apprehends
scoutmaster	偵察隊長|ボーイスカウトの隊長
prissy	おかまみたいな|小うるさい|取り澄ました|紳士面した|女々しい|やかまし屋の|ホモの|神経質な
julep	=mint julep
zoonotic	of or relating to or constituting zoonosis; "the Ebola virus is believed to be zoonotic"|of or relating to or constituting zoonosis
spillane	スピレイン
oxygenate	に酸素を送り込む|酸化する|酸素で処理する
puncher	穿孔(せんこう)機|打ち抜き器|パンチャー
southeasterly	南東の|南東へ向かう|(風が)南東からの|南東へ(に)|(風が)南東から
funnily	面白おかしく|滑稽に|奇妙なことに|奇妙に
bergson	アンリ・ベルクソン
masterly	巧みな
handwoven	made on a handloom; "handwoven tablecloth"|made on a handloom
claystone	fine-grained rock consisting of compacted clay particles
butchery	屠殺|肉屋|屠殺業|殺生|ぶちこわし|虐殺|だいなしの大へま
treacle	=molasses
variably	変わりやすく|不定に
subtractive	減じる|減算の
happenstance	思いがけない出来事|偶発事態
uncollectible	不良
blooper	(野球)テキサスヒット
amphora	(古代ローマ・ギリシアの)両取っ手つき壷(つぼ)
parasympathetic	副交感神経の|副交感神経
menhir	立て石|立石
socialisation	社会化|社会化|社会化|文化化
deadweight	〈U〉自重(車・船などのそれ自体の重さ);死重(自力で動けない物の重さ)|《a dead weight》《比喩(ひゆ)的に》重荷
unconstitutionally	in an unconstitutional manner; "the president acted unconstitutionally"|in an unconstitutional manner
macrame	マクラメ|マクラメ
foolhardy	無鉄砲な|向こう見ずな|無謀な
unflattering	へつらわない
lagan	goods (or wreckage) on the sea bed that is attached to a buoy so that it can be recovered
nightcap	(寝るときかぶる)ナイトキャップ|(寝る前に飲む)寝酒|(野球)ダブルヘッダーの第2試合
sensationalism	感覚論|興味本位|人気取り|扇情主義
dianthus	ナデシコ・カーネーションなどセキチク類の植物
unconfined	not confined|free from confinement or physical restraint
leaguer	連盟加入者(団体|国)|(野球)リーグの選手
granulomatous	relating to or characterized by granulomas
macula	黒点|太陽黒点|黄斑|斑
musher	a traveler who drives (or travels with) a dog team
dacron	ダクロン
yukawa	Japanese mathematical physicist who proposed that nuclear forces are mediated by massive particles called mesons which are analogous to the photon in mediating electromagnetic forces (1907-1981)
analogical	expressing, composed of, or based on an analogy; "the analogical use of a metaphor"|expressing, composed of, or based on an analogy
overspend	spend more than available of (a budget)|spend more than available of (a budget) |spend at a high rate
chive	エゾネギ
bibliophile	愛書家|蔵書道楽家
waggon	=wagon
pepsin	ペプシンは消化系の中で最初に見つかったタンパク質|胃でポリペプチド鎖が分解され|腸でアミノ酸やジペプチドの断片となり|吸収され代謝エネルギーや新しいタンパク質の原料となる
leghorn	〈C〉《しばしばL-》レグホン(よく卵を産むニワトリの一種)|〈U〉麦わらさなだの一種|〈C〉麦わらさなだで作った婦人用帽子
arava	アラバ|レフルノミド
hydrofoil	水中翼船
signboard	看板
directness	まっすぐ|直接|率直
conflate	異本を合成する|一つにまとめる|合成する|混ぜる|融合する
neurotoxic	神経毒の
bluebook	ブルーブック|青書(国会や政府の報告書|cf|white book)|(米口語)紳士録|大学の記述式試験
unnaturally	人工的|人為的
unsanitary	非衛生的な|不潔な
deerskin	鹿皮
midbrain	中脳
missense	missense mutation|ミスセンス突然変異|遺伝子のコードに塩基置換が起こることにより|コドン部分の塩基配列が変わり|他のアミノ酸をコードするようになる突然変異
hame	ヘメ
sesquicentennial	150年[祭]の|150年祭
pervasiveness	広播性
picking	掘ること|採集|摘み残り|摘むこと
exegetical	relating to exegesis
cholla	arborescent cacti having very spiny cylindrical stem segments; southwestern United States and Mexico|arborescent cacti having very spiny cylindrical stem segments|southwestern United States and Mexico
unexposed	露光されていない
wonton	(中華料理の)ワンタン
panoply	盛装|よろい･かぶとひとそろい|一式
maillot	女性用水着|体操用タイツ|バレエ用タイツ
credulity	軽々しく信じること|過信
gannet	カツオドリ(海岸に住み魚をとる)
polymorph	多形
oversupply	供給過剰
precancerous	前癌状態の
unscramble	〈混乱したもの〉‘を'元どおりにする|整頓する|〈混線した通信など〉‘を'分かるようにする|〈暗号〉
hematuria	血尿
purana	a body of 18 works written between the first and 11th centuries and incorporating legends and speculative histories of the universe and myths and customary observances
picosecond	ピコ秒
incoherence	支離滅裂
stuffing	お召し|調味料|詰め物|詰まり|御召し|詰り|詰め物
narwhal	イッカク(寒帯の海に住む鯨の一種で|雄には角のような長いきばが一本ある)
calamus	羽柄|羽柄
marginalisation	周辺化
nonessential	本質的でない
rightness	正確|適正|適切|正義|公正|高潔
warty	いぼ(こぶ)の多い|いぼいぼの
blowup	爆発|《話》かっとなること|(写真の)引き伸ばし
derangement	混乱|発狂|撹乱
reticule	(昔の)小物入れ・（網製）手さげ袋; （コンピュータ）レティクル (ICの回路パターンの焼き付けられた原版)
mucky	汚ない(dirty)|(天気が)ひどい
pervious	admitting of passage or entrance; "pervious soil"; "a metal pervious to heat"|admitting of passage or entrance
caisson	ケーソン|潜函(せんかん)(橋やダムなどの水中工事で用いる)|(またcamel)浮き箱(沈没船を浮揚させるのに用いる)|(砲兵隊用の)二輪弾薬車
windowpane	(1枚の)窓ガラス
midshipman	海軍少尉候補生|海軍兵学校生徒
exothermic	発熱の
isolationism	孤立主義
overman	〈職場など〉‘に'人員を配置し過ぎる|過剰配員する
swiftness	迅速さ
diplomatically	外交上|外交的に;如才なく
samizdat	(特に旧ソ連における発禁書などの)地下出版[物]
androgynous	雌雄両性の|(同一花序に)雌雄両花のある|男女両性の
westernmost	最西の|西端の
nullity	〈U〉(法律上の)無効;〈C〉(文書・行為などの)法律上無効のもの|〈U〉無;無力|無意味|〈C〉つまらぬ人(物)
discriminative	裁判上
whipper	スイッチャ
jotting	覚え書き|メモ|覚書|備忘録|メモランダム|覚書き|手控え|控え
unsuited	不適当な|適合しない;(〜に)不適当な《+to(for)+名》
cholestasis	(医)胆汁うっ滞|胆汁分泌停止
boatswain	(商船の)甲板長|水夫長;(軍艦の)掌帆長
hearthstone	〈C〉炉石|〈U〉炉辺|家庭
tinplate	ブリキ
geologically	with respect to geology; "geologically speaking, this area is extremely interesting"|with respect to geology
bulbul	ヒヨドリ
gusseted	provided or reinforced with gussets
superintendence	(〜の)監督|指揮|管理《+of+名》
pepcid	ファモチジン
austerlitz	アウステルリッツ|アウステルリッツ
granma	グランマ|おばあちゃん|(=nan|nana|nanny|granny|grandma|granma|gran)
fermenter	発酵槽
transversely	in a transverse manner; "they were cut transversely"|in a transverse manner
nitrification	硝化|硝化
unperturbed	＜perturb|(かき乱す|不安にする) かき乱されない|ろうばいしない|平静な|落ち着いた
featureless	特色のない
pasteurization	低温殺菌
imperil	あやうくする|危うくする|危険にさらす
retool	工場の機械設備を改善する|を再編集する|を改組する
porterhouse	腰上部とあばらの間の肉で作った最上のビーフステーキ
illusive	錯覚を起こさせる|迷わせる
moire	波紋織の絹|波紋模様
contractility	収縮性
animatronic	アニマトロニクス(ロボットや機械を利用し|人の動きを再現すること)
canty	lively and brisk
ripeness	成熟
streaky	筋のついた|しまのはいった|《話》(性質などが)むらのある
bourdon	a pipe of the bagpipe that is tuned to produce a single continuous tone
antiperspirant	汗よけ|発汗抑制薬品
neurophysiological	of or concerned with neurophysiology
laryngoscope	喉頭(こうとう)鏡
vapid	おもしろくない
tsetse	ツェツェ蠅
adulteration	〈U〉混ぜ物をすること|〈C〉粗悪(不良)品
debridement	surgical removal of foreign material and dead tissue from a wound in order to prevent infection and promote healing
unremitting	休む(絶える)ことがない|根気強い;(〜に)根気強い《+in+名》
primula	プリムラ(サクラソウ属の草花)
interoffice	(会社などの)各部課間の|会社内の
evanescent	(次第に)消えてゆく|束の間の|消え入るような|繊細な|はかない
overshoe	オーバーシューズ(靴の上にはく雨・防寒用のゴムの靴)
atavistic	形隔世遺伝的な|先祖返り的な
semiautomatic	半自動式の
panicle	円錐花序
sward	外皮|芝生|芝地|草地|草土|芝生で覆われる|芝生で覆う
aglow	燃え立つように照り輝いて|情熱に燃えて|輝いて
eschatological	of or relating to or dealing with or regarding the ultimate destiny of mankind and the world
slimmer	細い
shareowner	株主
naan	ナン
erratically	不規則に|進路を一定せずに|常軌を逸して
unapologetic	悪びれない
europol	欧州刑事警察機構
achromatic	無色の;色消しの
inebriated	(‐brièɪṭɪd)|酩酊した
ranter	熱弁家|大ぼら吹き
teleological	of or relating to teleology
vulcanize	undergo vulcanization; "vulcanize rubber"|undergo vulcanization|subject to vulcanization; "vulcanized rubber"|subject to vulcanization
hexagram	六角星形
deist	理神論者
caroling	singing joyful religious songs (especially at Christmas)
bugbear	(悪い子を食べてしまうという)お化け|(しばしば根拠のない)こわいもの
quarterdeck	後甲板(最後尾マストと船尾の間の間;おもに高級船員用)
lanceolate	(of a leaf shape) shaped like a lance head; narrow and tapering to a pointed apex|(of a leaf shape) shaped like a lance head|narrow and tapering to a pointed apex
reticence	無口(なこと)|沈黙|控えめ|思慮
iambic	(韻律で)弱強格の|=iambus|《複数形で》弱強格の詩
provably	明らかに
behaviorist	a psychologist who subscribes to behaviorism|of or relating to behaviorism; "behavioristic psychology"|of or relating to behaviorism
quadrille	カドリール(4人が組みになって踊るスクエアダンス;その曲)
treetop	こずえ
urd	goddess of fate: a giantess who personified the past
hassel	ハッセル
inedible	食べられない|食べるのに適さない
incongruity	不調和|不一致
subalpine	growing at high altitudes
vilification	悪口|中傷
unfashionable	流行遅れの
parana	パラナ
recapitulate	要点を繰り返す|要約する|要点を繰返す
sceptic	=skeptic
redetermination	determining again
empiric	経験的|実証的|経験的
fricative	(子音が)摩擦で生ずる|(文法)摩擦音
noncurrent	not current or belonging to the present time
milliliter	ミリリットル
subsumption	小前提|包摂
standpipe	給水用パイプ|給(貯)水塔|水力利用の加圧パイプ
velodrome	ベロドローム
vociferous	大声でどなる|やかましい|騒々しい
outbuilding	離れ(家)
soothsayer	占い師|予言者
trapdoor	跳ね上げ戸
headfirst	まっさかさまに|無鉄砲に|大急ぎで
theist	有神論者
pashtun	a member of the mountain people living in the eastern regions of Afghanistan; "Pathans are the predominant ethnic group in Afghanistan"|a member of the mountain people living in the eastern regions of Afghanistan|an ethnic minority speaking Pashto and living in northwestern Pakistan and southeastern Afghanistan
coitus	性行為|交接|関係|交り|交合|セックス|交わり|交尾|性交|媾合
separability	the capability of being separated
neuritis	神経炎
serogroup	血清学的グループ
opuntia	ハウチワサボテン
dentition	歯の状態(歯の数・種類・歯列など)|歯牙(しが)の発生
understaffed	人員不足の
smallness	小さいこと|狭量
cutback	枝の刈り込み|切りかえし|縮小|削減|合理化
perineal	of or relating to the perineum; "perineal pains"|of or relating to the perineum
gavage	強制飼養(病人・鳥にゴム管などを用いて食物を与えること)
unforeseeable	incapable of being anticipated; "unforeseeable consequences"|incapable of being anticipated
counteroffer	an offer made by someone who has rejected a prior offer
uncompleted	未完成|不完全
worktop	調理台|(台所の)作業台
trope	言葉の比喩的用法
weka	flightless New Zealand rail of thievish disposition having short wings each with a spur used in fighting
sulfonate	スルホン酸塩
sociability	社交性|交際じょうず;交友を好むこと
volcanology	火山学
scapular	肩甲骨
fettuccine	フェットチーネ
hijinks	どんちゃん騒ぎ
thankless	感謝されない|感謝の気持ちを表わさない|報いられない|忘恩的な|恩知らずの
paraquat	パラコート
pudge	a short fat person
amblyopia	弱視
stringency	(規則などの)厳格さ|厳重さ|(金融界の)切迫|金詰まり|(議論などの)説得力|もっともらしさ
sublimity	荘厳さ
enticement	(悪への)誘惑|誘惑するもの|えさ
conservatoire	=conservatory2
patency	the openness (lack of obstruction) of a bodily passage or duct|the property of being easy to see and understand
thereunto	それに|そこへ
compatriot	同胞|同国人
discontented	不平のある|不満な
reflexivity	the coreferential relation between a reflexive pronoun and its antecedent|(logic and mathematics) a relation such that it holds between an element and itself|a relation such that it holds between an element and itself
reductionism	還元法|還元法
nonsurgical	非外科的
discolor	変色する
inoffensive	害にならない
erudition	博学
loll	ゆったり横になる|たれる
masonite	a type of fiberboard
sulfonylurea	スルホニル尿素薬(SU薬)|糖尿病内服治療薬で最も多く使用されている薬
imprimatur	許可|認可
peritoneum	腹膜
cycloheximide	シクロヘキシミド|真核生物のタンパク質合成の阻害剤|DNA損傷|催奇性のため|「in vitro(生体外)」でのタンパク質合成阻害研究に使われ|ヒトの治療薬には不適
turpitude	邪悪|卑劣
adduce	引用する|提示する|例証として挙げる
strictness	厳格|厳重
linnean	of or relating to Linnaeus or to the system of taxonomic classification that Linnaeus proposed
etiologic	病因的|病原学的|病因的|病原学的
egalitarianism	平等主義
humanitarianism	人道主義|博愛
aspergillosis	アスペルギルス症|アスペルギルス症|アスペルギルス症
rammer	石槌
niebuhr	ニーブール|ニーブール
deviled	(料理が)辛く味付けした|辛味をきかした
wellpoint	a perforated tube driven into the ground to collect water from the surrounding area
keeshond	a spitz-like dog having a shaggy greyish coat and tightly curled tail originating in Holland
tussock	草むら|茂み
segno	(music) a notation written at the beginning or end of a passage that is to be repeated|a notation written at the beginning or end of a passage that is to be repeated
inviolable	犯すことのできない|不可侵の|神聖な
washy	(飲み物が)水っぽい|薄い|(色が)薄い|弱い|(感情・文体が)弱い|力のない
thymine	チミン(thymine)|デオキシリボ核酸|DNAを構成する塩基の1つ|英発音はサイミン|DNA中にのみ見られ|リボ核酸(RNA)ではほとんどの場合ウラシルに置き換わっている
commercialise	売り物にする
insufferable	我慢のできない
blinder	目をくらます人(もの)|(馬の)目隠し(= blinkers)|(俗)クリケット|サッカーなどのファインプレー
kimberlite	キンバーライト
cabinetmaker	木工家具職人|指物(さしもの)師
tattle	おしゃべりする
rostrum	演壇|演説家
petroglyph	a carving or line drawing on rock (especially one made by prehistoric people)
unction	(聖別の印として)油を塗ること|塗油式|(塗油の儀式に用いる)聖油|和らげる物|(話をするときなどの)うわべだけの感激(熱心)
unstated	not made explicit; "the unexpressed terms of the agreement"; "things left unsaid"; "some kind of unspoken agreement"; "his action is clear but his reason remains unstated"|not made explicit
germicidal	preventing infection by inhibiting the growth or action of microorganisms
schemer	計画者|策士
decontaminate	〜'を'浄化する|〈物・場所〉‘から'有害物を除く|汚染を除く
anaplastic	of or relating to anaplasia
vaquero	(メキシコ･米国南西部の)家畜商人|カウボーイ
microflora	ミクロフローラ
airbed	空気ベッド
tardive	遅発性
cistron	遺伝因子|ゲン|シストロン|ジーン|遺伝子|因子
hecate	ヘカテ
bustard	野ガン
bibliotheca	a collection of books
staunchly	断固として
presbyter	(長老教会の)長老;(監督教会の)司祭;(初代教会の)世話役
auricular	耳の;聴覚の|(心臓の)心耳の
scrawny	やせた|(口)がりがりにやせこけた|骨張った
peppery	(食物が)こしょうの(ような)|こしょうのきいた|短気な|おこりっぽい
vivisection	生体解剖|生体実験(すること)|(比喩的)綿密な検査|吟味|厳しい批評
splodge	汚点
dauntless	びくともしない
eosinophil	Eosinophil granulocyte|好酸球|5種の白血球の一種|肥満細胞から出される物質によって活性化する
scuttlebutt	(ˈskʌtəlbʌt)|うわさ|ゴシップ|飲料水入れ|水飲み場|噴水式水飲み|大樽
frugality	倹約
nymphet	(10代前半の)魅力的な少女
grovel	腹ばう|ひれ伏す|屈服する|卑屈な態度をとる
loth	=loath
undisciplined	訓練を受けてない;規律を守らない
incriminate	のせいにする|罪を負わせる
signalize	合図|相図|指示|指摘|指ししめす|示す|さし示す|指す
xenotransplantation	異物移植|異種移植
stricture	狭搾|拘束
idempotent	unchanged in value following multiplication by itself; "this matrix is idempotent"|unchanged in value following multiplication by itself
disinvestment	the withdrawal of capital from a country or corporation
disappointingly	がっかり
nephron	ネフロン|尿細管
prejudge	前もって判断する
gielgud	ギールグッド
springy	弾力がある|泉の多い
knowle	についての知識
acrostic	アクロスティック|(数語の語頭などにある語句を折り込んだ遊戯詩･文字遊び)
lamentable	悲しむべき|悲しい
hussy	おてんば娘|いたずら娘|あばずれ女
uncountable	数えられない;無数の(numberless)|不可算名詞(おもに抽象名詞・物質名詞で不定冠詞(a|an)をそけることなく|また複数形にならない)
chanticleer	おんどり
destitution	貧困|困窮
gladiolus	グラジオラス(アヤメ科の多年草;多彩な色の花が咲く)
carbonation	(特に飲料の)炭酸ガス飽和
heliocentric	地動説the heliocentric (Copernican) system(theory) (反)geocentric theory
chromophore	発色団
squalid	むさくるしい|むさ苦しい|劣悪な
cardizem	ジルチアゼム
cytokinesis	細胞質分裂
interrogatory	疑問の
bagatelle	玉突きの一種|つまらないもの|ささいな事|小曲
nilpotent	equal to zero when raised to a certain power
nephrectomy	surgical removal of a kidney
syndic	(法人・大学などの)理事|評議員|地方行政長官|ケンブリッジ大学の特別評議員
imbibe	飲む|吸収する|摂取する|酒を飲む
autobus	二階建バス|乗合自動車|2階建てバス|オムニバス|乗りあい|2階建バス|乗合|ダブルデッカ|バス|乗り合い自動車
semicircular	半円の|半円形の
allosteric	アロステリック効果|タンパク質の機能が他の化合物(制御物質|エフェクター)によって調節されること
trow	=believe|think　信じる　思う
preachy	説教じみた
piling	杭|ピロティ|支柱
photoemission	光電子放出
milliner	婦人帽子屋
catty	意地悪な
hypercalcemia	高カルシウム血症
seismogram	震動記象(地震計によって描かれた記録)
haulier	a haulage contractor
pommel	柄頭|前輪|柄頭|ぶんなぐる|したたか殴る|打ちのめす
crake	クイナ類の鳥の総称|その鳴き声
deckchair	甲板いす
pileup	玉突き事故
duopoly	複占 
linnet	ベニヒワ(小型の鳴き鳥)
shoplifter	万引き[する人]
gaiter	ゲートル|側面が伸縮性のくるぶしまでの高さの深靴|甲が布地のオーバーシューズ
laddie	サニーボーイ|坊や|小僧|カブ|ラッド|少年|ラディー|サニー
chimaera	=chimera
ferociously	猛烈に
pistil	雌しべ
ethidium	ethidium bromide(臭化エチジウム)は有機化合物で|紫外線を当てると赤橙色の蛍光を発する
butanol	ブチルアルコール|ブタノール
unbearably	我慢できないほど
reinforcer	強化因子|強化
stretchable	伸ばす(広げる|張る)ことのできる
typecast	俳優に合わせて役を決める|役を割り振る
homophobe	a person who hates or fears homosexual people
laryngitis	喉頭炎
extrication	脱出|救出
understudy	代役の俳優|〈役〉‘を'代役としてけいこする|〈別の俳優〉‘の'代役を演ずる
hellion	乱暴者|無法者・乱暴者・わんぱく・いたずらっ子
hyla	the type genus of the Hylidae; tree toads|the type genus of the Hylidae|tree toads
ballyhoo	誇大宣伝|鳴り物入りで宣伝する
stooge	(喜劇役者の)引き立て役|ぼけ役|相手の言いなりになる人
trabecular	小柱
judgeship	裁判官の職(地位|権限)
sigmoidoscopy	Ｓ字結腸鏡検査
unrighteousness	failure to adhere to moral principles; "forgave us our sins and cleansed us of all unrighteousness"|failure to adhere to moral principles
shrilly	金切り声で|甲高く
thunderhead	入道雲|積乱雲|発達した積雲の上部
sketchpad	=sketchbook1
aerie	(崖や山頂にある)ワシ|タカなどの巣
basilar	of or relating to or located at the base; "the basilar membrane of the cochlea"|of or relating to or located at the base