parachutist	落下傘で降りる人|落下傘兵
prizefighter	職業拳闘選手|プロボクサー
stuntman	スタントマン(映画などで危険な場面の代役をする人;女性はstunt woman)
fluoridation	フッ化物添加[法]
leaguer	連盟加入者(団体|国)|(野球)リーグの選手
pappy	おやじ|ドロドロの|パン粥状の|柔らかな
homonym	(文法)同音異義語
mailroom	郵便仕分け室
taproot	(植物の)直根|主根
buckram	バックラム(洋服の衿芯(えりしん)や製本に用いる|のり・にかわなどで固めた亜麻布または綿布)
mockingbird	マネシツグミ(北米南部産)
dactylic	(古典詩の韻律が)長短短格の|(英詩の韻律が)強弱弱格の
impedimenta	手荷物;(軍隊の)隊に所属する荷物|行李(こうり)|じゃまになる物
sambo	(ロシア語)サンボ|柔道とレスリングを合わせたようなロシアの格闘技
shakiness	震え|揺れ|動揺|不安定
bather	泳ぐ人|水浴びをする人|水着
connubial	=conjugal
declassification	〈書類などを〉機密情報のリストから落とすこと，機密指定から解くこと
cosponsor	(議案の)共同主唱者(提案者);共同スポンサー|〜‘の'共同主唱者(提案者)になる|共同スポンサーになる
endospore	(生命科学)内生胞子
clothespin	(UK英)洗濯挟み(clothes peg)
exterminator	害虫駆除業者
splotchy	汚れ(しみ)のついた;大きな斑点のある
workbox	道具箱;裁縫箱(workbasket)
behoove	ふさわしい|必要である|にとって義務である
doily	ドイリー|レースの花瓶敷き
climatically	気候上;風土的に
yammer	鼻を鳴らす|(子供が)めそめそ泣く|だだをこねる|こぼす|不平をいう|わめく|大声でしゃべり続ける
sweetmeat	砂糖菓子|キャンデー|ボンボン;果物の砂糖づけ
breadbasket	《話》穀倉地帯|《俗》胃袋
caesium	=cesium
machination	陰謀|たくらみ|策謀
cosmography	天地学(自然・宇宙の一般的特徴を扱う科学)|宇宙現状誌(宇宙の現在の構造を記述する学問)
containerization	コンテナによる貨物輸送
defenseman	ディフェンスマン
proteasomal	プロテアソーム(proteasome|タンパク質の分解を行う巨大な酵素複合体)の
forcemeat	フォースミート(詰め物料理などに用いる味付けひき肉)
pokey	poky|牢獄|ブタ箱
comfrey	ヒレハリソウ(毛ばだった葉のムラサキ科の植物)
mulish	強情な|がんこな|御しがたい
skimmer	上澄み(浮きかす)をすくい取る人(もの|穴あきスプーン)|表面すれすれに過ぎるもの|飛ばし読みする人
abstainer	節制する人|(特に)禁酒する人
deary	かわいい人
graffito	(特に|壁・便所などの)落書き
shortcake	《米》いちご・甘く味付けした果物などをあしらったケーキ|《英》厚手の
cotangent	コタンジェト|余接
sutler	(昔の)従軍商人|酒保商人(軍隊について歩いて品物を売る商人)
braise	蒸し焼き|(肉･野菜を)軽くいためてとろとろ煮る
aboveboard	公明正大な|隠すことのない|公明正大に|隠しごとをせずに
inclemency	気候(天候)の厳しさ
overstock	過多|在荷過剰|仕入れ過剰|仕入れ過ぎる|長く搾乳しないでおく|に詰め込み過ぎる|に供給し過ぎる
polysyllabic	(単語が)多音節の|多音節語を特徴とする
rubicund	(顔色などが)赤い|赤らんだ|血色のよい
saute	(仏語)ソテー(にした･する)(にする)|少量の油で強火でいためること･またはその料理
moulder	=molder
downdraft	下降気流
manlike	人間らしい|人間のような|男らしい(manly);(女が)男まさりの
accordant	《補語にのみ用いて》(〜と)一致した|合致した《+『with』(『to』)+『名』》
purgatorial	罪を清める|浄罪の|煉獄(れんごく)のような
splitting	裂ける|割れる|割れるように痛む|キリキリ|腹が痛む様子
floodlight	投光照明|フラッドライト
dairyman	酪農場で働く男|酪農場主(経営者)|酪農製品販売者|牛乳屋
hereunto	=hereto
bulldoze	整地する|おどしつける|ごり押しする|ブルドーザーでならす
cookhouse	炊事場|(特に)船の調理室|(キャンプ・工事現場などの)仮設炊事場
medevac	(戦場の)負傷者救出用ヘリコプター
protestor	抗議者
cupric	第二銅の|銅を含んだ
highschool	高校
bestride	〜‘に'またがる;〜'を'またいで越す
fink	密告者(アメリカのスト破りの名から)
reckoning	計算する|見積り
cheeriness	明るさ|元気|快活
periphrasis	〈U〉迂言(うげん)法|〈C〉迂言的な表現(文章);回りくどい表現(文章)
strikebreaker	ストライキ破りをする人
spiciness	香ばしさ|痛快さ
strop	(かみそりをとぐ)皮砥|〈かみそり〉‘を'皮砥でとぐ
frontrunner	(競技で)先頭を走る選手(馬など);ペースメーカー
tidewater	潮水(海岸・河口に差してきた潮水)|海岸地方
zit	にきび
ziplock	ジッパーのついたビニール袋
aspic	アスピック(肉・魚・野菜の煮汁から作るゼリー)
itty	(幼児語)ちいちゃい(=itty-bitty)
welterweight	ウェルター級|(welterは波やうねりのこと)|ボクシングでは約63|5-66|7kgと最も平均的な体格で|競争率が高い
gamesmanship	(スポーツで)反則すれすれの巧妙な勝ち方
longhaired	長髪の|《軽べつして》芸術家気取りの|インテリの・ヒッピーの
nutter	気違い|狂人|変わり者|木の実を拾う人
signalman	(鉄道の)信号手|信号係;(軍隊の)通信兵
argillaceous	粘土の|粘土質の
harlotry	売春
huskiness	(声の)しわがれ|かすれ
theosophical	神知学の|接神教(論)の
freebie	ただでもらえるもの
autosome	常染色体
wormy	虫のついた|虫の食った;虫だらけの|虫けらのような;浅ましい
barker	ほえる動物|どなる人|客引き|ピストル
biddable	(人が)柔順な|すなおな
jessamine	=jasmine
lectureship	大学の講師の職(地位)
recombinase	リコンビナーゼ|酵素(enzyme)の名
gutless	意気地(根性)のない
gaga	ホモ|ホモの前戯|いかれた|熱狂した|変わった|のぼせ上がった|夢中になって|恍惚の
decant	静かに注ぐ
clannish	氏族の|一族の|党派的な|同族で固まった|排他的な
lancer	(また『lance』)〈C〉(やりで武装した)槍騎兵(そうきへい)|《複数形で》《単数扱い》ランサーズ(男女4組から成る古い舞踏の一種|またその曲)
logjam	行き詰まり|渋滞|流れに停滞した丸太群
perquisite	《話》臨時収入;(合法的な)役得
mummery	無言劇の演技|見せかけの儀式;こけおどし
sunbaked	(陶器・れんがなどが)日干しの;天日でからからになった(堅くなった)|《話》(道路などが)太陽の照りつける
compeer	(階級・能力などが)同等な人|仲間|同僚
hijacking	ハイジャック
ogress	(女の)人食い鬼|酸酷な女|野蛮な女
broider	《古》=embroider
housewares	家庭用品
kooky	(俗)ばかげた|気違いの|妙な
lumberman	材木切り出し人;材木商
highlander	高地人|スコットランド高地人
hyphenation	ハイフネーション(ハイフンでつなぐこと)
interurban	都市間の
beatification	幸せにすること
hooray	=hurray
parainfluenza	パラインフルエンザウイルスは|関連した数種類のウイルスを含み|感冒からインフルエンザ様症候群|肺炎まで多数の呼吸器疾患を引き起こす
cryptosporidiosis	クリプトスポリジウム症|家畜やネズミなどの腸管寄生原虫が糞口経路で伝播する|最も一般的な水系感染症の1つ|腸が障害を受け下痢症状となる
mannerly	礼儀正しい|ていねいな
prolate	(球体が)長形の
brill	ヨーロッパ産のヒラメ
maven	達人|(自称)物知り|通
shirtwaist	カラーとカフスのついたワイシャツ型の婦人用ブラウス(ワンピース)
choirmaster	聖歌隊の指揮者
tetchy	気難しい|怒りっぽい
navvy	土木労働者|土方|土工
shipwright	船大工|造船工|船修理工
cytometer	血球計算器
pompadour	ポンパドゥール(男性のオールバック|または女性の前髪をなで上げて後ろで束ねた髪型)
howbeit	〜とはいえ(nevertheless)|〜だけれど(although)
syllabary	音節[文字]表(日本語の五十音図など)
frustum	円錐(すい)台(円錐の上部を切り取った形)
orthologous	オーソロガス(種分岐相同性の)　参：パラロガス(paralogous|遺伝子重複相同性の)
congresswoman	婦人国会(下院)議員
emoticon	顔文字
stolidity	鈍感|無神経
threadlike	糸のような|細長い|ほっそりした
songster	歌手|歌の作者;詩人|鳴き鳥(songbird)
larkspur	=delphinium
cadenza	カデンツァ(楽曲の中で|独奏(唱)者が伴奏を離れて独自に演奏する華やで技巧的な部分)
crampon	つかみ金(氷・材木・石などの重い物をつかむ)|《複数形で》(また『climbing irons』)アイゼン|鉄かんじき
podiatrist	足病医
theodolite	経緯儀(鉛直角・水平角を測定するのに使う器械)
peppy	加速が速い|活発な|元気いっぱいの|高速運転ができる|酒に酔って|張り切った
rupiah	ルピア|インドネシアの通貨単位
pneumococcus	肺炎球菌
crybaby	泣き虫|弱虫
inflexibly	不屈に|がんこに
superficies	表面|外面;外観|体裁
scrim	スクリム(綿または麻の目のあらい織物;旗・カーテン用)
hereupon	ここにおいて;その直後に
rancidity	いやなにおい(味)のすること|いやなにおい|悪臭;いやな味
fluoresce	けい光を発する
lawbreaking	法律を破ること|法律違反の
overexpress	(生命科学用語)過剰発現する
univ	大学
evacuee	避難者|疎開者
execrate	〜‘を'ひどくきらう;〜‘を'激しく非難する
eluate	溶出液
woodbine	スイカズラ(よじ上り性の低木)|《米》=Virginia creeper
coalfield	炭田|石炭埋蔵地帯
funnily	面白おかしく|滑稽に|奇妙なことに|奇妙に
lecher	好色家
neuralgic	神経痛の
peloton	サイクリングレースなどのメイン集団|先頭集団
scatological	糞便の
bedfellow	政治的同士|仲間
outmost	=outermost
mispronounce	発音を誤る
sepoy	インド人兵|インド人傭兵
mayfly	蜉蝣(カゲロウ)
asepsis	無菌状態
capillarity	毛細管現象|毛状|毛管状
seamy	縫い目のある(出た)|裏面の|見苦しい
lineament	顔だち|人相|特徴
bluefish	青魚|アジ|ニシン|スズキなど
coevolutionary	共進化
pneumoconiosis	肺塵(じん)症(塵やほこりを吸いこんで起こる肺の病気)
despond	落胆する
southeasterly	南東の|南東へ向かう|(風が)南東からの|南東へ(に)|(風が)南東から
wether	去勢した羊
besom	竹ぼうき
stoat	貂|テン|イタチ(夏に毛が褐色)
adagio	(音楽で)ゆるやかに|アダージォの曲(楽章)
quadroon	祖父母4人のうち一人が黒人の混血児
incrust	=encrust
knavish	悪漢のような|ふらちな;不正な
adulterant	(品質を落とす)混ぜ物|混ぜ物をする
nonstarter	見込みのない人;可能性のない考え
obstructionist	議事妨害者
flutist	フルート奏者
jinks	浮かれ騒ぎ
modernistic	現代主義[者]の;現代的な|新しい
steelworker	製鋼所工員|製鋼所職工|鉄鋼労働者
incumbrance	=encumbrance
permissibly	許されて|差し支えなく
potbelly	太鼓腹
preexistence	(霊魂の)先在・前世・生前の魂の存在
aftereffect	後遺症|残効
backfield	(アメリカンフットボールで)後衛
ankh	(エジプト美術で)輪つき十字形(生殖・長寿の象徴)
coryza	鼻カタル|鼻かぜ
sweeping	おおざっぱな|全面的な|さっと動く|掃除|広範な|ごみくず|十把一絡げ
crupper	しりがい(馬具がすべらないように|尾の下に通してくらに結ぶ皮ひも)
cornstalk	とうもろこしの茎
glebe	〈U〉《詩》土|土壌|〈U〉〈C〉(またglebeland)《英》小教区教会耕地|聖職領畑地
oversea	海外の|海外へ|海外向けの
peacekeeper	平和維持軍
ethidium	ethidium bromide(臭化エチジウム)は有機化合物で|紫外線を当てると赤橙色の蛍光を発する
metalworker	金属細工師(職工)
purlieu	〈C〉(まれ)(都市の)周辺地域|郊外|《文》《the purlieus》(〜の)周辺|近隣《+『of』+『名』》
bipartisanship	2党主義
drouth	=drought
flanker	側面にある物(人)|(米式フットボールで)フランカー(攻撃側の最前線両端の競技者の外側に並ぶ競技者)
emend	〈原稿〉‘を'校正する|‘の'誤りを正す
hobnob	懇談|親しくつきあう|親しく話をする
suffusion	(液体・色などが)みなぎること|充満;(顔などの)紅潮
thievish	盗癖のある;泥棒のような;こそこそやる
ineffaceable	(しみなど)消すことのできない;(思い出など)忘れられない|ぬぐい去れない
tabor	テイバー(昔|竪笛の伴奏に用いたタンバリンに似た小太鼓)
upperclassman	(大学・高校の)上級生(3年生または4年生)
isogenic	同系の
puffiness	ふくれ上がっていること|息切れ
inebriate	酒癖のある;酔った|大酒飲み;酔った人|〜‘を'酔わせる
snuffle	=sniffle
bowline	もやい結び(船をつなぎ止めるときの結び方)
caddie	ゴルフのキャディー
elephantiasis	象皮病(皮膚や肉が厚くなる熱帯病)
lateen	大三角帆(地中海の帆船に見られる)
misgovernment	悪政|失政
mambo	マンボ(を踊る)
growly	(動物の)吠える声のような|うなり声の|(人が)がらがら声の|いらいらした
quetzal	ケツァル(中南米産の長い美しい尾を持つ鳥)
amnesiac	記憶喪失者|健忘症患者|記憶喪失症の
bilberry	コケモモ(ヨーロッパ下部山岳地の低木)|その実
dormouse	ヤマネ(リスに似たネズミで冬眠する)
halite	岩塩
sunroof	(自動車の)日よけ屋根
stabbing	突き刺すような|のを刺す|刺す
cremate	〈死体〉'を'火葬にする
emasculate	無力にする|骨抜きにする|弱くする|去勢する
blowpipe	(俗)吹矢筒|トーチ|ライフル銃
wimple	(修道女の着ける)ベール|頭巾(中世には一般の婦人も使用した)
insatiate	満足することない|飽くことのない
marimba	マリンバ
pussycat	プッシーキャット
condole	(人に)悔やみをいう|(人を)慰める《+『with』+『名』〈人〉》
exotica	異国趣味の文学作品|異国風のもの|奇習
preachy	説教じみた
subjoin	〈文など〉‘を'追加する|終わりに付け加える《+名+to+名》
decidual	脱落膜|(decidual cell脱落膜細胞)
hydrofoil	水中翼船
alphabetize	〜'を'アルファベット順に並べる|〜'を'アルファベットで表す
hogwash	豚のえさ(残飯などに水を加えたもの)|くだらないもの|ナンセンス
mummer	無言劇の役者|役者
pigheaded	強情な|がん固な
welkin	空(sky)
folksong	民謡|フォークソング|民謡調の歌
infielder	(野球)内野手
monophonic	単旋律の;単旋律曲の|1チャンネル録音再生の(monaural)
peeper	のぞき見する人;せんさく好き|《複数形で》《俗》目|ピーピー鳴く鳥・ピーピー[チューチュー]鳴く獣[鳥]; ひな・(かん高い声で鳴く) アマガエル科のカエル・めがね・覗(のぞ)き見をする人・(ふつう複数で)目
disproof	反証[すること]|反ばく;〈C〉反証物件
polisher	艶出し器|磨く人|おべっか使い|追従者
waspish	スズメバチのような|怒りっぽい|短気な
weaponless	武器を持たない|武器のない
disbandment	(組織・隊などの)解散|解隊
oof	お金|強さ|現金|効力|ウーン|ウッ
bedevil	(人を)悪魔に取りつかせる|混乱させる|苦しめる
twosome	二人でする舞踏|二人の|2人組|二人でする(試合)
knitter	編む人|編み機
camptothecin	カンプトテシン(CPT)は細胞毒性のあるアルカロイド(Alkaloid)|DNA酵素の働きを阻害する|抗がん剤として中国原生のカンレンボクの樹皮と幹から単離された
fussiness	小うるさいこと|口やかましさ
tarpon	Atlantic tarponターポン|カライワシ目イセゴイ科の魚|体長は250cmを記録|太古よりほとんど形状を変えず現代まで生き延びてきた古代魚
trilobite	三葉虫(甲殻類に属する最古の化石動物)
depolarize	減極させる|脱分極させる
ironmonger	《英》鉄器商|金物屋
extravert	=extrovert
deepness	深さ|深度|深遠
floriculture	草花栽培[法]|花作り
garbanzo	=chickpea
neap	小潮(こしお)(潮の干満の差が最小の日)
oversubscribe	〈公債・寄付など〉‘を'募集額以上に申し込む
travois	昔|平原インディアンが馬か犬に引かせた|おもに2本の長い丸太でできたそり
almoner	《英》(病院の)社会医療事務職員
backbench	《英》(特に下院の|党幹部を除く)平議員
periwig	(17・18世紀に男性が用いた|現在は法律家が用いる白い装飾用)かつら
horsemeat	馬肉
adjudge	〈人〉‘に'判決を下す|宣告する|(法律・審査で)(人に)〜'を'与える《+『名』+『to』+『名』〈人〉》(award)|《『adjudge』+『名』[+『to be』]+『形』(『名』)〈補〉》(〜と)〜'を'考える|見なす
apiary	ミツバチ飼養場
dartboard	投げ矢遊びの標的(盤)
oculist	眼科医
escritoire	書き物机(writing desk)
heartbreaker	人の心を傷つける人(女)|(特に恋人を振って)男の心を痛ませる女
narcosis	(麻酔剤による)昏睡(こんすい)状態
transcendentalist	先験論者;超絶論者
chao	(=ciao)チャオ|イタリア語の挨拶
dayroom	(軍のキャンプ・刑務所・病院などの)読書娯楽室
megalith	(特に|先史時代の遺物である)巨石
strangulate	〈腸・血管など〉‘を'くくる|縛る;〈血行など〉‘を'縛って止める
markdown	値下げ|プライスダウン(和製英語)
slaty	スレートの|スレート状の
manacle	《複数形で》|手錠|束縛|拘束|〈人〉‘に'手錠を掛ける|〜‘を'束縛する
chilblain	しもやけ|凍傷(frostbite)
ducky	かわいい|すてきな|素晴らしい
truckle	(〜に)ぺこぺこする《+to+名》
unblushing	恥知らずの|ずうずうしい|赤面しない
clansman	氏族の一員;同氏族の人
crosswind	(進行方向に対し)直角に吹く風|横風
misdirect	あて先を誤る|誤った指導をする
careerist	出世第一主義者
stereoscope	立体(実体)鏡
trollop	だらしのない女|自堕落な女|身持ちの悪い女
bittern	サンカノゴイ(サギの一種)
hairbreadth	毛ほどの幅(間隔)|毛ほどの|ほんの少しの
quirt	編み皮の乗馬むち
hubcap	ホイールキャップ(和製英語)
hypercritical	酷評の|あら捜しする(overcritical)
naughtily	わんぱくに
phlox	フロックス|ハナシノブ科の植物で花が美しい|67種が知られており|越冬性一年草のものと多年生のものがある
topgallant	トゲルンマスト(帆船でトップマストのすぐ上に付けるマスト);トゲルンスル(トゲルンマストの帆桁にかける帆)|トゲルンマスト(トゲルンスル)の
peekaboo	いないいないバー
purism	(語法・文体などでの)純粋主義
febrifuge	解熱作用のある|解熱剤
potation	《複数形で》酒を飲むこと;酒盛り|〈U〉〈C〉酒
astigmatic	乱視の
painfulness	苦しみ|骨折り
softie	気が弱い人|人の言いなりになる人
matricide	〈U〉〈C〉母殺し|母殺しをする者
photometer	光度計;(写真の)露出計
unmethylated	非メチル化
blather	ばかげたことを言う
steamroller	蒸気ローラー
ethernet	イーサネット|コンピューターネットワークの規格の1つで|世界中で使用されているLAN(Local Area Network)で最も使用されている技術規格
whodunit	推理(探偵(たんてい))小説(映画)|ミステリーもの
embalm	香気を満たす|(死体に)防腐処理する
unlatch	〈戸など〉‘の'掛け金をはずす
ingathering	取入れ|収穫|集会|会合
quintal	キンタル(重量の単位;100kgに相当)
kraut	塩漬けかぶら
wintergreen	ヒメコウジ|冬緑樹|冬緑油(の香味)
gibbous	《名詞の前にのみ用いて》(月が)凸(とつ)状の|せむしの(humpbacked)
gesticulate	身振りで話す|身ぶり手振りで表現する|活発な身ぶりをする
gyroscopic	ジャイロスコープ(回転儀)の
projectionist	テレビ技師|映写技師
crosse	クロス(ラクロス(lacrosse)競技用のラケット)
sulfonylurea	スルホニル尿素薬(SU薬)|糖尿病内服治療薬で最も多く使用されている薬
adorer	礼拝者|崇拝者|賛美者|熱愛者
heavenwards	=heavenward
smudgy	汚れた|しみだらけの|不鮮明な|煙る|くすぶった|すすけた
tripeptide	トリペプチド(アミノ酸の元としてタンパク質proteinを作る) cf|peptide
tush	牙|長くとがった歯|白黒混血児|お尻|危険な|好戦的な|上流の|チェッ!
tantalize	じらす|人をじらす
broncho	=bronco
suborn	(わいろなどを与えて)(人に)偽誓(偽証)させる|悪事を働かせる
bungle	やりそこなう|へま(をする)|しくじる|しくじり
kerf	(のこぎりなどで木につけた)切り込み|ひき目;(枝などの)切り口
syndic	(法人・大学などの)理事|評議員|地方行政長官|ケンブリッジ大学の特別評議員
animalism	獣性;獣欲主義|人間動物説(人間の霊性を否定する説)
catgut	腸線|ガット(小羊などの腸で作った強いひも・糸で弦楽器の弦|テニスのラケット|外科用縫合糸などに用いる)
durbar	(インド土侯・旧インド総督の)公式会見|謁見
bandbox	(帽子・カラーなどを入れる)ボール箱|薄板箱
enrollee	入学者
lychee	=litchi
thespian	悲劇の|(一般に)演劇の|悲劇役者|(しばしばおどけて)俳優|役者
mazy	迷路のような
sectionalism	地域主義|地域偏重[主義];派閥主義
jodhpurs	乗馬ズボン
railhead	鉄道(線路)の終端|レールの頭部
interstice	隙間|割れ目|裂目|穴|間隔
emulsify	〜‘を'乳状(乳剤)にする
homebody	家に引きこもりがちな人・家庭的な[マイホーム主義の]人
lubber	(体の大きな)ぶこつ者|無器用者|未熟な水夫
mefloquine	メフロキン(抗マラリア剤|内服する)
platen	プラテン(印刷機・タイプライターのローラー)
seropositivity	血清反応陽性
overlie	〈覆い・地層などが〉〜‘の'上に横たわる(重なる)
myristate	ミリスチン酸エステル|ミリスチン酸(化合物名)
mesmerize	催眠術をかける
sporangium	(コケ植物の)胞子嚢(のう)
columbine	オダマキ(植物)
phylactery	(ユダヤ教の)経札|聖句箱
quitclaim	(不動産などの)権利放棄|〈財産・権利などの要求〉‘を'放棄する
appointive	任命(任用)による
bleacher	漂白者(器･剤)|屋根なし観覧席
deadwood	枯枝|枯木|無用な人々(もの)
left	左の|左側
motocross	モトクロス(荒地の競走路を走るオートバイレース)
catafalque	棺台|無蓋の霊柩(れいきゅう)車
distend	膨張させる|広げる|膨脹させる|誇張する|膨らませる
masturbatory	自慰の|手淫の
precentor	(聖歌隊の)先唱者
redux	戻ってきた
cerumen	耳あか
jimmy	(食用の)羊の頭|(強盗用の)金てこ|金てこでこじあける
lorn	孤独の|わびしい|見捨てられた
rockery	=rock garden
felicitation	祝賀|祝辞
itchiness	かゆいこと|むずむずすること
churchgoer	(きちんと･熱心に)教会に通う人
preamplifier	プリアンプ(受信した弱い電波を検波・増幅する装置)
rhyolite	流紋岩(二酸化ケイ素を多く含むきめの細かい火山岩)
calla	(サトイモ科)カラ|ミズイモ
dodger	ぺてん師|小さいビラ
ghostwriter	代作者|ゴーストライター
cellblock	(刑務所の)独房棟
retouch	写真修正
intronic	イントロン(遺伝子関連)の|遺伝情報として転写はされるが最終的にはアミノ酸の塩基配列から除去される配列をintronという
murkiness	暗さ;陰気;曇っていること
masterstroke	すばらしいできばえ|みごとな腕前(手腕)
yearend	年末の
cozen	〈人〉'を'だます
negativism	否定論|懐疑論
staging	上演できる|上演|駅馬車業|集結
mutineer	19
hallo	もしもし|ハロー(Hello)
nougat	ヌガー(木の実がはいった砂糖菓子)
sectary	=sectarian
shortchange	サボる
uncrowned	[まだ]王冠を戴かない(いただかない)|王位につかずに実権を持つ
palmistry	手相術
pennon	槍旗(三角形または燕尾(えんび)形で騎士が槍につけた)|(一般に)旗
abeam	(海事用語で)(〜の)真横に《+『of』+『名』》
spanking	(歩調)活発な|威勢のよい|(風)強い|すごく立派な|すてきな
toadstool	(特に)毒きのこ
bookstall	[古]本の露店|《英》(駅の)新聞[雑誌]売店(《米》newsstand)
collectable	収集価値のあるもの|マニアが収集するもの
trilby	フェルトの中折れ帽
civvies	(軍服に対して)平服|背広
lorgnette	(柄の付いた)めがね|オペラグラス
shipmaster	船長
paratyphoid	パラチフス
sociably	社交的;愛想よく
matriculate	(試験の結果によって)〈人〉‘に'大学の入学を許す|(大学に)入学資格を得るための試験を受ける《+『at』(『in』)+『名』》
pannier	(牛馬の背や自転車の両側につける)荷かご|パニエ(婦人服の腰部を広げるための骨のわく)
triumvir	(古代ローマの)三執政官の一人
intangibility	触れることのできないこと|漠然としてつかみどころのないこと
moated	《名詞の前にのみ用いて》堀で囲まれた(守られた)
congener	同種|同類の物(人)|同属の動植物
bullfighter	闘牛士
ectoplasm	(霊媒の体から出る)心霊体
shrike	モズ
turboprop	ターボプロップエンジン(航空機)
trimmer	trimする人･もの|手ごわい人|ごまかしを言う人|素晴らしいもの|一級品
worldclass	ワールドクラス
mimeograph	謄写版|複写器|(謄写版による)写し|〜‘を'謄写する(duplicate)
pacer	ペースメーカー
chessman	チェスのこま
derringer	デリンジャー式ピストル(短い銃身で口径が大きい)
drowning	溺死
foredoom	〜‘を'前もって運命づける|前もって定められた運命|予定された運命
bund	海岸通り|築堤|堤防|(punt平底小船|ラグビー等でボールが地に着く前に蹴ること|bunt野球のバント|band帯|楽団|bund海岸通り)
hyperopia	遠視
nippy	(幼児語)おしゃぶり(=pacifier)|すばしこい|厳しい
inveigle	(ある場所に)〈人〉‘を'おびき寄せる|(ある行為に)〈人〉‘を'そそのかす《+『名』+『into』+『名』(do『ing』)》
basset	バセット犬(basset hound|足の短い犬種)
holmium	ホルミウム(希土類金属元素;化学記号は『Ho』)
damselfly	イトトンボ
brindled	とらぶちの(灰色・黄褐色の地に濃い縞・斑点のある)
glycopeptide	糖ペプチド
moped	ペダル付きのオートバイ|原動機だけでもペダルをこいで人力だけで走行することが可能な車両の総称|Motorと Pedalの合成語
owlish	フクロウに似た
racquetball	ラケットボール|壁に囲まれたコートでボールを壁にはね返らせるスカッシュに似た球技
revalue	〜‘を'再評価する|〈通貨〉‘を'切り上げる
dugong	ジュゴン(インド洋に住むイルカに似た水生哺乳(ほにゅう)動物)
distich	二行連句|対連(ついれん)(同じ韻を持つ2行だけの詞)
hygrometer	湿度計
floodgate	(水量の調節をする)水門
hearten	元気づける|励ます
somite	体節(somite)|脊索動物全般に胚発生時に現れる分節構造
bilabial	両唇(しん)音([b]|[m]|[p]など両唇で発音されるもの)|両唇で発音される
dullard	のろま|ばか
roomie	ルームメイト
remediable	治療できる|取り返しのきく|救済できる
autobahn	アウトバーン|ドイツの高速道路
overqualified	(ある仕事に泌要以上に)教育(経験)がある
patriotically	愛国的に
remunerate	(苦労などに対し)〈人〉‘に'報いる《+『名』+『for』+『名』(do『ing』)》|(サービスに対し)〈人〉‘に'報酬を与える《+『名』+『for』+『名』(do『ing』)》
andiron	(炉の)まき載せ台
lachrymose	(人が)涙もろい;(物語・歌などが)涙を催させる
otiose	(考え・言葉などが)不必要な|よけいな|役に立たない
playgoer	よく劇場へ行く人|芝居の常連
deafen	聴覚を奪う
lightsome	軽快な;快活な|陽気な;上品な|優美な
marketeer	市場商人
osteoclastogenesis	破骨細胞形成
procaine	パロカイン(局所麻酔な用いる薬品)
weatherproof	(布・衣服が)風雨に耐える|〈生地〉‘を'風雨に耐えられるようにする
airbrush	エアブラシ(ペンキ吹き付け用噴霧塗装器)
bagatelle	玉突きの一種|つまらないもの|ささいな事|小曲
congrats	=congratulations
fretwork	雷文飾り
gauss	ガウス(磁力の強さのcgs単位)
commendatory	推薦する|推賞の
peckish	腹のすいた
thymocyte	胸腺細胞
fortissimo	(音楽の演奏で)最も強く(《略》ff)|最も強い|フォルテシモの
pusillanimity	いくじのなさ|おくびょう|優柔不断
slammer	ドア|戸口|刑務所|ブタ箱
bookbinding	製本[術]|製本業
generalissimo	大元帥
guff	(俗)ばか話|くだらない事
tuppence	=twopence
buster	ベビーブームのあとの世代の人|破壊する人|(よびかけで)おい
deliveryman	(客の購入品・注文品の)配達員
traumatize	に外傷を負わせる|を傷つける|に損傷を与える|に精神的ショックを与える|に心の痛手を負わせる
condign	(特に罪が)当然の|妥当な
dogcart	(背中合わせの2座席がある)軽二輪馬車|犬に引かせる二輪車
imperforate	穴のあいていない|(切手に)ミシン目のない|ミシン目のない切手
pennyworth	(〜の)1ペニーで買える分量|1ペニー分(の〜)《+『of』+『名』》|わずか|少量(の)《+『of』+『名』》
sailcloth	帆布|ズック|帆木綿
collocate	〜'を'いっしょに置く|一まとめにする;〜'を'配列する|〈語が〉(他の語と)連語をなす《+『with』+『名』》
gassy	ガスが充満した;ガスを含む|ガス状(質)の
pliancy	(物の)柔軟さ|しなやかさ|(人の)柔順さ|順応性
breaststroke	平泳ぎ
canoeist	カヌーのこぎ手;カヌーこぎの名手
commissionaire	(ホテル・劇場・役所などの制服を着た)守衛|受付|門衛
purblind	半盲の|目がよく見えない|反応(理解)のおそい|鈍感な
antigravity	反重力(陽の質量の物体が陰の質量の物体と反発する力)
oiler	タンカー
parboil	〈肉・野菜など〉'を'さっとゆでる|さっと湯を通す|《まれ》〈部屋など〉'を'熱くしすぎる|〈人〉'を'ひどく暑がられる
caterwaul	(発情期の猫のように)ギャーギャー言う|いがみ合う|ギャーギャー鳴く声
dastard	ひきょう者|卑劣漢
rudiment	《the rudiments》(〜の)初歩|基本|原理《+『of』+『名』》|《the rudiments》(〜の)きざし|芽ばえ|初期《+『of』+『名』》|〈C〉(生物の)痕跡器官|退化器官
cotillion	コティヨン(18世紀に始まった活発な社交ダンス)
meddler	おせっかいをやく人
mercaptoethanol	メルカプトエタノール|劇物取締法による毒物|引火性で炎や酸化剤などに接触すると発火する|還元剤として働く
attache	大使館員|(大使･公使の)随行員
canvasser	(選挙などの)運動員|(販売などの)勧誘員
cesspit	汚物だめ|(一般に)汚い場所
classified	分類された|機密の
complacence	=complacency
faubourg	(特にフランスの)郊外|近郊
obeah	(アフリカ・西インド諸島で行われる)魔術
ablate	除去する
overbalance	〜‘の'平衡を失わせる|(重さ・重要さなどで)〜‘を'圧倒する|‘に'勝る|平衡を失う|バランスをくずして倒れる
irrefragable	論争の余地のない|反論できない|否定できない
woad	(大青(たいせい)から採った)青色染料
prepay	前払いする
spud	小さい鋤(すき)
copybook	習字の手本帳|《米》複写薄
entombment	埋葬
gherkin	(酢づけにする)小キュウリ
nocturne	夜想曲|ノクターン|夜景画
solecism	文法(語法)違反|破格|無作法|誤り|不適当
viewless	意見のない
seasonably	時機を得て|つごうよく
aconite	トリカブト(有毒性植物)
cowman	牛飼い|牧畜業者
virological	ウイルス学的な
taillight	テールランプ
nonrepresentational	非描写的な|非具象的な|描象的な
ribonucleoprotein	リボ核タンパク質
striation	〈C〉細い溝(筋)にはいった状態|筋を付けること|〈C〉細い溝(筋)に一本(stria)
aphelion	遠日点(月・遊星が太陽から最も離れる点)
giro	郵便振替
yadda	yadda|yadda|yadda等と使う|等々|の意味|"blah blah blah"や"and so on"と同じ使い方(スラング) (=yada)
oxtail	牛の尾(特にシチュー・スープなどに用いる)
swallowtail	ツバメの尾;先が深く二つに割れたもの|《話》=swallow-tailed coat|アゲハチョウ
floret	小花
atony	(生体の組織の)無力[症]|弛緩(しかん)
expurgate	〈書物など〉‘の'不穏当な箇所を削除する
verboten	(法律などにより)禁じられた
bedew	(露・水滴・涙などで)〜'を'ぬらす《+『名』+『with』+『名』》
europium	ユーロピウム(希土類元素;化学記号は『Eu』)
loadstone	=lodestone
offish	よそよそしい
cornerback	アメリカンフットボールの守備陣の名
vend	(小さな商品を)売り歩く|(土地･家屋などを)売却する
annelid	環形動物(ミミズなど)|環形動物の
cabdriver	タクシー運転手
hidalgo	(スペイン語)下級貴族
interline	(語句などを)〈本の行間〉‘に'書きこむ《+『名』+『with』+『名』》|〈衣服など〉‘に'芯(しん)を入れる
sanely	正気で|分別をもって
blowhole	(トンネル・地下室などの)通風孔|(クジラの)噴気孔|(鋳物の)気泡(ほう)|(アザラシなどが呼吸するための)氷の中の穴
cabinetmaker	木工家具職人|指物(さしもの)師
craton	大陸塊(地殻で比較的堅く安定した部分)
pushcart	手押し車
ultranationalist	超国家主義者
cliffhanger	はらはらさせるもの|はらはらする試合
shoeshine	みがいた靴の艶|靴を磨くこと|靴磨き(人)
annuitant	年金受領者
dextrin	デクストリン|糊精(こせい)(印刷用インク・水あめなどの粘着剤)
deejay	ディスクジョッキー|DJ|disc jockey
ramie	〈C〉カラムシ(アジア産の低木で織物用の繊維が採れる)|〈U〉カラムシの繊維
enfranchise	〜‘に'参政権(選挙権|自治権)を与える|〈奴隷(どれい)など〉‘を'解放する|自由にする
unloose	(〜から)〈鳥・捕虜など〉'を'離してやる|解放する《+名+from+名》|〈つかんだ手など〉'を'緩める|解く
grayling	カワヒメマス
neuroblast	神経芽細胞
suspensive	未決定の;不確かな|不安な|中止する|停止の
ramekin	ラミキン(チーズやパン・卵などを混ぜて1人前ずつ焼いた料理)|ラミキン料理用の皿
photographically	写真術によって;写真のように
pterodactyl	テロダクティル(絶滅した翼竜の一種)
unstimulated	刺激されていない
rive	裂く|割れる
lemming	レミング(極地帯に住む小型のネズミ|大量繁殖で有名)
pigskin	〈U〉豚の皮;豚のなめし皮|〈C〉《米話》蹴球のボール(football)
lanai	ベランダ
typesetter	植字工|植字機
disputatious	論争(議論)好きな
nonfederal	非連邦(の)
dialectician	弁証法論者
grapnel	(また grapple|grappling hook|grappling iron)(複数のかぎや締め具のついた)固定具|引っ掛けかぎ|四つ爪(つめ)いかり(3本以上の爪のある小いかり)
megalopolis	メガロポリス(いくつかの大都市と隣接する複数の都市から成る大都市圏)
commingle	混ざり合う
ironist	皮肉屋
transmigrate	〈魂が〉他の肉体に転生する
calumet	カルメット(北米インディアンが和解の印としてタバコを回し吸いする長い飾りパイプ)
chrism	聖香油(教会で洗礼などの儀式に用いる油)
crooner	低い声で感傷的に歌う歌手|クルーナー
coliseum	大競技場
desuetude	廃止[状態]|不用
flyaway	(髪や服が)風になびく|風にゆれる
enthrall	魅了する|夢中にさせる
cannily	慎重で抜け目なく
dooryard	玄関の前庭
provolone	プロバローニ(芳醇(ほうじゅん)なイタリアチーズ)
catarrhal	カタル性の
humpbacked	ねこ背の|せむしの
mooch	(俗くそったれ|素人投資家|だまされやすい奴|バーゲン商品をあさる客|くすねる|ずる休みする|ねだる|ぶらつく|知らん顔をする
autoantigen	自己抗原
flatboat	(特に川の浅瀬で用いる幅の広い)大型平底船
slovenliness	だらしないこと|いいかげんさ
shirtfront	(特にノリをつけた正装用の)ワイシャツの胸部
whistler	(北米産)ロッキーマーモット
baccarat	バカラ|おいちょかぶに似たトランプ賭博
barbican	(城などの)物見やぐら|外堡(ほ)
jacuzzi	ジャグジー
lox	鮭の薫製|スモーク･サーモン
selectman	(米国New Englandでの)都市行政委員
sedulous	勤勉な|よく働く
unhinge	乱す|狂乱させる|蝶番(ちょうつがい)をはなす|混乱させる
mazurka	マズルカ(ポーランドの軽快な4拍子のダンス)|マズルカの曲
reverberant	反響する|鳴り響く
waviness	波立ち|波形
bluebell	空色のつり鐘形の花をつける植物の総称;スコットランドのイトシャジン|米国のハマベンケイソウなど
flagellate	鞭毛(べんもう)のある;鞭毛状の|〜‘を'むち打つ
hardhearted	無情な|冷酷な
planetesimal	微惑星体(太陽系生成時に互いとの衝突・合体によって原始惑星に成長する小天体)
peccadillo	ちょっとした過ち
extenuate	軽くする|酌量のする|軽くみなす|酌量する|軽減する
boaster	自慢屋|ほら吹き
barnstorm	芝居の地方巡業をする|《米》地方遊説する
highchair	脚の高い幼児食事用いす
voile	ボイル(木綿・羊毛・絹・レーヨン製の薄織物)
madden	(人を)発狂させる|激怒させる
durably	長持ちして|永続的に
monkfish	アンコウ|(=anglerfish)
midseason	中間期(スポーツなどの|=mid season) cf|high season|low season
outcaste	(インドで人が)社会的地位のない
sarsaparilla	〈C〉サルサ[パリラ](中国米に産するつる植物)|〈C〉サルサ根(薬用・シロップの香料に用いる)|〈U〉〈C〉サルサ[パリラ](サルサ根の香料人り清涼飲料)
whirligig	回転するおもちゃ|回転木馬|回転運動|変転|ミズスマシ
repackage	再パッケージ化
spermatozoon	精子|精虫
orison	祈り
protract	(時間的に)〜‘を'長引かせる
gadgetry	(家庭用などの)小道具･機械類|(器具類の)がらくた
indelicacy	〈U〉下品|野卑|無作法|〈C〉下品な言動
picnicker	ピクニックする人|行楽者
ragout	ラグー(野菜と肉や魚の煮込み料理)
dulcimer	ダルシマー|小さなハンマー(槌)で打って発振する台形の弦楽器
horseracing	競馬
spiffy	きちんとした|気のきいた|スマートな|しゃれた
tumescent	腫れた
pinecone	松かさ|松ぼっくり
autosuggestion	自己暗示
dinette	(家の中の)小食堂
cycloid	円形の
gasworks	ガス工場|ガス製造所
heedful	用心深い;(〜に)気を付ける《+『of』+『名』》
reft	(〜を)奪われて|失って《+『of』+『名』》
seismograph	地震計
coverall	すっぽりと覆うもの|つなぎ|赤ん坊のひとつなぎの服|全般的な|包括的な
ampersand	(ˈæmpɚs`ænd)アンパサンド(&の記号)
harridan	意地悪ばばあ|鬼ばば cf|hag
gibbon	ギボン|テナガザル
kerfuffle	騒動|言い争い(about)
pfft	(物が消えるさまを表し)パッ|フッ|(失敗を表し)ポシャッ
ribozyme	リボザイム|リボ核酸 (RNA)の一種で|触媒としてはたらく酵素の名
squareness	方形|四角;直角であること|公正|正直;きちょうめん
airstrike	空爆|空からの攻撃|航空ストライキ
fandango	ファンダンゴ(スペインの陽気な舞踏)
farina	穀粉|粉末|花粉
housefly	イエバエ
oxcart	牛車
synergize	相乗作用を与える
bannock	《英・スコットランド》バンノック(オートミールを主体にした菓子パン;米ではトウモロコシを用いる)
canaille	下層民|烏合(うごう)の衆|愚民
anticline	背斜褶曲(しゅうきょく)(岩石層が中軸より左右側に下方傾斜した地層構造)
barberry	メギ(赤くて細長く酸味のある実をつける低木)
forepart	(ある物の)前部;(ある期間の)初めの部分《+『of』+『名』》
friary	(托鉢(たくはつ)修道士の)修道院
twopenny	2ペンスの|安っぽい|つまらない
bollard	《英》(街路中央にある横断着用)保護柱|繋船(けいせん)柱|(街路にある車通行禁止を示す)柱
carpetbag	じゅうたん地で作った古風な旅行かばん
grippe	インフルエンザ(influenza)
tailless	尾のない
tonneau	トンノー(昔の自動車の後部座席)
woodcarving	木彫術|木彫り
curlicue	渦巻き形の飾り書き|装飾的な渦巻き
envenom	〈特に武器〉‘に'毒を塗る|〜‘を'憎しみで満たす
fannish	ファン心理|(反) unfannish
inkblot	インクのしみ
copayment	患者負担金
matchbook	マッチブック(二つ折りの携帯用はぎとり式マッチ)
colorist	カラリスト|彩色者
joyride	車をブッ飛ばすこと
navigability	(川・海などの)航行可能(性)
squally	突風の吹く|荒れ模様の|《話》形勢が悪い;不穏な
plonk	どすんと落ちること
dissimulate	=dissemble
monthlong	1カ月
submariner	潜水艦乗組員|アンダースロー|下手投げの投手
breadcrumb	パンの中の部分
matzo	マツォー|種なしパン
nara	奈良(日本の古都)
pinhead	馬鹿|間抜け|ピンの頭|つまらない物|まぬけ
stratus	層雲
colocalization	同時局在|共局在性|共局在
microdissection	顕微解剖
throatily	のど(しわがれ)声で
otolaryngology	耳鼻咽喉(いんこう)科(学)
retroflex	そり返った|反転音の(舌先を上にそらせ発音する)
festoon	花づな|花綱(で飾る)
calumniate	〜'を'中傷する|'を'悪口を言う
firth	河口|入り江|湾
inapt	不適当な|適切でない;(〜に)適さない《+『for』+『名』》|《補語にのみ用いて》(〜が)へたな|不手際な《+『at』(『in』)+『名』》
cataleptic	強梗(硬)症の|強梗(硬)症患者
melodramatically	メロドラマ風に
embezzle	着服する|使い込む|横領する
dearness	高価|親愛
panchromatic	(写真のフイルムなどが)全整色の|全色の|パンクロの
underfloor	(特に暖房装置が)床面下施工の
krone	クローネ(デンマーク･ノルウェーの通貨単位)
adversative	反対の意味の|対照を表す
congressionally	議会
myoblast	筋芽細胞(筋線維を形成する)
anesthetize	麻酔する
unseal	〜‘の'封を切る|‘を'開封する;〜‘を'開く(open)
foursquare	(特に建物が)正方形の|断固たる
impassivity	無表情|無感動|無神経
nabob	(18‐19世紀のイギリスで|アジアでもうけた)大金持ち;《軽べつして》大尽;お偉がた
nightstick	(米語)警棒
sericulture	養蚕|蚕業
scherzo	スケルツォ(おどけた調子の楽章)
topnotch	飛び切り上等の|第一級(一流)の
sparkler	線香花火
blepharitis	眼瞼(けん)炎(まぶたの炎症)
backflip	後ろ宙返りをする|バク転をする|態度をころりと変える|後ろ宙返り|態度の反転
alumna	(女子の)卒業生|(pl|alumnae)
backslide	(悪い方へ)後戻りする
bellybutton	へそ
mudslide	土砂崩れ
dactyl	(古典詩の韻律で)長短短格(‐);(英詩の)強弱弱格(‐‐‐)
countrified	(人が)いなかじみた|やぼな|(けしきなどが)ひなびた
diacritic	=diacritical|=diacritical mark
pilaster	ピラスター|柱形|付け柱|片蓋柱
alb	アルバ(司祭がミサで着る祭服)
buggery	=sodomy
birthstone	誕生石(生まれ月の星座にちなんだ宝石)
executrix	女の遺言執行者
ironstone	鉄鉱石|白色硬質陶器
indorse	=endorse
dewlap	(牛などの)のど袋|のどの皮膚のたるみ
evensong	(英国国教会の)夕べの祈り|晩祷(ばんとう)
loge	(劇場の)仕切席|特別席
pocketful	《a~》ポケット一杯(の〜)《+『of』+『名』》|たくさん(の〜)《+『of』+『名』》
titbit	=tidbit(うまい物の)ひと口; おもしろいニュース)
loupe	拡大鏡|ルーペ
mescal	〈C〉メスカル(アメリカのテキサス州および北部メキシコのサボテン)|〈U〉〈C〉メスカル酒(リュウゼツランの発酵汁を蒸留して造った酒)|〈C〉〈U〉(メスカル酒を造る)リュウゼツラン
rambler	＜ramble|ぶらぶら歩く人|ツルバラ
freeholder	土地・不動産自由保有権者
emote	感情を表に出す
gobbler	雄の七面鳥
pimpled	=pimply
peaky	峰のようにとがった|衰えた|やつれた|《話》気分が悪い
turbofan	ターボファン(ジェット推進機関の一種)
autodidact	独学者
transvestism	服装倒錯(同性愛者などが異性の服装をすること)
blueish	= bluish
sifter	調査官|ふるい|ふりかけ器
sirocco	シロッコ(北アフリカから南ヨーロッパ地方に吹きつける乾燥したほこりっぽい熱風)|(一般に)うっとうしい熱風
unguent	軟こう;こう薬
alongshore	海岸に沿った|磯(いそ)伝いの|海岸沿いに
cloudburst	(突然の)穀雨|どしゃ降り
chemiluminescent	化学発光
chromosphere	彩層(太陽の周辺を取り巻いている白熱ガスの層)|恒星を取り巻くガス層
shrillness	(声の)甲高さ|鋭さ
besmear	(〜で)〜'を'べたべたに汚す《+『名』+『with』+『名』》
misconstruction	誤解|意味の取り違え
oxbow	牛のくびきのU字型の部分|《米》川の湾曲部
birdseed	つぶえ(小鳥のえさ)
proband	発端者
stevedore	沖仲士|沖仲仕
bulrush	《米》フトイ|《英》ガマ(水辺・沼にはえる植物)
fluoridate	(虫歯を防ぐために)〈飲料水〉‘に'フッ化物を入れる
fuddle	(ウイスキーなどで)〈人|人の意識〉‘を'もうろうとさせる|意識がもうろうとすること|思考の混乱
imperturbability	容易に動じない|落ち着いた|冷静な|落ち着き
neutralism	(外交問題などの)中立主義政策
polecat	ケナガイタチ(ヨーロッパ産の肉食動物;攻撃されると悪臭のある液体を出す)|《米話》スカンク(skunk)(北米産)
unfathomed	測り知れない|深遠な
toupee	(はげ隠し用)男性かつら
untidily	だらしなく;無精に;乱雑に
demographer	人口統計学者
assumptive	仮定の|推測の|生意気な
moneymaker	儲け仕事|金儲けのうまい人|蓄財家
salesgirl	女店員
bacteriologist	細菌学者
horticulturist	園芸家
blear	(涙などで)目がかすんだ|曇った(blurred)|(涙などで)〈目・視力〉'を'かすませる(blur)
acerbity	〈U〉渋味|にがさ|〈U〉〈C〉辛らつさ
calibrator	内径(目盛り)測定器
cere	蝋膜(ろうまく)|ろうびき布で包む
daemonic	=demonic
gewgaw	安ぴかもの|見かけ倒しのもの|安ぴかの|見せかけだけの
citronella	〈U〉〈C〉シトロネラ(南アジア産の植物;石けんなどの香料となる)|〈U〉シトロネラ油
filarial	糸状虫の|フィラリアの
financing	融資
scansion	詩を韻律分析して音脚に分けること
septuagenarian	70歳[代]の人|70歳[代]の
cryptogram	暗号;〈C〉暗号文
flatfoot	(複flatfeet)偏平足|《俗》(複flatfoots)巡査
revivify	〜‘を'よみがえらせる|再び元気づける
scandalize	あきれさせる|あきれる|(人を)憤慨させる
filch	くすねる
honcho	長|親方|ボス・日本語の「班長」が語源
meadowsweet	シモツケソウ(白またはピンクの花をつける)
micronized	微粉化
obit	葬儀|死亡記事|命日
riptide	潮衝(他の潮流と衝突して激潮を起こす潮流)
granulate	〈砂糖など〉‘を'粒[状]にする|〈紙・革など〉‘の'表面をざらざらにする|粒[状]になる|表面がざらざらになる
arraign	(法廷に呼び出して)〈被告〉‘に'起訴事実の認否を問う|《文》〈言動など〉'を'とがめる|糾弾(きゅうだん)する;(〜に関して)〈人〉'を'とがめる|非難する《+『名』+『for』+『名』》
deckchair	甲板いす
hereabout	このあたりに
pitiably	哀れに
schoolmarm	(古いタイプのまたは田舎の)女教師|教師じみた|堅苦しい|物知り顔の人
bigamist	重婚者
chippy	フィッシュアンドチップスの店|chipmunk(シマリス)の愛称|chipping sparrow(小スズメ)の愛称|大工|あばずれ女
earmuff	耳おおい
eulogistic	(演説・文章が)賞賛の|ほめたたえる
zilch	(俗)ゼロ|無
toady	ごますり(人)|ごまをする
uncouple	〈連結したもの〉‘を'離す
elvish	=elfish
cumber	(〜で)〈人〉'を'じゃまする|‘に'負担をかける《+『名』+『with』+『名』》
ranchman	=rancher
unshod	《文》(人が)靴をはいてない|はだしの|(馬が)蹄鉄を打ってない
sadhu	(ヒンズー教の)聖者
screwy	らせん状の|搾取する|(口)変な|気が変な
abjuration	宣誓して放棄すること
moleskin	モグラの毛皮|モールスキン(昔|衣服・帽子を作ったじょうぶで滑らかな綿布)
spittoon	=cuspidor
mutagen	突然変異原|突然変異誘発物質
villein	(中世の)農奴
bowlful	(〜の)どんぶり(はち・わん)1杯[の量]《+『of』+『名』》
interscholastic	(特に中学校・高校)学校間の|対校の
personalty	=personal property
hayfield	干し草畑
sideward	横の|横向きの・(また『sidewards』)横に(へ)|横向きに
inquietude	不安|心配
spikenard	〈C〉カンショウ(甘松)(根から香料をとる芳香のある植物);〈U〉(その根からとった)甘松香|〈C〉(北米産の)ウド
laburnum	キングサリ(マメ科キングサリ属の有毒な小さい木)
chasuble	上祭服(ミサで司祭が着る袖のないゆったりした祭服)
garishly	派手に|けばけばしく
sockeye	紅鮭|sockeye salmon
confrere	(仏語)会員|同僚
geodesy	測地学
hous	ハウジング
uncharacterized	特徴付けられていない
wherefrom	[そこから]〜するところの(from which)
immunocytochemical	免疫細胞化学的な
presbyterian	長老派の人|長老派の信徒
catalpa	キササゲ類の植物(北米・アジア産)
pictograph	絵文字|象形(しょうけい)文字|ピクトグラフ|統計画(数字の代わりに絵や図を用いて表す)
bowlder	=boulder
seclude	(〜から)〈人〉‘を'引き離す|孤立させる《+『名』〈人〉+『from』+『名』》
beatnik	ビート族の若者|ビート族の人|服装や行動が突飛な人
contumacious	反抗的な|がんとして命令をきかない
dotard	もうろくした人
ensouled	ensoulの過去分詞(に魂を吹き込む|を心にとどめる)
heparinized	ヘパリン(抗凝結成分)化された cf|heparin
presumable	仮定(推定)できる|ありそうな(probable)
messmate	(軍隊の)食事仲間|同宿同飯の友
passbook	銀行通帳(bankbook)
perjure	偽誓する
loanword	外来語|借用語
cattail	ガマ(沼地に生える背の高いアシに似た植物)
immunoblotting	免疫ブロット法
deathblow	致命的打撃|(〜を)終結させるもの《+『to』+『名』》
hellion	乱暴者|無法者・乱暴者・わんぱく・いたずらっ子
immunocytochemistry	免疫細胞化学
julep	=mint julep
teetotal	絶対禁酒[主義]の
altruist	利他主義者
everytime	毎回
flab	ぶよぶよ|ぜい肉
radioman	無線技師
corselet	胴よろい|コルセレット(ブラジャーがついて胸を締めるコルセット)
necrophilia	死体姦(かん)症(死体に性的魅力を感じること)
transitively	他動詞的に|他動詞として
withholding	差し控え
boomtown	《米》新興都市
doorstop	戸止め|戸当たり金具
nullah	(インドで大雨の後などにできる)水路
expertness	練達
gluey	にかわ質(状)の|にかわのようにねとねとする
refractor	屈折媒体(レンズ)|=refracting telescope
officeholder	公務員
hijacker	乗っ取り犯人
bouillabaisse	ブイヤベース(魚・エビ・トマト・サフランなどをオリーブ油でいため|水を加えて煮たフランス風寄せなべ)
enjambment	句またがり(詩韻律である行の意味・構文が次の行に続くこと)
amorality	超道徳性;道徳意識の欠如|不道徳
tetanic	＜tetanus|破傷風の
cox	舵手|舵取り
declarer	宣言者|申告者
imputable	負わせられる|帰せられる;(〜を)負わせられる《+『to』+『名』》
straightjacket	=strait jacket
urodynamic	(医)尿力の|尿力学|尿動態
muddleheaded	(人・議論などが)混乱した
savageness	残忍;野蛮|未開
ringlet	小環|(長い)巻き毛
fantail	扇形の尾(部分)|クジャクバト(扇形の尾を持つハト)
portraitist	肖像画家|人物写真家
bottler	瓶詰め業者
ownerless	持ち主のない
downswing	ダウンスイング(ゴルフのクラブを振り降ろす動作)|(商況・出生率などの)下降|減少
scrofulous	るいれきの;るいれきにかかった
undercoat	(動物の長い毛の下の短い)下毛|(仕上げ塗り前の)下塗り
fanfic	二次創作
footpad	追いはぎ|(月に着陸するための)宇宙船の脚部
homiletics	説教術(法)
birdbath	(庭などに設けた)小鳥の水浴び盤
rotundity	丸々と太っていること|(声が)朗々としていること
straitlaced	(道徳や作法が)非常に厳格な|堅苦しい
firebomb	焼夷弾|火炎ビン|発火物|焼夷弾(火炎ビン･発火物)を投げ込む
popover	軽焼きマフィン・(軽い焼き菓子の一種)
wassail	(もと英国で用いた)乾杯のあいさつ|《おもに文》酒宴|酒盛り|乾杯する;酒盛りする|〜‘に'乾杯する
adulterate	(粗悪なものを)〜‘に'混ぜて品質をおとす《+『名』+『with』+『名』》
foxtrot	社交ダンスの一種|Foxは創始した米人の名|foxtrotはphonetic alphabetのfに使われるほど著名
groundhog	マーモット(marmot)|ネズミに似た動物
sapper	工兵隊員|敵前工作兵
anklet	(靴の)留め革|足首までの短いソックス
spay	卵巣を取り去る
poinsettia	ポインセチア
overspill	(都心が過密で)郊外に移る人々;(都市の)過剰人口
squeegee	とんま|まぬけ|ゴムぞうきん|スキージ|抜作|にゴムぞうきんをかける|ゴムぞうきんでふき取る
vicegerent	(王・最高長官の)代理人|名代
wallboard	壁張り用材
dishrag	=dishcloth1
haricot	インゲン豆
dogmatist	(キリスト教の)教義学者|独断する人
detractor	中傷者|けなす人
uncoil	〈巻いたもの〉‘を'ほどく|解く|ほどける|解ける
bursary	(大学などの)会計課|奨学金(scholarship)
moll	情婦|売春婦
ligate	(強く)縛る|ligate the artery動脈を結紮(ケッサツ)する
profiteer	暴利をむさぼる人
hewer	(木・石などを)切る人採炭夫
pointblank	(射撃など)至近距離からの|直射の|至近距離の|あけすけな|至近距離から|直射で|あけすけに
variegation	(特に植物の)多彩な色合い|雑色|まだら
poltroon	腰ぬけ|おく病者|ひきょう者
semiprecious	準宝石の
grabber	ひったくり|欲張り者|人の心を強くとらえるもの|度胆を抜くもの
paramedical	(看護婦・衛生兵などとして)医療の補助をする
pizzicato	ピチカートの(弦楽器の弦を指ではじく奏法)|ピチカートで|ピチカートで演奏される部分
striver	努力する人|戦う人
counterfeiter	にせ金造り;偽作者
astrobiology	宇宙生物学(exobiology)
organza	オーガンザ(薄いレーヨン・ナイロン・絹の平織物)
myrmidon	(王の)家来|忠僕;手先|子分
bedizen	(〜で)〜'を'ごてごて飾りたてる《+『名』+『with』+『名』》
bootblack	(街頭の)靴みがき
dexter	右(側)の|(盾の紋地の)右側の(向かって左|(反)sinister)
euphony	音調のよさ
incommode	〈人〉‘を'困らせる|‘に'迷惑をかける;〜‘の'じゃまをする
penology	刑務所学(刑務所の機能や管理について研究する)
carillon	組み鐘|カリヨン|鐘楽曲
carryall	大きな手さげ袋|(数人乗りの1頭立ての)四輪馬車|乗合バス
deadliness	致命[致死]的なこと・死にかかわること;死の状態
dotty	馬鹿な
molly	人気がある観賞魚(グッピーの異表記)
karat	カラット(金の純度を表す単位;純金を24カラットとする;《略》『k.|Kt.』;《米》ではおもに金にはkaratを宝石にはcaratを用いるが|《英》では宝石・金のいずれもcaratを用いる)
courtliness	上品さ|礼儀正しさ|尊厳
gazpacho	ガスパーチョ|スペイン料理とポルトガル料理の冷製スープ
luff	船首を風上へ向ける
pterosaur	テラソー(翼竜;現在絶滅している)
transmogrify	(魔法のように)姿･性格を一変させる
titillate	くすぐる(=tickle)
cowpuncher	=cowboy
paramountcy	最高位;(〜の)最上|至上《+『of』+『名』》
shuffleboard	シャッフルボード|銭はじき
neurotrophin	ニューロトロフィン|神経栄養因子として|神経細胞の生存|発生|機能に必要とされるタンパク質
ummm	うーん
culpably	不届きにも|けしからんことに
easterner	東部地方の人
thermosphere	温度圏(温度が高さとともに上昇していく地上80Kmより上部の大気圏)