warthog	イボイノシシ
toiler	働き者;労働者
chimneypiece	=mantelpiece
deuteron	重陽子(重水素の原子核)
electrodynamic	電気力の;電気力学の
godchild	名付け子(洗礼で名付け親から名を付けられる子)
insole	靴の敷き皮
arnica	〈C〉アルニカ(キク科の植物)|〈U〉アルニカチンキ(アルニカの花・根を原料とする打撲・捻挫(ねんざ)の治療液)
adenoviral	アデノウイルスの
pilothouse	(船の)操舵(そうだ)室
menstruate	生理がある
cultist	熱狂的な人|狂信者
whew	ひゃぁ!|ヒャア|ヘエッ
autobiographer	自叙伝作者
chickweed	ハコベ(白い小さな花の咲くナデシコ科の低木)
orthopedist	整形外科医
proclaimer	(公式の)宣用者|公布者|言明者
scintilla	微量(の〜);(〜の)気味《+『of』+『名』》
sightsee	観光旅行をする|見物する
blackball	〈人が組織の一員になること〉‘に'反対投票する|〈人〉'を'排斥する|村八分にする|反対投票[古代ギリシアで黒い球で反対の意を表したことから]
scrollwork	うず形装飾|雲形模様
windage	弾丸に与える風の影響|偏流|(弾丸の)偏流度
fishtail	(車の後部などが)左右に横滑りする|(飛行機が)尻振り滑空する
baldric	(昔の)飾り帯(剣・角笛などをつるすために肩から腰へ掛ける皮帯)
dandify	〜'を'めかしこませる
reposeful	安らかな|平隠な|落ち着いた;ゆったりした
marquetry	(家具などの)はめこみ細工|象眼細工|寄せ木
radiogenic	放射能物質の崩壊で生じた
brouhaha	(brúːhɑːhὰː)|世論の沸騰|大騒ぎ
godhood	神格|神性
mesosphere	中間圏(地表約40から80キロメートルの所に広がっている大気層)
mansard	(またmansard roof)マンサード屋根|二重こう配屋根|マンサード屋根下|屋根裏部屋
discography	ディスコグラフィー|椎間板造影(法)
appal	=appall
chromo	多色石版刷りの絵
saguaro	サグワロサボテン(非常に大きなサボテンで|アメリカ合衆国西南部・メキシコに産する;白色の花をつけ|実は食用となる)
underdone	(食べ物が)生煮えの;(肉が)生焼けの
traduce	《文》〈人・性格など〉‘を'非難する|中傷する
wiener	ウィンナソーセージ(語源|Vienna|Austria)|フランクフルト|ホットドッグ
backstroke	打ち返し|逆手(さかて)打ち|(またback crawl)背泳
cliche	(陳腐な)決まり文句|月並みな考え
dinnerware	食器類
hatpin	婦人帽の留め針
underthings	女性用下着(underclothes)
dishearten	落胆させる
farrago	寄せ集め|ごたまぜ
indestructibility	破壊できないこと|不滅
presbyopia	[老人性]遠視|老眼
cauterize	(医)(傷口などを)焼灼(しょうやく)する|(良心･感情)まひさせる
bambino	赤ん坊|幼い子|幼いキリストの像(画)
litchi	レイシ(中国産の常緑小高木)|レイシの実(薄皮の白い実で甘い)
mewl	赤ん坊の泣き声|弱々しく泣く
backwoodsman	(米国・カナダなどの)辺境の未開拓地の住人;奥地の人
funfair	移動式遊園地|=amusement park
merchantable	販売用の|売り物になる
scummy	浮きかすの多い|下等な
troopship	軍隊輸送船
buss	(愛情表現)キス|キスをする
altruistically	利他的に
fingerboard	(弦楽器の)指板
harrumph	(わざとらしく|または異議を表明して)咳払いする|ぶっきらぼうに示す
uhh	うう
bloodsucker	吸血動物|ヒル(leech)|搾取者|高利貸し
maraca	マラカス(リズム楽器)
monomaniac	偏執狂[者]
stayer	根気強い人(動物)|がん張り屋
nasturtium	キンレンカ(黄や赤の花をつける園芸植物)
mickey	元気|誇り|ジャガイモ|をからかう|侮辱する|いじめる|ぺしゃんこにする
rheostat	加減抵抗器
solipsist	唯我論主義者|自己中心主義者
pannikin	《英・オーストラリア》パニキン(金属製の小さなカップ)
rearmost	最後尾の
reviser	校閲者|監修者;校正をする人|再履修者
bourse	(特に欧州の)株式(証券)取引所|金融市場
emptily	むなしく
novelette	感傷的な中編小説
illusionism	迷妄(めいもう)説(物質世界は錯覚にすぎないとする哲学論)|(目を惑わすための)だまし絵技法
pastern	繋(けい)(牛・馬などの脚のくるぶしとひづめとの間の部分)
tailcoat	燕尾(えんび)服
lade	〈特に|荷など〉‘を'積む|〜‘を'ひしゃく(スプーン)ですくう|荷を積む|ひしゃく(スプーン)ですくう
coloratura	コロラチューラ(声楽の装飾的高音部)|〈C〉コロラチューラソプラノ歌手
antipodean	(にとって)対蹠地の|(と)正反対の(to)
effendi	エフェンディ(トルコなどで用いた男性の敬称)
northeastward	北東へ(に)|北東の;北東へ向かう|北東;北東部
personate	(劇などで)〜‘の'役を演ずる|(だますため)〜‘の'ふりを装う|‘に'なりすます
halftone	〈U〉(美術・写真などの)暗部と明部との間の階調;中間調(色)|〈C〉(写真印刷の)網版(あみはん);網版画|半音
pullet	(1年未満の)めすのひな
acclivity	《まれ》上り坂
drier	ドライヤー|乾いた
formfitting	(衣服が)身体にぴったりと合った
jeremiad	(長い間の)悲嘆|恨みごと
myofibroblast	筋線維芽細胞
spacewalk	宇宙遊泳|宇宙遊泳する
besmirch	《文》〜'を'汚す
casuistic	決疑論的な|詭弁的な
flunkey	=flunky
tetrameter	四歩格(詩脚(foot)が四つある詩行)
allopatric	異所的な|異所的種分化(ギリシャ語allos=other|patris=fatherland)|同じ生物学的集団に発生する隔離的な種分化
bongo	ボンゴ(大小2つの片面太鼓をつなぎ合わせた打楽器|bongo drum)
jacaranda	ジャカランダ(熱帯アメリカ産の樹木)
intermix	混ぜる
anteater	アリクイ|ant-eater
arrack	アラック酒(東インド諸島などの強い蒸留酒)
oryx	オリックス(アフリカ産の大カモシカの種)
thistledown	アザミの種子の冠毛
beastie	小動物
dino	ディノ|恐竜(の)
styrofoam	スタイロフォーム(発砲スチロールの一種)
trinomial	三項[式]の|三項式
huffily	腹を立てて
nacre	=mother-of-pearl
ouzo	ウーゾ|ブランデーにアニス(地中海産のセリ)の香りをつけたギリシアの無色のリキュール
sphygmomanometer	血圧計|脈圧計
calve	〈雌牛が〉子を産む|〈氷河・氷山などが〉一部分離する
guidepost	道標|道しるべ|指針|指標
reredos	(教会の祭壇背後の)飾り壁|飾りつい立て
involucre	(花の茎部にある)総包|外被
legionnaire	《しばしばL-》米国在郷軍人会員|軍団員
quadripartite	4部から成る|四者間の
irenic	平和に資する|平和的な|協調的な
aerobe	好気性生物(空中の酸素を必要とするバクテリア類)
prat	まぬけ|ばか
corky	コルクの[ような]|《俗》元気のよい|浮かれた
plectrum	(ギター・マンドリンなどをひくための)つめ|ピック
borscht	ボルシチ|牛肉をビーツ･タマネギ･にんじん･キャベツなどの野菜で煮込みサワークリームを添えて食するロシアの煮込み料理
cosiness	=coziness
dextrous	=dexterous
mustachio	《複数形で》大きな口ひげ
semiprivate	(病室など2|3人で共有の)準個室の|半私用の
spinsterhood	(婦人の)独身|未婚
bouffant	フワフワした髪型|ふっくらした|膨れた|ダブダブした
elfish	小妖精のような;いたずらっぽい
metatarsus	中足(人間の足の|足首からつま先までの部分で5本の骨から成る部分;四つ足動物の後足|鳥の足の同じ部分)
openhearted	率直な|親切な
poisoner	コック|料理人|害毒を与える人|毒を使って害を与える者|毒殺者
umbel	散形花序
animatronic	アニマトロニクス(ロボットや機械を利用し|人の動きを再現すること)
scuttlebutt	(ˈskʌtəlbʌt)|うわさ|ゴシップ|飲料水入れ|水飲み場|噴水式水飲み|大樽
avirulent	無毒の
gusher	噴油井|しゃべり立てる人
condemnable	非難すべき|とがめるべき
workingwoman	働く婦人|(女の)労働者|女工員
plagiarize	盗用する|剽窃する|盗作する|人の文章などを盗む
debouch	(狭い所から広い所へ)流れ出る|抜け出る《+『into』(『on』)+『名』》
immunofluorescent	免疫
quoit	《複数形で》《単数扱い》鉄輪投げ|〈C〉(鉄輪投げの)鉄輪　尻の穴
ideogram	表意文字
catchup	ケチャップ|ketchup
hornpipe	ホーンパイピの踊り(特に水夫が一人で踊る);その舞曲
idiolect	(文法)個人言語(一個人のある一時期における発話の総体|習慣)
pensionable	年金(恩給)をもらう資格のある
auriferous	(岩石が)金を含んだ(産する)
henbane	〈C〉ヒヨス(ヨーロッパ産の毒草)|〈U〉ヒヨスの毒
lifework	一生をかけた仕事|ライフワーク
runaround	(the runaround)言い逃れ|run around(好ましくない人物と)つき合う|浮気する
foldout	(雑誌などの)折り込み写真
sadistically	加虐的に
pupate	〈幼虫が〉さなぎになる
lyceum	〈C〉《米》(演説・音楽会などを催す)文化運動団体|〈C〉(上記の催し物を行う)文化会館|《the『L-』》リュケイオン(アリストテレスが哲学を説いたアテネ郊外の学園);アリストテレス学派
gawp	(口を開けて)(〜を)ぽかんと見詰める《+『at』+『名』》
ampule	(注射液を入れる)アンプル
doofus	とんま|間抜け|へんてこな
petard	(ベル形の)小型爆破道具(城門・城壁などを破るにの用いた)・(城門破壊用)爆薬; 爆竹
resister	抵抗する人
asphodel	アスフォデル(白・ピンクまたは黄色の花をつけるユリ科の植物)
doggone	忌まわしい|いまいましい|嫌な|ばかげた|呪うべき|呪う
trivium	(古代ローマの)三学科(七教養科目のうち文法・修辞学・論理学を指す)
quintuple	5倍の|5重の;5部(5人)からなる|5倍|5倍の量(数)|5倍になる|〜‘を'5倍にする
caitiff	《古》卑劣な人|卑怯者
comedown	(地位・身分・名誉などの)失墜|下落|零落
histochemistry	組織化学
ytterbium	イッテルビウム(希土類元素;化学記号は Yb)
conceptus	受胎産物 (胎児と胎盤の総称)
flytrap	ハエトリソウ
bleeder	多量に出血しやすい人.(特に)血友病患者|出血素因者
commonweal	公共の福利(福祉)
conterminous	隣接する|(時間・空間が)同一限界の
homodimer	ホモダイマー|ホモ2量体(生化学)
fundraise	資金集め
agitprop	アジテーションとプロパガンダ|アジ宣伝の
bunting	旗布|(慶祝などのための)細長い旗|吹き流し|まん幕|(主に米)(乳児用の)おくるみ|ホオジロ類の小鳥
taw	はじき玉|びー玉|(はじき玉遊びの)基線
landslip	=landslide1|2
mispronunciation	発音の誤り|誤った発音
palmate	(葉などが)手のひらの形をした
rutabaga	(植)カブハボタン|その根(食用)
truculence	凶暴|残酷;好戦性
klaxon	クラクション(自動車の警笛)[の音]
mistranslate	〜‘を'誤訳する|誤訳する
lacerate	(lˈæsərèɪt)引き裂く|引き裂かれた|裂けた
dissuasion	(説得して)思いとどまらせること
monochorionic	絨(じゅう)毛
minestrone	ミネストローネ(肉・野菜・パスタなどを入れて煮たスープ)
rube	田舎者|青二才|世間知らず|ばか|まぬけ|お客|見物人|新参者|新米|田舎の
bumptious	傲慢な|横柄な|でしゃばりの
corrugation	〈U〉波形にすること;波形のついた状態|うね状|〈C〉(波形を構成する)うね|溝|しわ
capitulum	小頭(長い骨や触角などの先端のふくらんだ部分)
scabrous	ざらざらした|でこぼこの|わいせつな|きわどい
turbojet	タービン式噴射推進機関(turbojet engine)|ターボジェット機
alterable	変えられる|改められる
entreatingly	懇願するように|おりいって
vl	Vulgar
burble	さらさら音をたてる
curbstone	(歩道の)縁石(《英》kerbstone)
eeriness	無気味さ|気味悪さ
euphonious	響きのいい|耳に快い|口調のよい
coexpression	共発現
loudmouth	大声でしゃべりまくる人|大口を叩く奴|ほら吹き|弁護士|に偉そうな口をきく
tousle	〈髪など〉‘を'乱す|もつれさせる
confab	談笑|会談(する)
hassock	(お祈りのときに使う)ひざ布団|草むら(tussock)
hogan	ホーガン|北米インディアンNavaho族の住居
anaerobe	嫌(けん)気性生物(空気・遊離酸素を必要としない細菌類)
hickey	にきび|あざ|キスマーク(和製英語)|継ぎ手|あれ|例のやつ
pedigreed	血統の正しい;由緒(ゆいしょ)のある
surmountable	(困難・障害などが)克服できる;乗り越えられる
longshoreman	港湾労働者
babbler	片言をいう幼児|おしゃべり屋
calaboose	刑務所
mach	マッハ
miserliness	しみったれ|けちなこと
bellyful	(〜の)腹いっぱい|十分《+『of』+『名』》
enucleated	(生命科学)細胞から核を除去する|眼球除去する 他
fauces	口峡(こうきょう)(咽頭に続く口腔奥部)
maidenhair	アジアンタム(ハコネソウ・クジャクソウなどのシダ類)
runnel	小川(runlet)
prokaryote	原核生物|核膜が無い(区別出来る核を持たない)細胞(原核細胞)からなる生物|細菌類や藍藻類が相当する
bestest	最高のもの
coracle	ヤナギの枝を編み獣皮を張った小船;アイルランドやウェールズの川・湖で用いる
lockjaw	=tetanus
postmistress	女郵便局長
apparat	旧ソ連の政治機構
guppy	グッピー(観賞用のメダカ科の淡水熱帯魚)
finial	フィニアル|頂点|頂部装飾
captivation	魅惑
enfilade	縦射|〜‘に'縦射をあびせる
sidesaddle	横くら(両足を同じ側に下げる婦人用くら)|(馬に)横乗りに
wagtail	セキレイ
niggard	けちんぼ(miser)|=niggardly
paring	皮を剥くこと
petrology	岩石学
uncial	アンシアル書体の|アンシアル書体(4‐8世紀にギリシア・ラテンの写本に用いられた)
ossify	〜‘を'骨化させる|(骨のように)〜‘を'硬化させる|骨化する|(人・考え方が)がん固になる|融通がきかなくなる
excursionist	遊覧(周遊)旅行者
corso	大通り
exotically	異国ふうに
glissando	〈U〉グリサンド奏法(キイ・弦の上に指先をすべらせる奏法)|〈C〉グリサンド楽節|グリサンド奏法の(で)
gobbledygook	分かりにくい言葉|ややこしい言葉|お役所言葉|チンプンカンプン
sawyer	木びき
unintelligibly	分かりにくく|理解しがたく
basswood	=bass
houseboy	屋敷やホテルのボーイ(雑役夫)
indexer	索引作成者
incorrigibly	矯正できないぼど|根深く
helot	(古代スパルタの)奴隷|ばかにされる人
ravishment	うっとりさせること|《文》強奪|《文》強姦(ごうかん)
sweetish	やや甘い
tiebreaker	テニス･サッカーなどタイで終った場合勝敗をつけるため短時間のプレーを行うシステム
collegian	大学生(college student)
discoideum	キイロタマホコリカビ|細胞性粘菌の一種|分子生物学|遺伝学のモデル生物として|細胞間連絡|分化|アポトーシスの例として研究されている
stenography	速記|速記術(shorthand)
lawbreaker	法律違反者
bandolier	(兵士が肩からかける幅広の)弾薬帯|負い革
highfalutin	もったいぶった|大げさな
rotter	ろくでなし
yes	はい
swaddle	赤子を産着(細長い布)でくるむ|(to swaddle a baby)
trophozoite	栄養体
cerise	サクランボ色|淡紅色
frisbee	フリスビー
moa	モア|ニュージーランドに生息していた鳥類
misreport	《しばしば受動態で》〜‘を'虚報を伝える|‘を'誤って報告する
nard	甘松(かんしょう)香(古代人が用いた香油)
prognosticate	(知識・経験に基づいて)〜‘を'予知する|予測する;〈〜であること〉‘を'予知する《+『that節』》|〜‘の'前兆となる
piecrust	パイの皮
drowse	眠気がさす|うとうとする《+『off』》|ぼんやりしている|眠気
disinheritance	廃嫡(相続権を奪うこと);勘当
schoolchild	学童
interlink	〜‘を'つなぎ合わせる|連結する
gigabyte	ギガバイト
appanage	《文》(生まれ・身分・地位に付随する)財産|特権|役得|《文》特性|属性|《古》(王子・王女に与えられる)領地|扶持(ふち)
didactically	教訓的に|説教じみて
encyst	〜‘を'包嚢(ほうのう)に包む|包嚢(ほうのう)に包まれる
hairiness	毛深さ
outdistance	(競技などで)〈相手〉‘を'はるかに引き離す
clavichord	クラビコード(ピアノの前身であるけん盤楽器)
loutish	ぶこつな|無作法な
hematologist	血液学者
manometric	流体圧力測定器の(で測った)
seaway	航路|航行|(外洋船の航行できる)河川航路|荒海
temporariness	一時的なこと|はかなさ
yarmulke	ヤムルカ|ユダヤ教正統派の男性信者が教会や家庭でかぶる小さな頭布
debilitate	〈病気などが〉〈人・体〉'を'衰弱させる
bullring	闘牛場
bacchanalian	バッカス祭の|どんちゃん騒ぎの
skedaddle	あわてて逃げる|あわてて逃げること
juiciness	汁の多いこと|水分の多いこと
longwinded	息の長く続く|(話・文章などが)長たらしい|冗漫な
moxie	活気|精力|ファイト|ガッツ|技術(知識)
purchasable	買える|手に入る|買収されやすい
bustard	野ガン
plasmodium	マラリア原虫|変形体(アメーバ状の多核原形質体)
quantitated	定量の
spermaceti	鯨(げい)ろう(マッコウクジラの頭から取れる白いろう状の物質;ろうそく・化粧品などになる)
homophone	異形同音異義語
dibasic	(化学)二塩基性の
peculation	公金横領|官物私用
yardarm	(帆の)桁端(帆桁の両端)
driller	穴あけ機
agglutinative	膠着する|膠着性の
maser	メーザー(マイクロ波増幅器)
preliterate	(文化・社会などが)記録(文献)を保存してない
undersell	を控えめに売り込む|値引いて売る|より安く売る|不当に低く印象づける
clampdown	(突然の)規制取り締まり
avoirdupois	=avoirdupois weight(《略》『avdp』)
explainer	説明者
grenadine	(カクテル用)石榴のシロップ|赤黄色(の)
podgy	=pudgy
pogo	(音楽に合せ)飛び上がって踊る
phrasing	言葉遣い
upmost	最高の　最上の　一番の　最重要の　真っ先に　=uppermost
deb	スケ番|突っ張り娘 (debutanteの略)
lasciviously	みだらに|挑発的に
unquote	引用終わり
calcify	〜'を'石灰質にする|石灰化させる|石灰質になる|石灰化する
calfskin	子牛の皮|カーフ(子牛のなめし皮)
neurasthenic	神経衰弱の|神経衰弱症患者
orris	ニオイアヤメ(根茎に芳香のあるアヤメ)
daw	コクマルガラス(ヨーロッパ産の光沢のあるガラス)|=jackdaw
crozier	=crosier
offertory	(ミサ・聖餐(せいさん)式における)パンとぶどう酒の奉献|(教会の礼拝式で集められる)献金;(その時用いられる)祈とう文
oldish	いくぶん年をとった|やや年配の|古めかしい
predestinate	=predestine
plagiarist	盗作者
sermonize	小言を言う|説教する|説法する
hemorrhoid	痔(通例-s複数扱い) (=piles)
bidet	(仏語)子馬|婦人用洗浄器|ヴィデ
pneumatically	圧縮空気を含んで|圧縮空気の作用で
lysogenic	溶原性|ウイルス(Phage)が感染し|細胞膜を破壊された細菌がphageの形質を持つようになることをいう
polyadenylation	ポリアデニル化|RNAにポリA鎖(poly-A tail)を付加すること|遺伝子発現過程の一部であり|ポリA鎖はmRNAの安定性に関わる
juryman	陪審員(juror)
immolate	いけにえにする|犠牲にする
maleficent	害をなす|有害な
insatiably	飽くことなく|どん欲に
radiotelephone	無線電話|無線電話機
heckle	質問攻めにする|妨害する|野次り倒す|詰問する
frenetically	逆上して;熱狂的に
hairnet	ヘアネット
biparental	ふた親の|ふた親の特徴を合わせ持った
kickstand	キックスタンド(自転車・オートバイなどを倒れないよう支える装置)
rondo	旋回曲|ロンド
kulak	クラーク(ロシア革命以前の富裕な農民・商人)
sickbay	(通例船内の)病室
transfuse	〈血液〉‘を'輸血する:transfuse blood 輸血する
goofball	間抜け
hobnail	(靴の底に打つ頭の大きい)びょうくぎ
diapason	〈U〉(音声・楽器の)全音域|〈C〉ダイアペーソン(パイプオルガンの基本音栓(せん))
earthshaking	世界をゆるがす|非常に重要な
mycobacterium	マイコバクテリウム属|グラム陽性細菌に分類される真正細菌の一属
bigwig	お偉方|大物|an important person
fettle	(心身の)状態
henpeck	〈亭主〉‘に'絶えず文句を言って悩ませる
longhorn	長角牛
measurer	測る人|量る人;計量器
leu	レウ(ルーマニアの貨幣単位)
reversely	逆に|反対に|転倒して|裏返して|これに反して
piggery	《おもに英》=pigsty
prohibitionist	酒類製造販売禁止論者
demodulate	(無線で)〈電波〉‘を'検波する|復調する
dethronement	廃位|強制退位
manful	男らしい|勇ましい
tactual	触覚の
thirtysomething	30代に見える|30代の
befoul	(〜で)〜'を'汚す|汚くする《+『名』+『with』+『名』》
earwig	ハサミムシ(寝ている人の耳に入り害をすると考えられた)
equalitarian	平等主義の|平等主義者
jejune	《文》(特に書かれたものが)おもしろみのない|無味乾燥な|未熟な|《米》子供っぽい
cretinism	クレチン病(甲状腺障害で幼児期に発育が止まる)
mosh	モッシュ|グループ通話ができるアプリ
nincompoop	とんま|ばか者|つまらない人
naturopathy	自然療法医|食餌(しょくじ)療法医
sawhorse	(X字型の)木びき台
staphylococcus	ブドウ球菌
coastwise	沿岸の|海岸に沿って
jetlag	時差ぼけ
milksop	弱虫|めめしい奴(sissy)
corbel	持ち送り積み(壁面から突き出た桁(けた)・はりの受け材)
baccy	《俗》たばこ
plastron	プラストロン(フェンシング用の胸当て)
boozer	大酒飲み
benzine	ベンジン(石油から採る揮発油)
biovar	次亜種|生物型|ビオバル
cosmetology	美容術|化粧法
earwax	耳あか|耳くそ
manageress	《おもに英》(商店やレストランなどの)女性経営者(支配人)
staph	ブドウ球菌|ブドウ状球菌|staphylococcus
bijou	宝石|小さくかわいらしい物(場所)
majolica	マジョリカ焼き|マジョリカ風の焼き物|赤茶色
worldling	俗物|俗人
appose	〜'を'並べる|隣りに(近くに)置く
drippy	(水の)滴る|雨の多い|ありふれた|弱虫の
kipper	に塩をして燻製にする
monarchism	君主制|君主制主義
fledge	羽毛でおおう
forsythia	レンギョウ|早春に黄色い花を鈴なりに付ける低木
jalopy	(口)おんぼろ自動車|おんぼろ車
kris	東南アジア地区の短剣|(人名)クリス
unbowed	(ひざ・腰が)曲がっていない|《文》屈服しない
abortionist	人工中絶賛成者
goodhearted	親切な|やさしい(kind)
refulgent	光り輝く
twerp	くだらないやつ|見下げはてたやつ
contumacy	権威無視|命令不服従
golosh	=galosh
voluptuary	享楽者|酒色におぼれる人
yahoo	野蛮な人間|田舎者|やっほー
castoff	解雇された人|脱ぎ捨てた|捨てられた人(物)
mistral	(仏語)ミストラル|フランスの地中海岸に吹く北風
rusticate	《おもに文》〜‘を'田舎へ行かせる|〜‘を'田舎ふうにする|《英》〈大学生〉‘を'停学処分する|《おもに文》田舎へ行く|田舎ふうになる
termagant	やかまし女|がみがみ女|口やかましい
greenroom	出演者控室|楽屋
petunia	ペチュニア(花)
cottontail	ワタオウサギ(綿毛のような白い毛のウサギ;米国産)
flasher	閃光を放つもの|点滅光|方向指示器|回転灯|露出狂
macrobiotic	長寿にきく殻類や野菜からなる|菜食による|長寿食の
mineralogist	鉱物学者
misprision	(公務員の)不正行為|業務怠慢
pyrometer	高温計(高温を測定する温度計)
repairer	修繕屋
derange	〜‘を'錯乱させる|狂わせる
bungler	へまをする人|不器用な人
destructible	破壊し(され)やすい|壊れやすい
superstore	スーパーストア
aerate	空気を含ませる|浄化のために空気にさらす|血液に酸素を供給する
armyworm	ヨトウムシ(夜盗蛾の幼虫;農作物害虫)
cayuse	(米西部で)インディアンの小馬
praline	プラリーヌ|砂糖をまぶしたアーモンド
purslane	スベリヒユ(サラダなどに入れて食べる雑草)
tripwire	わなや仕掛けを動かすため地面に張った針金
umlaut	母音変異|ウムラウト記号(¨)
brutalize	残忍にする|非人間的にする
colored	色づいた|着色した|有色の
largish	やや大きい
leadoff	最初の
guilder	ギルダー(オランダの通貨単位)
insurrectionist	反乱者|暴徒
cycad	ソテツ(蘇鉄)
mightiness	強大さ
spearman	槍兵(やりへい)
smegmatis	Mycobacterium smegmatis|恥こう菌|スメグマ菌
freebooter	略奪者|海賊(pirate)
convolvulus	サンシキヒルガオ(アサガオの一種)
incertitude	確信(自信)のないこと|不確実|不安定
showery	にわか雨の多い
behoof	《古》利益|必要
backstairs	秘密の|こそこそした|陰口(悪口)ばかりの
gabardine	ギャバジン(羊毛と綿のあや織り)
monstrance	聖体顕示台(ローマカトリック教会で礼拝のために聖体がおかれている容器)
whipcord	むち縄|強くよったひも|あやうね織物
indetermination	不確定|不決断
phonogram	発音文字
cowlick	(頭の)立ち毛
pageboy	=page|〈U〉小姓髪(肩のところで髪を内巻きにする女性の髪型)
politesse	上品|礼儀正しさ
coping	(塀などの頂部の)笠木|笠石
davenport	大型ソファ-
enkindle	〜‘に'火をつける|〈情熱・欲望など〉‘を'燃え立たせる
hydrography	水路学|水路測量術
psaltery	ソルタリー(古代の弦楽器)
unicycle	(スポーツまたは曲芸用の)一輪車
houseplant	室内用鉢植え植物(のように家にじっとしている人)|出不精|おたく族
angelfish	エンゼルフィッシュ
discussant	討論者
burglarize	押し入り強盗をする
carrel	書庫内閲覧席
dishpan	洗いおけ
proteobacteria	プロテオバクテリア門|真正細菌の分類群|大腸菌|サルモネラ|ヘリコバクターなどの病原体含む|(ギリシャ神話で姿を変幻自在に変える神プロテウスにちなむ)
hotchpotch	= hodgepodge
stomacher	(昔の婦人用)胸飾り(宝石や刺しゅう飾りがある)
bettor	賭けをする人
pelf	《通例軽べつして》金銭(money)|(不正で得た)富(wealth)
costimulation	同時刺激|共刺激の意
houri	(イスラム教で)楽園にいて喜びを与える美少女|魅惑的な女性|売春婦
nonrestrictive	(文法で)非制限的な
scorcher	焦がすもの(人)|《単数形で》《話》焼けつくように暑い日|《単数形で》《俗》痛烈(しんらつ)なもの
sideslip	(車・スキーなどが)横すべりする|横すべり|横転
attar	バラ油|花の精|花のエキス
posthaste	《文》大急ぎで
educationist	=educator
deflower	〜‘の'花をもぎ取る|〈処女〉'を'犯す
housewifely	主婦の|主婦らしい
kismet	運命
novena	(カトリックで)9日間の祈り(修業)
outbred	異系交配の
blowhard	《米話》ほら吹き
amoeboid	アメーバ状の
saddlery	〈U〉馬具製造業|〈U〉馬具類[一式]|〈C〉馬具店
terrycloth	テリークロス(両面のけば(毛羽)の輪奈を切らずに残した布地;タオル地など)
contrail	飛行機雲
hypervariable	超可変
premed	医科大学予科(生)|医進
warmonger	戦争挑発者|戦争屋|主戦論者
tropopause	圏界面(対流圏と成層圏との境界の大気層)　対流圏界面
reasonability	道理にかなっていること|正当性|妥当性
sangfroid	冷静|沈着
flack	不平|批判|異議|苦情
fraudulence	詐欺|いかさま|不正
thimbleful	(液体の)ほんの少量《+of+名》
ingrain	(〜に)〜‘を'浸透させる|根づかせる《+『名』+『into』+『名』》
hornbill	サイチョウ|(熱帯林の樹上で生活する|くちばしの大きな派手な色彩の鳥)
accounting	会計学|会計|計算
insignia	記章|勲章|バッジ|しるし
bloodily	血まみれになって|血に染まって|《英俗》ひどく|べらぼうに
celeb	有名人|セレブ
trolleybus	トロリーバス
conventicle	(非国教徒の)秘密集会
administrate	=administer
mugging	強盗|暴力スリ
refection	〈U〉(特に飲食物による)元気回復|〈C〉軽食
terrazzo	テラソ(大理石の砕石入りセメント)
auscultate	〜'を'聴診する|聴診する
strongpoint	長所|強み
alp	高山|高峰
openwork	(彫金・織物などの)すかし細工
scantiness	不足;不十分
suppurate	〈傷が〉うむ|化膿する
slangy	俗語をつかう|俗語的な
translucence	半透明
phenom	非凡な人|奇才|天才
seriatim	相次いで|順次
jackanapes	いたずら好きの子供
flambeau	たいまつ
kapok	カポック|パンヤ|絹綿(クッション・まくらの詰め物にする)
placemat	プレースマット(食卓で各人用食器類の下に敷く小型のマット)
postinfection	感染後
topper	topするもの|上積み|上層|上部のもの|短いオーバー|シルクハット|高いバウンドのゴロ|いい奴|優れたもの|傑作|ピックアップ･トラックの荷台の上に取り付ける
wicketkeeper	(クリケットの)ウィケット・キーパー(三柱門の後方にいて通ってくるボールを捕るプレイヤー)
coruscate	輝く|きらめく|(知性などが)きらめく
documentarian	記録担当者
eolian	風の堆積(たいせき)作用による|風成の
intersperse	散らばせる|まき散らす|蒔き散らす
downer	(俗)鎮静剤|(特に)バルビツール剤|気の滅入るような場面|経験|退屈な人物
gristmill	粉ひき場|製粉所
lightship	灯台船
stocktaking	在庫調べ|たなおろし|(現状の)調査
blackleg	スト破りをする
daiquiri	ダイキリ(ラム酒・レモンジュース・砂糖などを混ぜたカクテル)
vinegary	酢のような|すっぱい|(人が)意地悪い|気むずかしい
spinnaker	(ヨットの主帆の前に張って追い風を受ける)大三角帆
turtledove	キジバト
discotheque	ディスコ
jingo	好戦的愛国主義者
bluegill	米国Mississippi川流域産のクロマス科の淡水魚
chambray	シャンブレー織り(綿・絹あるいは麻の霜降り模様の薄地織物)
schmooze	馬鹿話|ばか話|気楽な話|楽しく会話をする
booger	のやつ|鼻くそ
disbarment	弁護士資格のはく奪
microform	縮小写真印刷[物]
microstate	マイクロステート|極小国家(Monaco|Nauruなど)
megahertz	メガヘルツ
nymphomaniac	(女性が)色情狂の|淫乱な女性
kook	変人|ばか
malarkey	でたらめ話|作り話|ほら話|ナンセンス
bullheaded	わからずやでがんこな
bluestocking	《軽べつして》文学かぶれの女性|学才を誇る女
honeymooner	新婚旅行者
inscrutably	不可解に|なぞめいて
placode	(発生学)母組織|原基|プラコード
electrocute	電気で殺す|処刑する
retool	工場の機械設備を改善する|を再編集する|を改組する
triode	三極真空管
balderdash	猥褻な言葉|戯言|ごたまぜ酒
commendably	りっぱに|感心にも
dozy	ねむい
autophosphorylation	自己リン酸化 (細胞が自ら細胞内のタンパク質をリン酸化|脱リン酸化し|酵素活性や他のタンパク質との会合状態を変化させる機能)
sheave	〈穀物など〉‘を'束ねる
irascibility	怒りっぽいこと|短気
ranchero	農場主
subtend	(幾何で)〈弦・三角形の辺が〉〈弧・角〉‘に'対する|向かい合う
garrulity	おしゃべり|多弁
pule	〈赤ん坊が〉弱々しく泣く
jailbreak	脱獄
undermanned	(船が)通常の人員を欠いている|(職場などに)人手が足りない|要員不足の
wacko	頭のおかしいやつ|へんなやつ
centerfold	(雑誌などの)2ページ見開き|折込みページ
fichu	婦人用三角ストール
moony	月の[光の];月の[光の]のような|《話》夢ごこちの|ぼんやりした
unsay	〈言ったこと〉‘を'取り消す|撤回する|言わなかったことにする
anchorman	(ニュース番組の)総合司会者|ニュースキャスター
bowlegged	わに足の|O脚の|がにまたの
dumbwaiter	(レストランなどで調理場から階上へ料理を運ぶ)小型エレベーター(《英》food lift)|《おもに英》移動式食品台
tansy	〈C〉コモギギク[属](小さな黄色い花の房をつける)|〈U〉(薬用・食用の)ヨモギギクの汁
waggish	こっけいな|おどけた;いたずら好きの
counterespionage	(敵のスパイ活動に対する)対抗スパイ活動
millpond	(水車用)貯水池|水車池
quot	quotation|引用の略語
skinflint	非常にけちな人
internee	抑留されている人|監禁されている人
sough	風がヒューヒュー鳴る|風がヒューヒュー鳴る音
grandnephew	おい(めい)の息子|兄弟の孫息子
polaroid	ポラロイド|(人造偏光板)
scrambler	はうようにして進む人(物)|周波数帯変換器
surlily	不きげんに|無愛想に
venturer	冒険者;投機家
nonsmoker	非喫煙者
shouting	叫び
vermifuge	駆虫剤|虫下し
wunderkind	神童|天才児|(実業界での若手)成功者
bagful	(〜の)袋1杯[の量]《+『of』+『名』》
diametrical	直径の|正反対の
laywoman	女性の平信徒
penstock	(水力発電所・水車などの)導水路;水門
semiofficial	半官半民の
conger	アナゴ(食用の魚)
jowly	下顎の張った|二重顎の
dodgeball	ドッジボール
fanboy	おたく|物事に異常に熱中する人(fanboyは男性のオタク|fangirlは女性のオタク)
semiprofessional	半職業的な|(選手など)セミプロの・半職業人|セミプロ選手
cooperator	(共通の目的を持った)協力者|協同者
czarist	ロシア帝政の|ロシア皇帝の|独裁的な|帝政支持者
distrait	(心配などのために)ぼんやりした|うわの空の
mustiness	かび臭さ|古くさいこと|陳腐
stupefy	ぼう然とさせる|昏睡させる|麻痺させる|仰天する
baluster	手すり子(手すり・らんかんの小柱;通例屋外で石造のもの)|《複数形》で=balustrade
postulant	聖職志願者
biennium	2年間
ivied	ツタ(ivy)でおおわれた
syllabification	=syllabication
swinish	(豚のように)意地ぎたない|どん欲な
weathervane	風見
eulogize	賞賛する|ほめたたえる|賛美する|の賛辞を述べる
contortionist	(体を自由自在に曲げる)軽わざ師|曲芸師
mycology	菌学
hagiographer	聖人伝の著者
endosymbiont	細胞内共生
epistatic	上位性|エピスタシスとは|遺伝学において異なる遺伝子座間の相互作用が一つの形質に影響すること
limbless	手足(翼)のない
roadwork	ロードワーク(長距離ランニングによる体力作り)
surefooted	=footsure = sure-footed　足元の確かな　転ばない　確かな　着実な
weeny	ちっちゃな|ちっぽけな
wickerwork	枝編み細工|柳細工
federate	〜‘を'連邦制度にする;〜‘を'連合させて(〜を)作る《+『名』+『into』+『名』》|連邦化する|連合する
fornicate	〈未婚や夫婦でない男女が〉性交渉を持つ|密通する
afterburner	(ジェットエンジンの)再燃焼装置
dele	(印刷物の校正で)〜'を'削除する|削除記号
weightlifter	重量あげ競技者
preponderate	(数量・勢力・重要性などにおいて)(〜より)優位を占める《+『over』+『名』》
hiccough	=hiccup
zloty	ズローティー(ポーランドのニッケル貨および貨幣単位)
endotoxic	内毒素
trombonist	トロンボーン奏者
eponym	名祖|名前の由来となった名|冠名
fanlight	(ドアや窓の上にある)小窓|扇窓|《英》=transom
grounder	簡単に解決できる殺人事件|(野球)ゴロ(= ground ball)
lapwing	タゲリ(ヨーロッパ産の鳥で鋭い鳴き声を出す)
milt	受精可能な|に受精させる|しらこ|魚精
mentalist	=mind reader
postbox	《おもに英》郵便ポスト(《米》mailbox)
horridly	ひどく
mellowness	芳醇(ほうじゅん)|甘美;円熟|成熟
unconscionably	非良心的に|不謹慎にも|不当に|不合理に
oversleep	寝過ごす|寝坊をする
crofter	小作農
inkpot	インクつぼ|インクびん
rebroadcast	再放送|再放送番組|中継放送|再放送する|中継放送する
boggle	しりごみする|英単語をつくるゲーム
prorogue	〈議会〉‘を'停会にする
prolegomena	=prolegomenon
perambulate	〈場所〉‘を'歩き回る|巡回する|歩き回る
ordure	《遠回しに》糞(ふん)|排せつ物・《文》汚れ|ごみ・汚物;みだらなこと［言葉］
annalist	年代記の編者
edgeways	=edgewise
howdah	(象の背に載せて人が乗る天蓋(てんがい)付きの)かご
sucky	嫌な
slantwise	(また『slantways』)斜めに|はすに|斜めの|はすの
southpaw	左ききの選手(ボクサー)|左投げの投手|左ききの
inductee	徴募兵
mariculture	海水魚人工養殖
puttee	巻きゲートル
unfunny	面白くない
vivify	〜‘に'生命(生気)を与える|〜‘を'生き生きさせる
lymphoblast	リンパ芽球
piezoelectricity	ピエゾ電気|圧電気(ある種の石への圧力で生ずる電気)
carryout	(食堂で)お持ち帰り料理|(料理が)お持ち帰り用の
feudalistic	封建制度の|封建的な
furthermost	最も遠い(farthest|furthest)
redact	〈布告など〉‘を'作成する|〜‘を'編集する;〜‘を'校正(改訂)する
potsherd	(特に考古学的価値のある)陶器片
autarchy	〈U〉独裁(専制)政治|〈C〉独裁(専制)国家|=autarky 2
asterism	〈U〉星状光彩(結晶した鉱物に見られる星形の光の反射)|〈C〉星群;星座
florescence	開花;開花期|盛り|繁栄期
polder	(特にオランダの)干拓地|低地帯
appropriator	専有する人|盗用(横領)する人|《英》教会禄(ろく)の設定を受けた宗教法人
chaffinch	ズアオアトリ(ヨーロッパ産の小型の鳴き鳥)
josh	からかい|悪意のない冗談|冗談|冗談を言う|からかう|冷やかす
potshot	手当たり次第の射撃
indite	〈演説・詩など〉‘を'書く|作る
milliard	10億(billion)
histo	ヒストグラム(度数分布図|柱状グラフ)の略
ocelot	オセロット|ヒョウネコ
papoose	北米インディアンの赤ん坊|赤ん坊を背負う袋
tamarack	アメリカカラマツ;〈U〉その木材
blarney	おせじ|おべっか|〈人〉を甘言でくどく|おせじ(おべっか)を言う
drumhead	〈U〉太鼓の皮|〈C〉鼓膜(こまく)
fangirl	ファンの女の子
kynurenine	キヌレニン|トリプトファンからナイアシンを生合成する際の中間体のひとつで|アミノ酸のひとつ
underachieve	(特に学業で)水準以下の成績をとる
weatherboard	(また weather boarding)《英》=clapboard
ebullience	幸福感と喜びに満ちあふれること
housewifery	家政|家事
turndown	(えりなどが)折り返しの
souse	(水などに)〜‘を'入れる|突っ込む《+『名』+『in』(『into』)+『名』〈水など〉》|〜‘を'ずぶぬれにする|〜‘を'酢(塩水)につける|《米》〜‘を'酔わせる|水につかる|ずぶぬれになる|《米》酔っ払う|(豚の足などの)塩づけ|(つけ物の)塩づけ汁|塩水|《米》大酒飲み|酔っ払い
downstate	州の南部|州南部へ(で)|州南部の|州南部特有の
insalubrious	(気候・風土が)建築によくない|不健康な
pectic	ペクチンの|膠素(こうそ)の
plink	(銃などで練習･遊びとしてを)撃つ|(楽器などを)ポロン･ペンと弾く|(チリン･リンなど)軽く響く音を断続的に立てる
songstress	(特に流行歌を歌う)女性歌手
vendee	買い主|買受人
biconvex	(レンズなどが)両凸(とつ)の
animalcule	(肉眼ではほとんど見られない)極微動物
appall	をぞっとさせる
dissembler	しらばくれる人|ねこかぶり
grotty	きたない|不潔な|不快な
barmy	愚かな|少し気が変な(《米》balmy)
hotcake	ホットケーキ
prorogation	(英国議会の)閉会|停会
alembic	ランビキ(昔の蒸留器|浄化器)
disestablish	〈既成の制度など〉‘を'廃止する|〈教会〉‘の'国教制を廃止する
nitpick	細かいあら捜しをする|重箱の隅をつつく
slickly	滑らかに
scatterbrained	散漫な|軽率な|うわついた
samarium	サマリウム(銀色の希土類元素;化学記号は『Sm』)
intermembrane	膜間(の)
incrustation	=encrustation
mistily	霧が深く|おぼろに|ぼんやりと
pennyroyal	ハッカ類の植物
seeming	うわべの|見せ掛けの|うわべ|外観|外見だけの
jilt	恋人を捨てる女|〈特に女性が〉〈恋人・愛人〉‘を'捨てる
cay	岩礁|洲|洲島|小島
dovish	ハトのような|ハト派的な|穏健派の|hawkish
testate	(法的に)有効な遺言を残した
ideologist	観念論者;空想家
cogwheel	[はめば]歯車
cowhand	=cowboy
cloudlet	小さな雲
filbert	ハシバミ;ハシバミの実
headhunter	首狩りを行う未開人|人材を引き抜く人
grogginess	ふらふらすること|千鳥足
pinworm	ギョウチュウ(人間の腸に寄生する蟯虫)
fulminate	声高に非難する|抗議する|爆発音を出す|電光のようにひらめく
ballade	バラード|物語詩|譚(たん)詩(フランス詩の一形式)|(音楽の)バラード|譚詩曲
oversexed	性的興味(性欲)が強過ぎる
squashy	つぶれやすい;(土地が)ぬかるみの;ぐしゃぐしゃの
intercalate	〜‘を'間に入れる|挿入する|〈うるうの日・月〉‘を'暦に入れる
airhead	変人
botanically	植物学士|植物学的に
resample	リサンプル
snit	イライラ|苛立ち|くだらん奴興奮|癇(かん)に障(さわ)る奴
infelicity	(言動の)不適当|不適切
backdate	(〜にまで)〜‘の'日付をさかのぼる《+『名』+『to』+『名』》
fricassee	フリカッセ(鳥・子牛・ウサギなどのこま切れ肉を用いた汁の少ないシチュー)|〈肉〉‘を'フリカッセにする
splenetic	脾臓(ひぞう)の|気むずかしい|怒りっぽい|意地の悪い
sirup	=syrup
translocase	トランスロカーゼ(酵素)|転位酵素
snog	キスする|愛撫する|キス|愛撫
museo	美術館|博物館のスペイン語(およびラテン系言語)
recoilless	はね返りのない
swashbuckler	(特に映画や物語の中で)向こうみずを自慢する人(冒険家|軍人など)
maltreat	〜‘を'虐待する|酷使する
comestible	食料品
obstructionism	議事妨害[行為]
shellfire	砲火|砲弾
tailwind	追い風
mullion	窓の縦仕切り|窓の仕切り|縦仕切り|(反|transom|窓の横仕切り|横棒)
busker	大道芸人|旅回り芸人
farsightedness	遠視
goodby	さようなら=goodbye
smokiness	煙だらけ
godparent	名付け親(生まれた子の洗礼式に立ち会って名前を与える人)
oddment	残り物|はんぱ物;がらくた
convoke	〈会議など〉'を'召集する
cannibalize	(車･機械)分解･解体する|(人の)肉を食う|共食いする
emulous	競い合う|競争心の強い;(〜を得ようと)競い合う《+『of』+『名』》
purvey	まかなう|調達する|伝える
quietus	《文》(債務などの)清算|解除|死|とどめ
hoyden	おてんば娘
convalesce	病気から回復する
erecta	エレクタ (黄色オレンジ色の花が咲く花の名) 
guiltiness	罪のあること|有罪;やましいこと
intermezzo	(劇・歌劇などの)幕合いの曲|間奏曲
mensuration	《文》測定|(長さ・面積・体積の)測定法|求積法
minesweeper	(敵の機雷を除去する)掃海艇
agoraphobic	広場(空間)恐怖症にかかった
outplay	〜‘より'じょうずである;(競技などで)〜‘に'勝つ(defeat)
roughhouse	大騒ぎ|ばか騒ぎ|大げんか
harrier	ハリヤー犬(ウサギ狩りに用いる)|クロスカントリーレースの走者
hipbone	座骨|無名骨《腸骨・坐骨・恥骨からなる》
cogitate	(〜について)熟考する《+『on』(『about』|『over』)+『名』》
dago	《軽べつして》スペイン(ポルトガル|イタリア)系の人
gimmicky	見てくればかりの|からくりで人目を引く
moray	ウツボ(魚)
muskeg	北米北部の沼沢地帯
mantissa	(対数の)仮数
preaching	説教
tachometer	タコメーター|回転速度計
confutation	論駁|論破|やりこめること
fasting	絶食|断食|物忌み
aflutter	(旗などが)はためいて|ひらひらして
manicurist	マニキュア師
stertorous	(病気のため)高いびきをかく
touchline	(ラグビー・サッカーで)タッチライン
pawpaw	=papaw
stannous	錫(すず)の(を含む)|(特に)第一錫の|2価の錫を含む
blabber	おしゃべりをする人|口の軽い人
overtax	重税をかける
balky	(馬が)急に止まる癖のある|(人など)がんこな|強情な
cruse	陶器のつぼ
brut	(ぶどう酒が)甘味のない|辛口の
immunogen	免疫原
vitis	ブドウ科植物の属名
dimwitted	ばかな|愚かな
troubleshooter	問題解決者|故障発見者|紛争調停者
falchion	鎌(かま)形刀(中世の幅広でそり返った刀)
permeabilized	透過処理
overplay	大げさな演技をする
antisepsis	殺菌による防腐[法](消毒[法])
byplay	(特に舞台で本筋の進行中に行われる)わき演技
hemophiliac	血友病患者(の)
agriculturalist	農業経営者;農業専門家
hakim	裁判官|太守|知事
sideswipe	(すれ違いざまに)〜‘を'横殴りする
vagary	気まぐれ
patricide	父殺しの行為;〈C〉父殺しをした人
surtax	所得税|付加税
bereave	(bereft|bereaved)(生命･財産など)を奪う|失わせる
hoarfrost	白霜
debauchee	放蕩者|道楽者
footlocker	(身の回り品を入れておく)小型トランク
macerate	湯や水に浸して柔らかにする|やせ衰えさせる
lamplighter	(街灯の)点灯夫;点灯用具
lodgement	=lodgment
naiad	(ギリシア神話・ローマ神話で|少女の姿をして川や泉に住む)水の精
peen	金づちの頭(くぎを打つ平らな部分の反対側)
cockfight	闘鶏(試合)
dyne	ダイン(力の単位|dyn)
staysail	支索帆(両マスト間の三角帆など)
scattershot	やみくもの|めくら滅法の|でたらめの
dimity	(ベッドカバー・カーテンに用いる)浮きじま綿布
exergonic	エネルギーを発生する
kleptomania	(病的)窃盗症|盗癖
plummy	好ましい|上等な|素晴らしい|スモモの|プラムのたくさん入った|干しブドウ入りの|丸くぽちゃぽちゃした|声量の豊かな
splintery	裂けやすい|割れやすい|破片の多い;破片のような
pinyon	=pinon
slicker	長いゆるやかなレインコート|詐欺師|如才のない都会人
sophomoric	(高校･大学)2年生の|青くさい|知ったかぶりの|生意気な
heliport	ヘリポート(ヘリコプター発着場)
spoilsport	他人の楽しみをだいなしにする人
damnit	くそっ
fishwife	魚売り女|がみがみ女
heathendom	異教の信仰|異端|《集合的に》異教徒
knout	革むち(昔のロシアの刑具)
schoolbook	教科書|教科書的な
abominate	《文》〜'を'忌みきらう;《話》〜‘が'大きらい
bicentenary	=bicentennial
lifejacket	救命胴着
misfeasance	(法律用語で)不法行為
cummerbund	カマーバンド(タキシードの下に着用する幅広の腰帯)
unitarian	ユニテリアン派(プロテスタントの一派|三位一体の教義(The doctrine of the Trinity|父と子と聖霊)を排して唯一の神格を主張し|キリストを神としない)クリスチャン
beery	ビールの|ビール好きの|ビール臭い
gosling	ガチョウの子
aborigine	原住民;《通例複数形で》土着の動物(植物)
bindweed	ヒルガオの類の植物
cheep	ヒヨコの鳴き声|ピヨピヨ
correlogram	相関曲線
fieldstone	自然石
keyless	(時計が)巻きねじの不要な;竜頭(りゅうず)巻きの
monitory	警告する|注意を与える
pedantically	学者ぶって|物知り顔で
infiltrator	侵入者|潜入者
arquebus	火縄銃
anywise	どうしても|なんとしても
distain	(〜を)差し押さえる《+『upon』+『名』》|〜‘を'差し押さえる
trinitrotoluene	トリニトロトルエン|高性能爆薬(《略》TNT|T.N.T.)
unshaved	陰のない;(絵画が)陰影をつけない|日よけ(おおい)のついていない;(電気スタンドなどが)シェードのついていない
webmaster	ウェブマスター
cockatrice	コカトリス(伝説上の怪物;頭・足・翼は鶏|胴と尾は蛇)
gumboots	ゴム長靴
insipidity	(飲食物の)風味のなさ|(人・話などの)味気なさ
stonecutter	石工|石切り工;石切り機
trendsetter	流行仕掛け人|流行の最先端にいる人
vermiform	(形が)虫状の
cajolery	うまい言葉でだますこと|たぶらかし
copeck	=kopeck
hereon	ここにおいて|この直後に|このすぐ後で
murrain	家畜の伝染病の総称
stridency	耳ざわりなこと|きしること
stockyard	(市場などの)家畜置き場
ammonite	アンモン貝|アンモナイト
extrusive	突き出す|押し出す|(岩石が火山から)噴出する
numismatics	貨幣(古銭)の研究(収集)
postpaid	郵便料金前払いの|郵便料金前払いで(《英》は{形}{副}ともpost-free)
seersucker	シアサッカー(しまのある縮れた薄織りリンネル･紳士用スーツ生地)
windbag	おしゃべりな人|(バグパイプの)空気袋
busywork	忙しいが価値のない仕事
unshorn	(羊などが)毛を刈取られていない
cigarillo	細い葉巻
pastille	トローチ(のどの薬などの入ったドロップ式錠剤)(troche)
danseuse	女子のバレエダンサー
egomaniac	極端な自尊家|極端に自己中心的な人|病的な自己中心者
smarten	〈人・服など〉‘を'きれいにする|きちんとする《+『up』+『名|』+『名』+『up』》|〈人・服が〉きれいになる
paratroops	落下傘部隊
tannoy	拡声器(loudspeaker)による宣伝　(商標)タノイ　タンノイ　スピーカーの一種
careerism	立身出世主義
copperhead	カパーヘッド(アメリカマムシ)|豪州産コモチコブラの一種|南部に同情した北部人
pix	写真|絵|(pic=picture)の複数形
tron	トロン (すべての技術情報が公開･利用できるというオープンな思想の組込み用技術開発プロジェクト) 東京大学の坂村健教授が開発
vulpine	キツネの|キツネのような;(キツネのように)ずるがしこい
whipt	whip の過去・過去分詞
magnetize	を磁化する|磁気を与える|磁化する|引き付ける|魅了する
belvedere	見晴らし台|展望台|望楼
corgi	コーギー犬(短足・胴長の小型犬)
ravisher	うっとりしている人|恍惚(こうこつ)の人|《文》強奪者;強姦者
stapler	ホッチキス(和製英語)
vocable	音語(意味に関係なく音と文字からみた語)　単語　母音　発声できる
handsaw	(片手で使う)手のこぎり
souffle	スフレ(卵の白身･ミルクなどをふくらまして焼いたもの)
armlet	腕輪|腕飾り(手首でなく腕上膊(じょうはく)部にはめる)|小さな入り江
sodomite	男色家;獣姦(じゅうかん)者
brio	活気|元気
bioscience	バイオサイエンス
comedienne	喜劇女優|女性コメディアン
whiner	哀れっぽい声を出す人(犬)|すすり泣く人;ぐちをこぼす人
diminuendo	次第に弱まる(弱める)|次第に弱く|次第に弱くなること|ディミヌエンドの楽節
equiangular	等角の
glibness	よく回る舌|達者な口
scentless	かおりのない
xeric	乾燥した|湿度の低い
etude	(音楽の)練習曲|エチュード;(絵の)習作
hosier	靴下・下着商|メリヤス商
archaeon	archaea(古細菌)の単数形
caiman	カイマン|小型のワニ|caymanとも綴る
housebreaker	(特に昼間の)押込み強盗
wrasse	ベラ(海水魚の一種)
microliter	マイクロリットル
fellowman	(人類の)仲間|同胞
bamboozle	〜'を'だます|あざむく|煙に巻く;〜'を'だまして(〜)させる(させない)《+『名』+『into』(『out of』)+『名』(do『ing』)》
preovulatory	排卵前の
supercharge	〈エンジン〉‘に'過給する
plunderer	略奪者
finagle	いんちきする|ごまかす
quadrivium	(中世の大学の)四学科(算術・幾何・天文学・音楽)
thole	かい座ピン(ボートのへりにさし込んであるオール受け)　船の櫓べそ　かい受け軸　瓶　栓
underexpose	〈写真のフィルム〉‘を'露出不足にする
whippet	ホイペット(小型の競走犬)
natter	不平を言う
cryosurgery	低温(凍結)外科療法(組織の破壊などに極度の低温を用いる療法)
nosiness	せんさく好き|おせっかい
simpatico	気の合う|同じ性質の
conk	パンチ|一撃|縮れ毛を(アルカリ溶液などで)伸ばすこと
ambulant	巡回する|動き回る|(患者が)歩行可能な|外来の
demijohn	(かご細工で包んだ)細口びん(1‐10ガロン入り)
dairymaid	酪農場で働く女|乳しぼり女
emigre	移住者
saxifrage	ユキノシタ(高山植物)
archrival	第一級の競争相手|大敵
flageolet	フラジョレット(小型の縦笛式木管楽器)
gangling	(身長・脚などが)ぶざまなほどひょろ長い
milepost	(ある場所との距離を示した)マイル標|里程標
coordinately	協調
demulcent	(薬剤などが)鎮痛の|沈静の|鎮痛剤|緩和剤
jamboree	(特に全国的･国際的な)ボーイスカウト大会|底抜け騒ぎ
pigpen	=pigsty
shyster	いんちき弁護士
scrimp	倹約する|切詰める|切り詰める|節約する
tweeter	ツイーター|高音用スピーカー
apparatchik	(ソ連の)政治局員|党官僚
customhouse	税関(《英》customs house)
moonscape	月面の眺め;月面写真
polyandrous	一妻多夫の|(植物が)多雄ずい性の
quarterfinal	準々決勝
jinni	=genie
affricate	破擦音
costermonger	(特にロンドンで)果物野菜を荷車にのせて呼売りする人
decrescendo	(音楽で)しだいに弱くなる|しだいに弱く
homozygote	ホモ接合体
sportscaster	スポーツキャスター
backcloth	=backdrop
cycloheximide	シクロヘキシミド|真核生物のタンパク質合成の阻害剤|DNA損傷|催奇性のため|「in vitro(生体外)」でのタンパク質合成阻害研究に使われ|ヒトの治療薬には不適
nurseryman	苗畑の所有者|苗木屋
northwestward	北西へ(に)|北西の;北西へ向かう|北西|北西部
unscramble	〈混乱したもの〉‘を'元どおりにする|整頓する|〈混線した通信など〉‘を'分かるようにする|〈暗号〉
ulcerate	潰瘍を生じる|〜に潰瘍を生じさせる
bloodstone	血玉髄|血石(玉髄に赤い斑点のある石)
cotter	(機械の)くさび栓(せん)|=cotter pin
soapsuds	=suds 1
tambour	(刺しゅう用の布地を張る2個の)わく|太鼓|(家具の)蛇腹とびら
disoblige	〜‘の'意に添わない|便宜を計ってやらない
enjoyably	楽しく
paleography	古文書学
pressman	印刷工|《英語》新聞記者