pugilist	(pjuː|dʒəl|ɪst) )(プロ)ボクサー|けんか(議論)好きな人
debark	=disembark
ingathering	取入れ|収穫|集会|会合
riband	=ribbon
teargas	催涙ガス
sardonically	冷笑的に|皮肉に
strongbox	金庫|貴重品入れ
cavil	けちをつける|あら探しをする
huskily	しわがれ声で
gastronomical	=gastronomic
anent	〜について|に関して
heterodoxy	〈U〉(宗教上の)異端|〈C〉異端の教義|異説
verruca	(特に足の裏の)たこ|いぼ
lambast	がみがみ言う|をひどく殴る
squarish	正方形の|角ばった
abjure	宣誓して捨てる
plenteous	= plentiful・『豊富な』|たっぷりの|たくさんの;豊富に生じる
doubletalk	きまじめな調子で意味のない言葉を挾んで相手を煙にまく話し方|内心とはかけ離れた話|むやみに難解な話し方
debauch	〈人〉'を'堕落させる;〈生活など〉'を'退廃させる|放蕩(ほうとう)|道楽;らんちき騒ぎ
splotch	染み|汚れ|斑点|汚れがつく|染みがつく|染みの原因になる|に染みをつける|を汚す
flamboyance	華麗さ|けばけばしさ
ratite	飛べない走鳥類|(ダチョウ|エミュー等)
pennyworth	(〜の)1ペニーで買える分量|1ペニー分(の〜)《+『of』+『名』》|わずか|少量(の)《+『of』+『名』》
crofter	小作農
gramp	おじいちゃん
customhouse	税関(《英》customs house)
rigmarole	くだらない（まとまりのない）長話　くだらない長々としたやり方（手続き）　無駄話
audibility	聞き取れること|可聴度
dragoman	(アラビア・トルコ・ペルシアなどの)通訳
cogency	(理由・議論などの)説得力|なるほどと思わせること
convalesce	病気から回復する
songster	歌手|歌の作者;詩人|鳴き鳥(songbird)
supersession	(〜に)取って代わること|(〜の)代替|代用《+of+名》
unsocial	非社会的な;非社交的な;家庭生活が優先する
vertiginous	グルグル回る|目が回るような|目まぐるしい|目まいがする|旋回する|不安定な|変わりやすい
electrocardiograph	心電計
commingle	混ざり合う
pictographic	絵文字の|象形文字の
sailcloth	帆布|ズック|帆木綿
phlegmatic	ほとんど感情を示さない|痰の多い|粘液質の|無気力な
boohoo	泣きわめく|泣きわめく声|ワーワー
dispossess	(特に法律に基づいて)(財産・土地などを)〈人〉‘から'取り上げる|没収する《+『名』〈人〉+『of』+『名』〈物〉》
skycap	(空港の)手荷物運搬係|赤帽
gibe	(for)|ばかにする|とがめだてする|あざける|からかい
drily	=dryly
languorous	けだるい
dicotyledon	双子葉植物
dysgenesis	発育不全
slithery	ずるずる(するする)すべる|つるつるした
schlep	(持ち)運ぶ|引っ張って行く|のろのろ動きまわる|ぶらぶらする|無能なやつ|面倒な仕事|大変な苦労
cockamamie	ばかばかしい|くだらない
pointillism	点描画法(フランスの新印象派の画家たちの技法)
rumple	〜‘を'しわにする|くしゃくしゃにする|しわになる|くしゃくしゃになる|しわ(wrinkle)
tarsier	メガネザル(インドネシア産;長い尾と大きな目を持つ小形の猿)
disapprobation	=disapproval
glumly	むっつりして
archdeaconry	archdeaconの職(地位|任期|住息)
vulpine	キツネの|キツネのような;(キツネのように)ずるがしこい
ambrosial	(ambrosiaのように)非常に美味な|かんばしい
goalpost	ゴールポスト
waggish	こっけいな|おどけた;いたずら好きの
dullard	のろま|ばか
synecdoche	提喩法|代喩|シネクドキ|全体とその一部についての言い換え
phagocyte	食細胞
groundsheet	=ground cloth
dogsbody	あくせく働くやつ|下っぱ
provender	かいば|まぐさ|《おどけて》(人の)食物
matronly	既婚婦人らしい|品のある|落ち着いた|(若い女性が)太めの
blabbermouth	口の軽い人
tiddler	《話》非常に小さい魚|《呼び掛けに用いて》ちびっ子|《俗》半ペニー銅貨
ungracious	無作法な|粗野な
overawe	〜‘を'威圧する|怖がらせる
mothball	防虫剤|をしまい込む
holidaymaker	休日の行楽客|休日を楽しむ人
limonite	褐(かつ)鉄鉱
gack	ギャー
airworthy	(航空機またはその部品が)航空に耐える|耐空性の
underskirt	アンダースカート(スカートの下にはくもの;ペチコートなど)
proapoptotic	アポトーシス(細胞死)促進性の
squinty	斜視の|横目の
linocut	リノリウム版画法;〈C〉リノリウム版画
tattooist	入れ墨師
aureate	金色の|さん然と輝く|華麗な
vespertine	夕方の|晩の|夕方に起こる|夕方に活動する
appal	=appall
prepuce	(陰茎の)包皮
hartebeest	シカレイヨウ(南アフリカ産の大カモシカ)
pointblank	(射撃など)至近距離からの|直射の|至近距離の|あけすけな|至近距離から|直射で|あけすけに
equable	一様な|均等な|(気分・気性などが)穏やかな|平静な
evildoer	悪事を行う人|悪人|悪者
poxvirus	ポックスウイルス|DNAウイルスの一種|ポックスウイルス科のウイルスによる疾患として天然痘が有名
handcart	手押し車
boodle	賄賂(わいろ)|買収金|腐敗看守　腐敗警官　盗品|ぶんどり品
praesidium	=presidium
elderflower	西洋ニワトコの花
anaerobe	嫌(けん)気性生物(空気・遊離酸素を必要としない細菌類)
moonscape	月面の眺め;月面写真
indulgently	甘く|気ままにさせる|優しく|寛大に
proximo	来月の
wangfujing	王府井は北京中心部の繁華街|巨大デパートや飲食店が立ち並び一帯は歩行者天国になっている
whimsey	whimsy
snowfield	雪原
superfluity	〈U〉〈C〉(〜が)多すぎること|余分|過剰《+of+名》|〈C〉《おもに複数形で》余分なもの|必要以上のもの;ぜいたく品
cremate	〈死体〉'を'火葬にする
immunohistochemically	免疫組織化学的に
tweeze	〜をピンセットで抜く
anabolism	(生物の)同化作用
uhuh	うーん(No)(鼻にかけて発音し否定・不同意を表す)
generalissimo	大元帥
coquettish	(女が)男にこびを売る|なまめかしい|あだっぽい
seasonably	時機を得て|つごうよく
outcaste	(インドで人が)社会的地位のない
downrange	(ロケット・ミサイルなどが)射程に沿って
deportee	国外追放者|被追放者|流刑者
commiseration	哀れみ|同情
entrain	〜‘を'列車に乗せる|列車に乗る
mechanistically	機構的に
potbellied	たいこ腹の
counterpoise	〈C〉=counterbalance|〈U〉釣合い|安定|=counterbalance{動}1
inquiringly	不審そうに|尋ねたそうに
mutineer	19
overqualified	(ある仕事に泌要以上に)教育(経験)がある
commendably	りっぱに|感心にも
maladjustment	適合(調和)しないこと;(環境への)不適応
polyploid	倍数体
steelworker	製鋼所工員|製鋼所職工|鉄鋼労働者
leitmotif	主な動機|中心思想･テーマ
unfeigned	偽らない|真実の(genuine)
impalpable	手で触れない|触知(感知)できない|(差異などが)なかなか理解できない|微妙な
cottonmouth	=water moccasin
theosophist	神知学者|接神論者
extrachromosomal	染色体外の
cowshed	牛小屋|牛舎
scrapheap	ごみの山|くず鉄の山;《the~》ごみため|ごみ捨て場
ectodomain	細胞外ドメイン
carefulness	注意深いこと
astatine	アスタチン(放射性元素の一つ;化学記号は『At』)
escapology	脱出術(袋・鎖から抜け出る奇術)
vaporous	蒸気が充満した|蒸気を出す|霧のかかった|はかない|空想的な|妄想的な|誇大な|実質のない
prevarication	言いのがれ|ごまかし|うそ
somnolent	眠い
antipyretic	熱さましの|解熱の|解熱剤
sibilant	シューシュー音がする|歯擦音
mortify	くやしがらせる|恥をかかせる|抑制する|(肉欲･感情などを)抑える
unstudied	(行為などが)自然な|わざとらしくない
unhallowed	聖別(祝別)されない|あがめられない|《文》悪に染まった|邪悪な
popover	軽焼きマフィン・(軽い焼き菓子の一種)
overfly	(編隊飛行で)〜‘の'上空を飛行する
injudicious	無分別な|無思慮な
beriberi	脚気(かっけ)
unmanly	男らしくない|ひきょうな|めめしい|柔弱な
mazy	迷路のような
cookhouse	炊事場・(特に)船の調理室|(キャンプ・工事現場などの)仮設炊事場
phosphatic	リン酸塩の|リン酸塩を含む
satinwood	サテンの木(東インド産のマホガニーの一種)
unsheathe	〈刀など〉‘を'さやから抜く
digoxigenin	ジゴキシゲニン|ジギタリス属の植物Digitalis orientalis等の花や葉に存在するステロイド|生化学における研究ツールとして用いられる
confiscatory	没収の|押収の|(税などが)過重な
climatically	気候上;風土的に
sarcomere	筋節|サルコメア(骨格筋線維の収縮単位)
steepen	〜‘を'険しくする|急勾配(こうばい)にする|険しくなる|急勾配になる
scentless	かおりのない
impulsion	〈C〉衝動|推進力|刺激|〈U〉推進
pinprick	(ピンなどで刺した)小さい穴|いやがらせ|意地悪
microsome	ミクロソーム|細胞をホモジナイズ(すりつぶす)して遠心分離すると|最初に核が|次にミトコンドリアが沈殿し|最後に上澄みから得られる小胞体などを含む部分|タンパク質合成活性などがある
nebulosity	〈C〉星雲状の物|〈U〉ぼんやりした状態|あいまいさ
factious	派閥的な|党派心の強い
middlebrow	ある程度教養がある人|知識や教養が中位の人|知識が中くらいの
provincialism	地方気質|地方色|偏狭|田舎根性|いなか風|田舎くささ|訛り|方言
shabbily	みすぼらしく;卑しく
undersell	を控えめに売り込む|値引いて売る|より安く売る|不当に低く印象づける
pelmet	(カーテン上部の金具をかくす)上飾り(《米》valance)
shyster	いんちき弁護士
detractor	中傷者|けなす人
superinfection	重複感染
hellacious	すばらしい|びっくりするような|ひどい|つらい(hell of a に近いことば)
armlet	腕輪|腕飾り(手首でなく腕上膊(じょうはく)部にはめる)|小さな入り江
dockland	ドック地域|波止場地域|ドック地区
oversexed	性的興味(性欲)が強過ぎる
feedstuff	飼料|えさ
homewards	=homeward
frugally	つましく|質素に
shako	(前に金層装飾|上に羽飾りのついた)筒形軍帽
bestride	〜‘に'またがる;〜'を'またいで越す
pilaster	ピラスター|柱形|付け柱|片蓋柱
rapine	略奪|強奪
milliard	10億(billion)
wittingly	承知で|わざと
fiddlestick	バイオリンの弓(bow)
noncombatant	非戦闘員(軍医・従軍牧師など)|戦時の一般市民
abnegation	権利(欲望など)の放棄;禁欲
synergize	相乗作用を与える
sporangium	(コケ植物の)胞子嚢(のう)
malefic	有害な|災いを呼ぶ
lecher	好色家
scatterbrain	気持ちが散漫な人|軽率な人
betake	(〜に)〈自分〉'を'行かせる《+one『self to』+『名』》
forestation	植林|造林;営林
quietus	《文》(債務などの)清算|解除|死|とどめ
wharfage	波止場(埠頭)使用料
enplane	飛行機に乗る(《英》emplane)
infrequency	まれなこと
vinous	ぶどう酒の[ような];ぶどう酒に酔った|ワインレッド色の
cornstalk	とうもろこしの茎
footbath	足洗い用たらい|足を洗うこと
saurian	トカゲ類の動物|トカゲ類の|トカゲ類動物特有の
pungency	(味・香りなどの)刺激|(皮肉・機知の)鋭さ|しんらつ
mudflat	干潟(ひがた)
avuncular	叔父の|おじ(伯父･叔父)の(ような)
shivery	ぞくぞくする|寒い
tramline	市街電車系統|《話》(テニスの)コートの側線
curdle	(牛乳など)凝結させる|凝固する
redcoat	(米国独立戦争当時の)英兵
chigger	ツツガムシ(ダニの一種)|スナノミ(南米・アフリカ産のノミ)
setscrew	止めねじ|押しねじ
unmerciful	無慈悲な|残酷な
tideway	潮路・潮流
deadness	死の状態|生気のないこと|(色などの)さえないこと;(酒などの)気の抜けていること
reprobation	非難|叱責(しっせき)|神に見放されること
burgomaster	(オランダ・フランドル地方・ドイツ・オーストリアの)市長
filarial	糸状虫の|フィラリアの
opalescence	オパールのような光|乳白光
roundish	丸みのある|やや丸い
plimsoll	《複数形で》《英》ゴム底ズック靴|運動靴《米》sneaker)
untwist	よりがもどる|ほどける|〈糸〉‘の'よりをもどす|〈もつれ〉‘を'ほどく
milquetoast	気の弱い人|いくじなし
fellah	(エジプト・シリアなどの)農夫|労働者
epiglottis	喉頭蓋|のどぶた
vacantly	ぼんやりと|ぽかんとして
cablegram	=cable{名}3
acclimatize	順応させる
obsessional	(人・考えが)強迫観念(妄想)にとりつかれた|(病気が)強迫観念(妄想)の症状を表して|強迫観念(妄想)を持っていめ人
flophouse	安宿|簡易宿泊所
debarkation	陸揚げ|上陸
crinoid	ウミユリ(ウミユリ綱の棘皮(きょくひ)動物)
miscue	誤り|しくじり(をする)|(スポーツの)エラー|間違った合図をする
croupier	胴元
nastily	不快に|意地悪く|みだらに
consanguineous	血族の|血縁の|血を分けた
camporee	キャンポリー(ボーイスカウトの地方集会)
inculcation	繰り返し教え込むこと|心にたたき込むこと
downstage	舞台の前方で(へ)|舞台前方の|舞台前半分
wardroom	(軍艦の)上級士官室
personalty	=personal property
splutter	(混乱して)早口でしゃべる|〈物が〉パチパチ(ジュー)と音を立てる|(混乱して)〜‘を'早口で言う《+『out』+『名』|+『名』+『out』》|パチパチ(ジュー)という音
mignonette	モクセイソウ(かおりのいい緑色がかった小さい花房をつける庭木)
crosscheck	〈計算〉'を'別のやり方で検算する|〈データなど〉'を'種々の情報(方法)で確かめる
eggbeater	卵泡立て器
appurtenance	付属物|従物(法律上財産に付属している権利)
sealskin	オットセイ(アザラシ)の皮(毛皮)
oubliette	(城などの)地下牢(ろう)(天井に出入口がある)
forewarn	(〜について)〈人〉‘に'前もって知らせる《+『名』〈人〉+『of』+『名』》;〈人〉‘に'(〜であることを)前もって警告する《+『名』〈人〉+『that節』》
motorman	(電車・電気機関車の)運転手
monetarism	通貨主義
bewilder	まごつかせる|当惑させる|驚き呆れさせる
promethium	プロメチウス(希土類元素;化学記号はPm)
flatcar	長物車(木材・鋼材などを運ぶ屋根・側面のない貨車)
consulship	領事の職(地位|任期)
proteasomal	プロテアソーム(proteasome|タンパク質の分解を行う巨大な酵素複合体)の
menfolk	男たち|男性|男連中|複数扱い
immunostained	免疫染色
nostalgically	昔を懐しんで|郷愁で
menstruate	生理がある
horsebox	馬運搬用貨車(トレイラー)
frazzle	ぼろぼろになる|へとへとに疲れる|〜ぼろぼろにする|へとへとに疲れさせる|ぼろぼろの状態|くたくたの状態
unclouded	澄み切った|かげりのない
affability	愛想の良さ|感じの良さ
affright	《古》〜'を'こわがらせる
recantation	(主張･陳述などの)撤回|取消し|否認
flannelette	綿ネル(フランネルのように表面がけば立っている)
outplay	〜‘より'じょうずである;(競技などで)〜‘に'勝つ(defeat)
southwestward	南西へ(に)|南西の;南西への|南西|南西部
impracticality	〈U〉実行不可能|非実用性|〈C〉実行不可能なこと|実用的でないこと
hyaena	=hyena
abrade	〈皮膚〉'を'擦傷する;〈毛・岩など〉'を'すり減らす
upholster	〈いす・ソファー〉‘に'詰め物をする|クッション(おおい)を取り付ける|〈部屋〉‘に'じゅうたん(家具)を取り付ける
expostulation	いさめること|訓戒;説伏
debunker	正体をあばく人|仮面をはぐ人
grampus	ハナゴンドウ(暖かい海にいるイルカ科の動物)
hexapod	六脚類|昆虫
graupel	雪状のあられ
gallimaufry	雑多な寄せ集め|ごたまぜ
besmirch	《文》〜'を'汚す
conventioneer	大会出席(参加)者
duckbill	カモノハシ
dilapidation	〈U〉荒廃|破損|《複数形で》(家具付き家などの)家具破損料
stereograph	ステレオ写真、立体図
flacon	(栓付きの)小びん
orbitofrontal	Orbitofrontal cortex眼窩(がんか)前頭皮質|ヒトの脳の一部で|意思決定などの認知処理に関わっている
foreordain	(神などが)〈人の運命・破滅など〉‘を'あらかじめ定める
protestation	抗議
retrench	(費用などを)削減する|削除する|省く
castellan	城主|城代|城守
frack	(=fracking)|(シェールオイルの掘削の際)高圧水で岩を砕くこと(=hydraulic fracturing)
becalm	(風がないで)〈帆船〉'を'止める
epistatic	上位性|エピスタシスとは|遺伝学において異なる遺伝子座間の相互作用が一つの形質に影響すること
crapshoot	不確実(予測不可能)なこと|賭け|さいころ博奕をする|危険を冒す
syncytium	合胞体|融合細胞|合胞体; 多核質; シンシチウム
straggler	落後者|stray(迷う)とdraggle(引きずる)の混成
skedaddle	あわてて逃げる|あわてて逃げること
disbandment	(組織・隊などの)解散|解隊
cheekily	生意気に
persnickety	=pernickety
ineluctable	不可抗力の|不可避の|免れえない
tokenism	(特に人種差別廃止における)名目主義
scrimp	倹約する|切詰める|切り詰める|節約する
urus	ウルス|最近絶滅した長く角のあるヨーロッパの大型の野生雄牛
cembalo	チェンバロ(harpsichord)
tinware	すず(ブリキ)製品
retrogressive	(元の状態に)後退する|逆行する|退化する;(〜に)後退する《+『to』+『名』》
amorality	超道徳性;道徳意識の欠如|不道徳
amateurism	アマチュア精神;しろうと芸
hermaphroditic	両性具有の|雌雄同体の
leprous	ハンセン病(らい病)にかかった;ハンセン病の|らい病の
penstock	(水力発電所・水車などの)導水路;水門
lambent	(特に炎が)ちらちらゆらめく|軽妙な|柔らかく輝く
asocial	非社交的な|思いやりのない|利己的な
sacristan	(教会・修道院の)聖具室係
tragicomedy	(悲劇と喜劇の両面をもつ)悲喜劇
ironbound	鉄で巻かれた|岩の多い|ごつごつした|堅い|曲げられない
coexistent	共存の
niggardly	けちな|もの惜しみして
warrantor	保証人
untended	世話されていない|世話する者がいない|ほったらかしの
blancmange	ブラマンジエ(牛乳とコーンスターチで作った甘いブディング)
operably	実施(使用)可能に;手術可能に
libidinous	好色な|肉欲的な|扇情的な
unforgettably	忘れられないで|いつまでも記憶に残って
postdate	〈手紙・事件など〉‘の'日付けを実際よりも遅らせる
copyedit	〈原稿〉'を'校正する
pockmark	あばた
orate	演説する
paratyphoid	パラチフス
buckboard	(米西部やいなかで用いる車体を木で作った)軽四輪荷馬車
commentariat	評論家
noisome	有害な|悪臭のする|不快な
hidebound	偏狭な|頑固な
intoxicate	酔わせる|夢中にさせる
exasperate	怒らせる|悪化させる
fatalist	運命論者|宿命論者
trinitrotoluene	トリニトロトルエン|高性能爆薬(《略》TNT|T.N.T.)
onrushing	突進する
babyhood	赤ん坊時代|幼年(期)
bluestocking	《軽べつして》文学かぶれの女性|学才を誇る女
tensity	緊張;張り
mesmeric	催眠術の
balky	(馬が)急に止まる癖のある|(人など)がんこな|強情な
roofless	(建物が)屋根のない|(人が)宿なしの
despoil	(〜を)〈人・場所〉‘から'奪う《+『名』+『of』+『名』》
fogy	時勢遅れの人|がんこで旧弊な人
inroad	侵入|侵略|襲撃
dirndl	ダーンドル(チロル農民ふうの婦人服で|ぴったりした胴着とゆったりしたスカートから成る)|ダーンドルふうのスカート
theca	花粉のうや蘚類の胞子のうのケースやさや|昆虫のサナギの外側のさや(outer sheath of the pupa of certain insects)
gangrenous	壊疽(えそ)の|壊疽にかかった
vainglorious	うぬぼれの強い|虚栄心の強い
embezzle	着服する|使い込む|横領する
disenchant	の魔法を解く
waterpower	水力
archbishopric	archbishopの職(地位|任期|教区|管轄権)
mayoress	《米》女性市長|《英》市長夫人
hatchway	=hatch
pinnace	艦載艇|(船への人の乗降・荷の運搬に用いる)小舟|小ボート
plummy	好ましい|上等な|素晴らしい|スモモの|プラムのたくさん入った|干しブドウ入りの|丸くぽちゃぽちゃした|声量の豊かな
nonsynonymous	非同義
quizmaster	《おもに米》クイズ番組の司会者(《英》question master)
extirpate	〈悪習・集団など〉‘を'根絶する|撲滅する|〈植物〉‘を'根こそぎにする
imposer	押しつける人|(課題・重荷などを)課する人
handpick	〜‘を'注意して選ぶ
avoirdupois	=avoirdupois weight(《略》『avdp』)
convulse	身もだえさせる|震動させる
imperiously	傲然と|横柄に|専制的に
misappropriate	悪用する|使い込む
neuroblast	神経芽細胞
kibosh	戯言|くだらないこと|ばかげたこと|ナンセンス|にとどめを刺す|をたたきつぶす|だいなしにする
unconcern	無関心|むとんじゃく|(心配事に)平気|平然
francium	フランシウム(放射性元素;化学記号は『Fr』
dearness	高価|親愛
gonfalon	(横木につるす)流旗|吹き流し
edibility	食用に適すること
stationmaster	駅長
squidgy	のり状の|どろりとした
hunting	狩をする|狩猟|狩り
wastrel	浪費家;怠け者
postern	裏口|裏門|通用門
philosophize	哲学的に思索する
undischarged	(船の積み荷が)荷揚げされていない|(銃が)未発射の|(勘定・借金が)未払いの|(法的に)返済不履行の
cacophonous	不協和音の
irremediable	(病気・悪習・欠点などが)直せない;(失敗・損失などが)取り返しのつかない
styptic	血止めの|(みょうばんなどの)止血剤
leonine	ライオンの(のような)
abscission	切除|切断;分離|離脱
wonderingly	不思議そうに|怪しそうに|驚いて
haversack	《まれ》(兵士の食料・衣類を入れる)雑のう
spiritless	元気のない
caterwaul	(発情期の猫のように)ギャーギャー言う|いがみ合う|ギャーギャー鳴く声
unburden	〜‘の'荷物を降ろす|(打ち明けて)〈心〉‘の'重荷を降ろす|‘を'軽くする|〈悩みなど〉‘を'打ち明ける
tetanic	＜tetanus|破傷風の
paleography	古文書学
congrat	(口語)おめでとう! congratulationsの略
outmost	=outermost
noblewoman	貴族の婦人|高貴の生まれの女性
catcall	(集会などでの)やじの声|口笛|やじる
dishwater	食器を洗った後の汚れ水
anticlimax	漸降法|滑稽な格調低下|大きな期待のあとの失望|竜頭蛇尾|尻すぼみ
gushy	噴出する|感傷的な
lefthander	左ききの人|左腕投手
piggybank	(特に子供が用いる)豚の形をした硬貨用小型貯金箱
unshackle	〜‘を'かせをはずす;〜‘を'解放する
homiletic	説教の
shunter	転轍手(器)　入れ替え用機関車
schmaltzy	ひどく感傷的な
froward	つむじ曲がりの|ひねくれた|強情な
oceangoing	=seagoing
farrago	寄せ集め|ごたまぜ
harrumph	(わざとらしく|または異議を表明して)咳払いする|ぶっきらぼうに示す
whitethroat	ノドジロムシクイ(ヨーロッパ産ののどの白い鳴き鳥)
indelicate	粗野な|ぶしつけな|下品な
venation	脈相(植物の葉脈・昆虫の翅脈などの分布状態)
rangy	歩き回る
ceremonious	=ceremonial1
trollop	だらしのない女|自堕落な女|身持ちの悪い女
pixilated	少し頭が変な|酔っぱらった
unworldly	世間離れのした
colloquialism	口語体の語句|話しことば
maraca	マラカス(リズム楽器)
nark	=narc
guardhouse	衛兵所|留置所
shopworn	(商品など)店ざらしの|(文句･考え)古臭い|陳腐な
delectation	《気どって》喜び|楽しみ
flowerbed	花壇
pyrethrin	ピレトリン(除虫菊から抽出した殺虫剤)
couldst	=couldの二人称単数形
cryonic	Cryonic Preservation(人体冷凍保存技術)
indeterminable	解決できない|決定できない
masterstroke	すばらしいできばえ|みごとな腕前(手腕)
doorknocker	=knocker
kegler	ボウリング競技者|ボウラー(bowler)
prate	《『prate』 『about』+『名』》(〜を)ぺちゃくちゃしゃべる|くどくどと話をする
whithersoever	[〜するところへは]どこへでも
rhythmicity	周期性|リズミカル
cocksure	自信満々の|うぬぼれの強い;(〜に)うぬぼれた《+『of』(『about』)+『名』(do『ing』)》|(〜だと)うぬぼれている《+『that節』》|(〜すると)確信しきっている《+『to』 do》
knish	クニシュ(肉・じゃがいもなどの詰め物を入れて油であげたユダヤ料理)
crammer	詰め込み勉強(一夜づけ)をする人|《話》詰め込み勉強をさせる教師(学校|書物など)
unaccented	強勢(アクセント)のない
moldboard	(うねの土をはね返す)すき板;(ブルドーザーの)ブレード
prokaryote	原核生物|核膜が無い(区別出来る核を持たない)細胞(原核細胞)からなる生物|細菌類や藍藻類が相当する
permeabilization	透過化
bughouse	精神病院
misdirect	あて先を誤る|誤った指導をする
quadraphonic	(録音再生が)4チャンネルの
putout	(野球で打者・走者を)アウト[にすること]
goatherd	ヤギ飼い
doubloon	(スペインなどで昔用いた)ダブロン金貨
planetoid	小惑星・= asteroid
porringer	深皿(特に小児のためのスープ・ポリッジ用)
munificence	気前のよさ|物惜しみをしないこと
latticework	〈U〉格子作り(細工|模様)|〈C〉格子
cautiousness	慎重さ|用心深さ
accounting	会計学|会計|計算
flysheet	(雨天の時テントの上にかぶせる)補助シート
dehumidify	〜‘の'湿気を除去する|'を'除湿する
cockade	花形帽章(階級などを表してつけられたが|現在は装飾用)
inconstancy	変わりやすさ;移り気|浮気
inducibility	誘導能|誘導性
sweeping	おおざっぱな|全面的な|さっと動く|掃除|広範な|ごみくず|十把一絡げ
chromogen	色原体
stalactite	(鍾乳洞で上からつらら状にできる)鍾乳石
groggily	ふらふらして|千鳥足で
benison	《古》祝福
suasion	勧告|説得
impenitent	悔い改めない|改心しない;がん迷な
gayety	=gaiety
moneybox	お金を入れる箱
coordinately	協調
jocularity	〈U〉こっけいさ|ひょうきん|《複数形で》こっけいな(ひょうきんな)言葉(行動)
greaseproof	(紙が)防油脂性の
protactinium	プロトアクチニウム(放射性金属元素;化学記号は『Pa』)
remunerate	(苦労などに対し)〈人〉‘に'報いる《+『名』+『for』+『名』(do『ing』)》|(サービスに対し)〈人〉‘に'報酬を与える《+『名』+『for』+『名』)doing)》
waveband	(ラジオ・テレビなどの)周波帯
cryptographer	暗号使用者
icefall	凍った滝
sadistically	加虐的に
sternness	厳しさ|厳格さ
wisecrack	気のきいた言葉|皮肉|いやみ|皮肉をいう
engross	夢中にさせる
convolute	《まれ》=convoluted
backslide	(悪い方へ)後戻りする
elide	省く|取り除く|削除する|無視する
upchuck	吐く|もどす|〜‘を'吐く|もどす
nearside	《名詞の前にのみ用いて》《おもに英》(馬や馬車の)左側の
busman	バスの運転手(車掌)
witticism	名言|機知に富んだ言葉
tympanum	中耳|鼓膜
trophozoite	栄養体
neurasthenia	神経衰弱
paleface	白人
ingoing	はいって来る
catnap	うたたね|仮寝|うたたねをする
cockfight	闘鶏(試合)
sureness	確実;確信;安全
propertied	財産(資産)のある
tyrannosaur	ティラノザウル(北米の後期白亜紀の地層から発掘された肉食恐竜)
coracle	ヤナギの枝を編み獣皮を張った小船;アイルランドやウェールズの川・湖で用いる
gadabout	(刺激・楽しみを求めて)ほっつき歩く人
disproof	反証[すること]|反ばく;〈C〉反証物件
tootle	くだらないことをしゃべる|だらだらした話|笛などを吹く(こと･音)
airily	軽やかに;快活に|浮き浮きして
primogeniture	長子であること|(またright of primogeniture)長子相続|長子相続権
congruity	〈U〉一致|適合[性]|調和;〈C〉《通例複数形で》一致点|〈U〉(数学で|図形の)合同
reline	〈コートなど〉‘に'裏を付け直す
hypermethylation	高メチル化
comportment	《文》ふるまい|態度
satirize	風刺で攻撃する|皮肉る
foulard	フーラード(柔らかく光沢のある布地)
reface	〜‘に'新しい表面をつける|〜‘の'表面を新しくする
getting	受け
khalif	=caliph
warmhearted	思いやりのある|心の温かい|親切な
cockiness	生意気|うぬぼれ|気どり
nonentity	非実在|取るに足りないこと(状態)
blandishment	ごきげん取り;甘言
streetwalker	売春婦|街娼婦|町の女
remonstrate	(人に〜について)忠告する|抗議する《+『with』+『名』〈人〉+『against』(『about|over』)+『名』(do『ing』)》
actomyosin	アクトミオシン(筋収縮を起こす複合体蛋白質)
perspicuous	(言葉・議論などが)理解しやすい|明快な
getup	(物の)作り|体裁|身なり;(特に)いっぷう変わった服装
improvident	(経済的に)将来への備えを怠る
polygynous	一夫多妻の|(植物が)多雌ずいの
luncheonette	軽食堂
carrycot	(乳児用の)携帯ベッド
rehear	(裁判で)〜‘を'再審理する
crookneck	首が長くねじれたカボチャ
prescript	規定|指令
bonhomie	(仏語)気さく|人のよさ|温容|温厚|快活
overdress	〜‘に'はでな服装をさせる|はでな服装をする
industrialize	産業化する|工業(産業)化する
coelenterate	腔腸(こうちょう)動物
disestablish	〈既成の制度など〉‘を'廃止する|〈教会〉‘の'国教制を廃止する
overact	大げさに演じる|演技し過ぎる|過剰な反応をする|やり過ぎる|演技過剰に陥る|必要以上のことをする
variorum	校異版(本);集注版(本)諸家の注を収めた|集注の　原典の異本を収めたラテン語「異なった(編者)の」の意
cherubic	＜cherub|ケラブ(智天使|9天使中の第 2 位で|知識を司る翼のある愛らしい天使)の|無邪気な
dephosphorylated	脱リン酸化
birdbrain	《俗》うすのろ|まぬけ
rotatory	（形容詞）回転する(させる)　交代する　循環する　輪番の
versification	作詩;作詩法|格調|韻律の形式
egotistic	自己中心の|自分本位の|うぬぼれの強い
incurably	不治で|矯正しようもなく
incontestably	疑いなく|明白に
unfaltering	とまらない|とどまることを知らない|ちゅうちょしない
whippy	(茎・枝・棒などが)しなやかな|弾力性のある
loftiness	非常に高いこと|高尚|高潔|高慢|尊大
predicable	断言(断定)できる
endosymbiont	細胞内共生
sculler	スカル(競走用の軽いボート)|スカルでこぐ人
containerization	コンテナによる貨物輸送
hardtack	堅パン|乾パン
turreted	小塔のある|砲塔(銃座)のある|(巻貝など)塔状の渦巻のある
connotative	含蓄のある|(論理学で)内包的な
acrophobia	高所恐怖症
clownish	おどけ者めいた|こっけいな
overdraw	〈預金・割怒額など〉‘を'超過して借りる;〈小切手〉‘を'過振りする|〜‘を'誇張して描写する
espousal	(支持|主義･説などの)支持|擁護|結婚|婚約
pseudoobscura	ウスグロショウジョウバエ(ハエの一種)
heparinized	ヘパリン(抗凝結成分)化された cf|heparin
redound	(信用・利益などを)高める|増す《+『to』+『名』》
moodily	不機嫌に
solipsist	唯我論主義者|自己中心主義者
purgation	清めること|浄化;浄罪|便通[をつけること]
snick	(はさみなどで)〜‘を'ぱちんと切り取る|〜‘に'刻み目をつける|(クリケットで)〈球〉‘を'切って打つ|ぱちっと切ること;刻み目|(クリケットで)球を切って打つこと
deathblow	致命的打撃|(〜を)終結させるもの《+『to』+『名』》
pollywog	=polliwog
hollo	=hallo
quarterstaff	六尺棒(昔の英国の武器;両端に鉄の金具がついている)
redcap	《米》(駅の)赤帽(porter)|《英》憲兵
winepress	(ワインを作るための)ぶどうしぼり器(おけ)
closedown	(工場・商店などの)閉鎖|操業中止|《英》放送終了
forepart	(ある物の)前部;(ある期間の)初めの部分《+『of』+『名』》
amendable	修正可能な
hardheaded	がんこな|実際的な
ileitis	回腸炎
tidily	きちんと|整然と
seadog	《おどけて》年とった水夫|老練な水夫
odalisque	オダリスク|昔のイスラエル国の女奴隷
conferee	会議出席者|受領者|授与される人|相談相手|評議員
snappish	(犬など)かみつく癖のある|がみがみ言う|おこりっぽい
superannuate	〈人〉‘を'老齢(病弱)のため退職させる
gangplank	道板(みちいた)(船から桟橋へ渡して客の乗降に使う移動式の橋)
parquetry	寄せ木細工|(床の)寄せ木張り
tiredly	疲れて;飽きて
stalking	ストーキング|つけ回すこと(他人の意思を構わぬ異常な行為)
sniffy	鼻であしらう|高慢な|軽べつした|《英》悪臭を放つ|臭い
mesospheric	中間圏の
amiability	感じのよさ;気だての優しさ;温和;温厚
shortening	ショートニング(舌ざわりをよくするためのバターやラードなど)
incapability	できないこと|不能|無能|不適格
psalmody	〈U〉聖歌吟唱[法]|〈C〉(符面つきの)聖歌集|賛美歌集
casualness	偶然|むとんじゃくさ;さりげなさ
wickerwork	枝編み細工|柳細工
kynurenine	キヌレニン|トリプトファンからナイアシンを生合成する際の中間体のひとつで|アミノ酸のひとつ
gussy	〈物・自分〉‘を'飾りたてる《+『up』+『名』|+『名』+『up』》
ballclub	球団
mispronounce	発音を誤る
standoffish	冷淡な|よそよそしい(aloof)
punctilious	作法にやかましい|形式ばった|きちょうめんな
egotist	自己中心癖の人|自尊家|利己主義者
peregrination	旅行|遍歴
nuttiness	木の実が多いこと|木の実のような風味
curbstone	(歩道の)縁石(《英》kerbstone)
importunity	しつこさ;《複数形で》しつこい要求(嘆願)
heterochromatic	異色の
moil	あくせく働く
waxwork	ろう細工;ろう人形|《複数形で》《単数扱い》(特に有名人の)ろう人形博物館
ailanthus	ニワウルシ(羽状の葉と緑色の小さな花を咲かせる)
bewitch	に魔法をかける
sentimentalism	感傷(感情)主義;涙もろさ
ichor	イコル(ギリシア神話で神の体中を流れているとされる霊液)
almandine	アルマンディン;鉄礬柘榴石(てつばんざくろいし)
eaglet	ワシの子
tinsmith	ブリキ屋|錫(すず)細工師
privily	ひそかに|内密に
ungenerous	物惜しみをする|けちけちする|不当な|不正な
medlar	西洋カリン(野生のリンゴのような実をつける小木;その実)|臭い人
desideratum	必要な物|なくては困る物
spectrophotometrically	分光光度法で
outbred	異系交配の
excursus	(本の巻末につけた)詳説|補説
thermidor	テルミドール|フランス革命時|革命歴の11番目の月(7月と8月)を指す|熱月と呼称
endotoxemia	エンドトキシン中毒症|内毒素血症|エンドトキシン血症
flashgun	閃光(せんこう)装置(カメラのシャッターを切ると同時にflash bulbを発火させる装置)
castanet	カスタネット
cockatrice	コカトリス(伝説上の怪物;頭・足・翼は鶏|胴と尾は蛇)
eccentrically	風変わりに|偏心(離心)的に
rearmost	最後尾の
coffeecake	コーヒーケーキ(ナッツと干しぶどうを入れたケーキパン)
viscountess	子爵夫人;女子爵
conventionality	〈U〉型にはまっていること|月並み|〈C〉《しばしばthe conventionalitiesで》しきたり|風習|慣例
quicklime	生石灰|酸化カルシウム|化学式CaOで表される化合物
firebase	砲兵隊基地|発射基地
uncommunicative	打ち解けない|話したがらない|無口な
borstal	感化院|少年院
twelvemonth	1年(a year)
broadminded	(心が)寛大な|偏見のない|心の広い(liberal)
caecum	=cecum
wistfulness	あこがれの|ものほしそうな|物悲しいこと
catlike	猫のような|ゆだんのない;足音を忍ばせた
munificent	非常に気前のよい|物惜しみをしない
phut	ポン|パン(なにかが破裂するようなにぶい音)
dovish	ハトのような|ハト派的な|穏健派の|hawkish
cesspit	汚物だめ|(一般に)汚い場所
eglantine	イバラ
greenroom	出演者控室|楽屋
uncrowned	[まだ]王冠を戴かない（いただかない）|王位につかずに実権を持つ
faddish	一時的に熱中する(流行する)|気まぐれな
upregulate	上方制御する
threnody	哀歌|悲歌|挽歌
malefactor	悪人|犯人
dotage	もうろく|老いぼれ
palliate	〈罪・過失など〉‘を'軽く見せかける|弁解する|(一時的に)〈病気など〉‘を'和らげる
euphonious	響きのいい|耳に快い|口調のよい
oxyacetylene	酸素アセチレン
teenybopper	ティーニーボッパー(ロックやファッションに熱狂する少女)
hydrophobia	恐水病;狂犬病(rabies)
predetermination	宿命|運命づけられていること
unmethylated	非メチル化
vocative	呼格(の)|呼びかけの
venturesome	冒険的な|大胆な|冒険好きな
plodder	とぼとぼ歩く人|こつこつ働く(勉強する)人
muskmelon	マスクメロン(表面に網の目模様があり甘い果物)
suppuration	うみ|化膿
forcefulness	力強さ
incomprehensibly	不可解にも
fusillade	一斉射撃|一斉攻撃
shininess	輝かしさ|すばらしいこと
ropeway	(工場・鉱山などの重量物運搬用)ロープウエイ
hogback	けわしい尾根|(地質用語で)丘
underclothes	下着|肌着(underwear)
parve	(ユダヤ教で)精進料理の(原料に獣肉や乳を用いない)
transliterate	〜‘を'字訳(音訳)する
bareheaded	帽子をかぶらない|無帽の|(敬意を表して)脱帽して|帽子をかぶらないで
hemstitch	ヘムステッチ(横糸または縦糸を数本抜きその部分をかがって|ハンカチ|テーブル掛けのへりを飾るかがり方)|〈布など〉‘に'ヘムステッチをする
moneylender	金貸し|金融業者|高利貸し|質屋
phenacetin	フェナセチン(鎮痛・解熱剤)
sego	セゴユリ(米西部産のユリの一種|球根は食用;Utah州の州花)
baffler	挫折(ざせつ)させる人(もの);困らせる人(もの)
lightshow	ライトショー(エレキバンドの伴奏によるライトを使った光のショー)
dayflower	ツユクサ(小さい青色の花をつける1日咲きの植物)
peignoir	(婦人用)化粧着|部屋着;(水泳後・湯上りに着る)ガウン
astringency	収れん性(皮膚をひきしめる性質)|きびしさ|厳格
gunge	=gunk
insufferably	たまらなく|我慢できなてほどに
aviatrix	女流飛行家
draftee	調整された者|応召兵
safecracker	金庫破り(《英》safebreaker)
asepsis	無菌状態
parlous	(国際関係など)危険をはらんだ|不安定な
pallbearer	(葬式で)棺のそばに付き添う人;《米》棺をかつぐ人
foreleg	(動物の)前脚
lenity	慈悲|寛容
predestinate	=predestine
inkpot	インクつぼ|インクびん
muscleman	筋肉人間(特別な訓練により筋肉を発達させた人)|《米》暴力団員
imper	imperative
rewatch	再見する
cuspid	(人間の)犬歯
chasuble	上祭服(ミサで司祭が着る袖のないゆったりした祭服)
angularity	〈U〉かどのあること|〈U〉やせて骨ばっていること|〈U〉ぎこちなさ;がんこさ|《複数形で》かど|ぎざぎざ
shillelagh	(オーク製などの)こん棒
outvote	〜‘に'投票で勝つ
vituperative	ののしりの|痛烈な|毒舌を振るう
unsubstantial	がんじょうでない|もろい|弱い|実質(実体)のない;非現実的な|空想的な
inwardness	霊性|精神性|真意
proselyte	改宗者;転向者|=proselytize
authoress	女流作家
etiolate	(光をあてずに)〈植物〉‘を'白く生長させる
outmatch	(試合などで)〜‘を'負かす|〜‘より'まさる
pleasantry	冗談|おどけた言葉|礼儀上の言葉
squareness	方形|四角;直角であること|公正|正直;きちょうめん
syllogistic	三段論法の;演繹(えんえき)的な
denominate	に命名する
prizefight	懸賞のつきのプロボクシング試合
ultraconservative	極端に保守的な(人)|超保守的な(人)
dhoti	ドーティ(インドの男子が着用する腰布)
captivation	魅惑
redbreast	胸の毛が赤い鳥;(特に)コマドリ(robin)
longwinded	息の長く続く|(話・文章などが)長たらしい|冗漫な
archaebacterium	古細菌
kepi	ケピー帽(上が平らで筒型のフランスの陸軍帽)
pestilent	死をもたらす|致命的な|悪影響のある|《話》やっかいな|うるさい
companionway	(船の)甲板昇降口の階段
bafflement	挫折(ざせつ)|失敗
countrified	(人が)いなかじみた|やぼな|(けしきなどが)ひなびた
jollity	愉快|陽気
nugatory	無価値の|取るに足らない|効力のない
transformant	形質転換体(外部からDNAを取り込んだりすることにより形質が変化した個体や細胞)
kalends	=calends
porkpie	《主に英》豚肉パイ
nitrify	〜‘を'硝化する|亜硝酸に変える|〜‘に'窒素[化合物]をしみこませる
amanuensis	筆記者|筆耕|写字生
dreariness	わびしいこと|退屈させること
downhearted	落胆した|元気のない
velum	軟口蓋;(動物の)菌膜;(クラゲの)縁膜
chessman	チェスのこま
trireme	(古代の)三段オールのガリー船
exotically	異国ふうに
stalagmite	(鍾乳洞の床から上に成長していく)石筍
penetrable	貫ける;浸透できる;見抜ける;(〜を)貫く|(〜に)しみ込む《+『to』+『名』》
outguess	〜‘を'出し扱く|‘の'裏をかく
taproom	=barroom
mischance	不運|不幸|災難|不運な(不幸な)でき事
hospitably	あいそよく|手厚く
metaphysician	形而上学者
muumuu	ムームー(特にハワイの婦人が着るゆったりした服)
insouciance	(仏語)むとんじゃく|平気|気楽な|心配のない|無関心
chasten	懲らしめる|鍛える|抑制する
discourtesy	〈U〉失礼|無礼|無作法|〈C〉無礼な行為|失礼な言動
pantaloon	《複数形で》19世紀に男性が着たぴったりしたズボン;《話》だぶだぶのズボン(baggy trousers)|《P-》(パントマイムで|道化役(clown)にからかわれる)老いぼれ役
velocipede	(足で地面をけって進む)昔の自転車;《古》《時にふざけて》自転車|《米》子供用三輪車
handwrite	〜‘を'手書きする
palpitate	〈心臓が〉動悸(どうき)を打つ|どきどきする|《文》(〜で)〈人・体が〉震える《+『with』+『名』》
vagary	気まぐれ
foppish	(男･衣服など)おしゃれな|にやけた
extravascular	血管外の
reanimate	〜‘を'再び元気づける(勇気づける)|‘に'生気を与え直す
sunlamp	(医療などに用いる)太陽灯
scoffer	嘲笑する人
bioclean	有害な細菌が[ほとんど]ない
insanitary	非衛生的な|健康によくない(unhealthy)
ennoble	高尚にする
arrivederci	さようなら
panegyric	〈C〉(人・物に対する)賛辞《+『on(upon)』+『名』》|〈U〉高い賞賛|(時に)法外な賞賛
profanation	〈U〉神聖を汚すこと|冒瀆(ぼうとく)|〈C〉冒瀆行為
messuage	(法律用語で|付属の建物や庭園・土地を含む)家屋敷
jinn	(イスラム教)精霊|幽鬼
mistranslate	〜‘を'誤訳する|誤訳する
intermarry	(異なる人種･階級の人と)結婚する|近親結婚する
cantharis	=Spanish fly
imprecation	祈ること|呪い
disunite	〜‘を'分離させる|分裂させる|分離する|分裂する
bracero	(米国へ農作業に来る)メキシコ人季節労務者
highboy	脚付きの高い洋だんす
parky	(空気などが)ひんやりとした|冷たい
corncrake	ウズラクイナ(ヨーロッパ産のクイナ科の小鳥)
obscurantism	反啓蒙主義|教化(開化)反対|故意にあいまいにすること
astrodynamics	天体力学
lilliputian	リリパット島(Swift原作のGulliver's Travelsの中の小人の国)の|小人国の住民|小人|リリパット人|狭量な人|つまらない人
murderess	(女の)殺人者
emulsify	〜‘を'乳状(乳剤)にする
gallinule	ガリヌール(ガンの類の水鳥の一種;脚が長い)
whop	《話》〜‘を'強く打つ|《俗》(競技などで)〜‘を'完全に負かす|《米》ドシンと倒れる|強打|一撃
radicle	幼根|胚根
carminative	胃腸内のガスを排出する|駆風剤
downscale	ダウンスケール
lengthways	=lengthwise
atavism	隔世遺伝|先祖返り
counteraction	反作用|(計画などの)阻止|(薬の)中和作用
fruitfly	ショウジョウバエ
einsteinium	アインスタイニウム(放射性元素;化学記号は『Es』)
prepack	=prepackage
whinny	馬の鳴き声|ヒヒーン
fortuneteller	占い師
kneepad	ひざ当て
darkish	薄黒い|黒ずんだ|黒味がかった
bungler	へまをする人|不器用な人
autosome	常染色体
petrify	〈有機物など〉‘を'石化する|化石にする|(恐怖・驚きなどが)〈人〉‘の'体を石のようにする|すくませる|〈有機物などが〉石化する|〈人が〉身をすくませる
giddily	めまいがして|目が回って|軽薄に|うわついて
futurology	未来学
blastoderm	胚盤葉
allopatric	異所的な|異所的種分化(ギリシャ語allos=other|patris=fatherland)|同じ生物学的集団に発生する隔離的な種分化
glaucomatous	緑内障の
tumbledown	(建物など)今にも倒れそうな|荒廃した
dustbowl	(砂あらしの吹く)黄塵(じん)地帯
hauberk	(中世の戦士の)鎖かたびら
costimulation	同時刺激|共刺激の意
unspotted	《古》道徳的に潔白な|非の打ち所のない|はん点のない|まだらでない
rankle	苦しめる
unseal	〜‘の'封を切る|‘を'開封する;〜‘を'開く(open)
pratfall	尻もちをつく(こと)|ヘマ
sweetish	やや甘い
iamb	=iambus
antinomian	道徳律超越(廃棄)論者(キリスト教徒は福音書の中の神の恩寵によって道徳律に束縛されないと主張する人)
fiver	5ドル(ポンド)紙幣
misinform	に誤りを伝える|誤解させる
bounden	義務的な|必修の
unexampled	前例のない|空前の
interpenetrate	〜‘に'十分浸透(貫通)する|十分に(相互に)浸透(貫通)する
serape	セラーベ(ラテンアメリカで用いるはでな色彩肩掛けまたはひざ掛け)
tearless	涙を流さない|泣けない|目にしみない
accessary	=accessory
icily	氷のように冷たく|冷淡に
parallelepiped	平行六面体
acus	(acūs)|針(needle)|千枚通し
archimandrite	〈C〉修道院長|〈U〉独身のすぐれた聖職者に贈られる称号
vermiform	(形が)虫状の
tackiness	ねばっこさ
dishpan	洗いおけ
bookstall	[古]本の露店|《英》(駅の)新聞[雑誌]売店(《米》newsstand)
hipbone	座骨|無名骨《腸骨・坐骨・恥骨からなる》
adulterate	(粗悪なものを)〜‘に'混ぜて品質をおとす《+『名』+『with』+『名』》
tearsheet	(新聞･雑誌などの)はぎ取りページ
vamoose	急いで立ち去る
kleptomaniac	盗癖のある人
stoical	ストア派哲学の|禁欲の
tegument	おおい|外被(integument)
aptness	(〜の)適性|才能《+『for』+『名』》|(〜する)傾向|性向《+『to』 do》
malediction	《文》のろい|のろいの言葉(curse)
discreditable	不名誉な
unseeing	目で見ていない|気づいていない
bootee	婦人(子供)用の毛糸編みの靴
jellyroll	ゼリーロール(ゼリーを塗った渦巻き形のケーキ)
flyswatter	はえたたき
derisory	嘲笑すべき;取るに足りない|つまらない
mutualist	相互主義者
portraitist	肖像画家|人物写真家
clonus	(病)クローヌス|間代(かんたい)性けいれん(ある種の神経病のため筋肉の収縮と弛緩が急激に交互に起る症状)
everglade	沼沢地
fainthearted	気の弱い|臆病な
obsequy	葬式|埋葬式
fireboat	消防艇
trapshooting	クレー射撃|トラップ射撃
fishwife	魚売り女|がみがみ女
disconcertingly	面くらわせるほど|まごつかせるように
antipope	対立教皇(教会法に基づいて選挙された教皇に対立して教皇であると主張する人)
jaywalker	(交通ルールを無視した)不注意な(乱暴な)横断者
oversell	売りすぎる|から売りする
bastardization	低下|堕落
upstroke	(特に)上へ向けた筆使い|(運筆の)はね
implausibility	信じがたいこと|本当らしくないこと
peristyle	(建物･庭などを取り囲む)柱列|柱列に囲まれた空間
witchdoctor	(原始社会の)まじない師|祈とう師
twirler	(バトンなどを)くるくる回す人
idolater	偶像崇拝者|(一般に)崇拝者|心酔者
publishing	出版する|出版業
porphyritic	斑岩(はんがん)の|斑岩のような
soldierly	軍人らしい|勇ましい|きりっとした
handclap	拍手|手拍子
pongee	絹紬(けんちゅう)(生糸を使った薄茶色のややあらい絹織物)
intercalary	間に入りこんだ|間に挿入された|(日・月・年が)うるう(閏)の
hammerlock	(レスリングで)腕固め(相手の片腕を背中にねじ上げる技)
biotinylation	(生化学)ビオチン標識|ビオチン化
racialism	民族優越観|人種差別|人種差別主義 cf|racism
perquisite	《話》臨時収入;(合法的な)役得
concretion	〈U〉凝固;〈C〉凝固物|〈C〉腎臓結石
danseuse	女子のバレエダンサー
partitive	部分を表す|〈C〉(文法で)部分語(any|few|someなど)
aftereffect	後遺症|残効
forelock	前髪
gormless	愚かな|間抜けな
zingerman	ジンジャーマン(ショウガ入りの焼きクッキー)
jauntily	のんきそうに|陽気に;元気に;気どって|いきに
declivity	下り勾配(こうばい)
nursemaid	子守女
demister	=defroster
moppet	人形|おちびさん|お嬢ちゃん|女々しい男
quirt	編み皮の乗馬むち
paralogous	遺伝子が種分化でなく|重複によって生じた|パラロガスな
dizygotic	二卵性の
suburbanite	郊外居住者
churl	無作法者|いなか者
assonance	音の類似|(特に)母音の類音
furbish	〈剣など〉‘を'研ぐ|〈銀器など〉‘を'磨く《+『up』+『名|』+『名』+『up』》|〈長い間放置していたもの〉‘を'一新する|‘に'磨きをかける《+『up』+『名|』+『名』+『up』》
bridgework	《おもに米》(歯の)ブリッジ技工|橋義歯
forebear	祖先
cementum	(歯の)セメント質
abstainer	節制する人|(特に)禁酒する人
extravert	=extrovert
fussiness	小うるさいこと|口やかましさ
sarky	=sarcastic
distain	(〜を)差し押さえる《+『upon』+『名』》|〜‘を'差し押さえる
heartsick	悲嘆に暮れた|意気消沈した
alveolus	胞|肺胞|腺房|歯槽|小窩|歯ぐき
sherd	=shard　破片　かけら
archly	いたずらそうに|ちゃめっぽく|ずるそうに
statesmanlike	政治家らしい
bhang	インド大麻|(インド大麻から作る)麻薬|麻酔剤
commonness	普通[であること]|平凡さ
dunghill	(農場の)ふんの山|墜落した状態(場所)
distraint	動産の差し押さえ
coati	ハナグマ(熱帯アメリカに住むアライグマ類の肉食動物)
undersurface	下面|底面|水面下の|水中の
wardship	後見(保護)を受けている状態
barkeeper	バーの経営者|バーテン
epifluorescence	落射蛍光顕微鏡(蛍光物質で染色された試料などを観察するための顕微鏡)
liveried	お仕着せ(livery)を着た|そろいの服を着た
outwork	〈人〉‘より'よけいに働く|いい仕事をする|《複数形で》外塁|〈U〉屋外の仕事
crudity	〈U〉天然のままであること|なま[の状態]|〈U〉未熟;〈C〉未熟なもの|〈U〉粗雑|粗野;〈C〉粗雑(粗野)なもの
ablate	除去する
modish	流行を追う|現代風の
indention	〈U〉)節の第1行目の)字下げ|〈C〉字下げ分の空白|〈C〉《古》ぎざぎざ|刻み目
thenceforward	thenceforth
freethinking	(宗教について)自由思想を持った|(宗教的束縛を受けない)自由思想
trug	(庭園で)花・道具を入れるかご
honeymooner	新婚旅行者
sutler	(昔の)従軍商人|酒保商人(軍隊について歩いて品物を売る商人)
hempen	麻製の
inexcusably	言い訳のたたないほど
recalcitrance	手に負えないこと|強情|反抗
decrepitude	老衰
shoreward	岸のほうへ|岸(陸)へ向かう|岸(陸)に面した
suggestible	(人が)暗示にかかりやすい|影響を受けやすい|提案(暗示)できる
acquiescent	黙認の|甘受する
scatterbrained	散漫な|軽率な|うわついた
polymorphous	多形の|多様な
stinginess	けち|しみったれ|物惜しみ
sinecure	(実務はないが報酬のある)閑職
chordate	脊索動物|動物の分類群のひとつ|ヒトなど脊椎(背骨)をもつ脊椎動物と|近縁の原索動物(ナメクジウオなどの頭索動物とホヤ類などの尾索動物)を合わせたもの
enucleated	(生命科学)細胞から核を除去する|眼球除去する 他
hatpin	婦人帽の留め針
underrate	過小評価する
wiglet	(女性用)ヘアピース
extralegal	超法規的
merrymaking	浮かれ騒ぐこと|お祭り騒ぎ
pardonable	許せる
alongshore	海岸に沿った|磯(いそ)伝いの|海岸沿いに
choleric	怒りっぽい
incarnadine	〜‘を'赤くする|朱に染める
mewl	赤ん坊の泣き声|弱々しく泣く
beggary	貧困|赤貧|さもしさ|卑劣
doodad	(小さな|安っぽい)飾り|(何とかいう)代物|仕掛け|(～s)がらくた
fettle	(心身の)状態
poolroom	玉突き場;公開賭博場
exordium	(演説・論文などの)導入部|前置き
redcurrant	アカフサスグリ(低木に一種)|その赤い実
tocsin	ベルによる合図;(特に)ベルによる警報|警鐘
dimity	(ベッドカバー・カーテンに用いる)浮きじま綿布
palpate	〜‘を'触診する
sidesaddle	横くら(両足を同じ側に下げる婦人用くら)|(馬に)横乗りに
catarrhal	カタル性の
cobuild	コウビルド英英辞典|Collins社のCOBUILD Dictionary of American English|Cobuildは共に作る|の意
coevolutionary	共進化
broadness	広いこと|広大|寛大|露骨|あけすけ
creaminess	クリーム状(クリーム色)であること
bacchanalian	バッカス祭の|どんちゃん騒ぎの
syllabary	音節[文字]表(日本語の五十音図など)
paunchy	太鼓腹の|ほてい腹の
workshare	ワークシェア
despond	落胆する
pustule	膿疱(のうほう)(うみ(pus)をもったできもの)
suspensory	(ひも・筋肉・包帯などが)懸垂式の|中止の|停止の
lionize	(人を)かつぎあげる|名士扱いにする
forwardness	(季節の訪れ・作物のできなどの)早さ;(子供などの)早熟|出しゃばり|厚かましさ
testily	短気に|いらいらして
disapprovingly	不賛成の考え(立場)で|非難をこめて
pardoner	許す人|(中世の)免罪符売り
unfasten	〈結んだもの・締めたもの〉‘を'解く|緩める;開ける|〈自〉|〈結んだものなどが〉解ける|緩む
tatter	〈C〉(1片の)ぼろ|ぼろ切れ|《複数形で》ぼろ服|〜‘を'ぼろぼろに破る
windflower	アネモネ
precocity	早熟
underachieve	(特に学業で)水準以下の成績をとる
backstay	後方索(帆船のマストを両舷後方より支える綱)
denaturant	(物質の性質を変える)変性剤
difluoride	oxygen difluoride|二フッ化酸素(化学式OF2)|常温で異臭ある気体|ガラスを侵さずフッ化酸素中最も安定しているが|酸化力が強く水蒸気と混合し室温で爆発する
semipermeable	(膜などが)半透性の
spasmodically	けいれん的に|発作的に
collocate	〜'を'いっしょに置く|一まとめにする;〜'を'配列する|〈語が〉(他の語と)連語をなす《+『with』+『名』》
wingspread	(鳥・飛行機などの)全翼長|翼幅(翼を広げたときの両端の間の長さ)
goalmouth	(サッカーの)ゴールマウス(goal postで囲われた部分)
intermembrane	膜間(の)
varlet	ならず者|悪漢
prevision	〈U〉(〜の)予知|事前の知識《+『of』+『名』》|〈C〉(〜の)予感|虫の知らせ《+『of』+『名』》