poorhouse	(昔の)救貧院
decisiveness	勇決
nationalize	国有(国営)にする
blenny	small usually scaleless fishes with comb-like teeth living about rocky shores; are territorial and live in holes between rocks|small usually scaleless fishes with comb-like teeth living about rocky shores|are territorial and live in holes between rocks
photic	of or relating to or caused by light
folksong	民謡|フォークソング|民謡調の歌
lifejacket	救命胴着
inflectional	語形変化する|屈折の
slaver	よだれを流す|奴隷売買者
succinic	of or relating to or obtained from amber
cyanobacterial	藍色細菌の
umpteen	非常に多くの
disrobe	衣服を脱ぐ
tingly	ゾクゾクする|ヒリヒリする
tellingly	in a telling manner; "the plain manner of its style all the more tellingly points up the horror of the case"|in a telling manner
stoner	an attacker who pelts the victim with stones (especially with intent to kill)
octogenarian	80歳(代)の
nefazodone	ネファゾドン
abiogenesis	自然発生説|自然発生
euonymus	widely distributed chiefly evergreen shrubs or small trees or vines
superego	超自我|super-ego
improbability	ありそうもないこと|本当らしくないこと
shrewdly	抜け目なく|利口に
provocatively	in a provocative manner; "`Try it,' he said provocatively"|in a provocative manner
lathyrus	レンリソウ属
epilog	エピローグ
vocationally	職業的|職業上
proventil	アルブテロール
meed	相応(当然の)報酬|正当な報い
waggle	揺れる|振れ|揺れ動く|を振る|揺する|振れる
undrained	非排水
impish	茶目な|鬼の|腕白な|ちゃめな
seneschal	(中世の王族・貴族の)執事|家令
nonpolar	非イオン
tetrodotoxin	テトロドトキシン
ergotamine	エルゴタミン
descant	(定旋律につく)随唱|随奏|随唱(奏)する|《文》(〜について)長々と(詳しく)述べる《+『on』(『upon』)+『名』》
affenpinscher	アーフェンピンシャー
mintage	〈U〉化幣鋳造|《集合的に》鋳造された貨幣|〈U〉貨幣鋳造費|〈C〉貨幣の極印(品質証明のために押す)
dysthymia	気分変調
bushwhack	〜'を'やぶにひそんで襲う|森林地を切り開く
dejection	落胆
kiang	wild ass of Tibet and Mongolia
psychogenic	心因性の(精神・心理作用から生じる)
distractor	気を散らすもの|誤った選択肢.
umma	ウンマ
tattler	おしゃべりな人;他に秘密をもらす人
ritually	in a ceremonial manner; "he was ceremonially sworn in as President"|in a ceremonial manner
greenside	adjacent to a putting green; "greenside bunker"|adjacent to a putting green
nitwit	まぬけ
prophetess	(女性の)預言者|予言者
meninx	髄膜
ghrelin	グレリン|胃から産生されるペプチドホルモン|成長ホルモン(GH)分泌を促進し|食欲を増進させる働きを持つ
carbonize	炭化|炭化
distension	膨張
pneumococcus	肺炎球菌
funereal	葬式の|しめやかな|悲しい|陰うつな
mealybug	scalelike plant-eating insect coated with a powdery waxy secretion; destructive especially of fruit trees|scalelike plant-eating insect coated with a powdery waxy secretion|destructive especially of fruit trees
ileostomy	surgical procedure that creates an opening from the ileum through the abdominal wall to function as an anus; performed in cases of cancer of the colon or ulcerative colitis|surgical procedure that creates an opening from the ileum through the abdominal wall to function as an anus|performed in cases of cancer of the colon or ulcerative colitis
humorless	ユーモアのない
hotcake	ホットケーキ
paresthesia	abnormal skin sensations (as tingling or tickling or itching or burning) usually associated with peripheral nerve damage
demesne	(封建領主・貴族などの)私有地|領地
briny	海|大洋|塩辛い|塩水の|海の|涙の
nimbly	すばやく
gossypium	ワタ
ludicrously	ばかばかしいほどに|ばかばかしいほど|ばかみたいに|ばかげて
autogenous	originating within the body
holoenzyme	ホロ酵素|(酵素本体となるタンパク質分子に|非タンパク質性の分子が結合して初めて酵素として機能するものを呼ぶ)
bloodstained	血痕のついた
unfix	〜‘を'はずす|緩める|〈心・気持ち〉‘を'ぐらつかせる
hytrin	テラゾシン
clansman	氏族の一員;同氏族の人
miconazole	ミコナゾール
gunwale	舷(げん)の上縁|船べり
dermatomyositis	皮膚筋炎
catchup	ケチャップ|ketchup
chicanery	ずるい言い抜け|ごまかし
counterspin	反回転
disastrously	悲惨に
upend	を逆さまに置く(立てる)|ノックダウンする|負かす
turnstone	キョウジョシギ
enterocolitica	Yersinia enterocolitica|(食中毒原因菌)エンテロコリチカ菌|(エルシニア･エンテロコリチカ)
hematoxylin	ヘマトキシリン|アカミノキの心材から抽出される染料|媒染剤により色調が異なり青白色や青黒色となる
formamide	ホルムアミドはギ酸から誘導されるアミド|サルファ薬の製造やビタミンの合成|紙や繊維の柔軟剤に使われる
acquisitive	欲ばりの|欲深い
boffin	科学者
dago	《軽べつして》スペイン(ポルトガル|イタリア)系の人
pressgang	水兵強制徴募隊(18世紀に英国海軍が兵集めに組織した)|《話》(部隊などへ)〜‘を'強制編入させる《+『名』+『into』+『名』》
laburnum	キングサリ(マメ科キングサリ属の有毒な小さい木)
heterodox	異端の
manque	unfulfilled or frustrated in realizing an ambition
accommodative	協調的|調和的
daikon	ダイコン
codfish	鱈|タラ|タラ
outwear	〜‘より'長もちする|〜‘を'着古す|使い尽くす
doublespeak	ダブルスピーク
cagey	抜け目のない
swaddle	赤子を産着(細長い布)でくるむ|(to swaddle a baby)
debility	(病気による)衰弱
magnifico	a person of distinguished rank or appearance
copulate	交尾する
depressor	any skeletal muscle that draws a body part down|any nerve whose activity tends to reduce the activity or tone of the body part it serves|a device used by physician to press a part down or aside
proprioceptive	of or relating to proprioception
disenfranchise	(個人から)公民権(選挙権･公職権)を奪う
gastrostomy	surgical creation of an opening through the abdominal wall into the stomach (as for gastrogavage)
tackler	a football player who tackles the ball carrier
tromp	殴る|ぶちのめす|完敗させる|打つ
archaeon	archaea(古細菌)の単数形
dully	不活発に
mammalogy	the branch of zoology that studies mammals
seethe	沸騰する|泡立つ|腹をたてる
shorthorn	ショートホーン(短い角を持った英国原産の肉牛)
atopy	アトピー
asphodel	アスフォデル(白・ピンクまたは黄色の花をつけるユリ科の植物)
minutia	(〜の)細目|詳細|ささいなこと《+『of』+『名』》
compassionately	in a compassionate manner; "the nurse looked at him pityingly"|in a compassionate manner
hussar	(はでな姿の)軽騎兵
scow	大型平底船
copyist	写字生|筆耕|謄写人|模倣者
biographic	of or relating to or being biography; "biographical data"|of or relating to or being biography
depredation	[通例複数形で] 略奪行為|破壊
itemization	箇条書き
espadrille	エスパドリーユ(キャンバス地で底の平らなサンダル)
insignia	記章|勲章|バッジ|しるし
bootlegger	(コンピューターソフトウェアなどの)違法コピー業者
satiate	=sate
ruanda	ルワンダ
phasic	相の
lumberman	材木切り出し人;材木商
sanitarian	[公衆]衛生の|公衆衛生学者
remorseful	後悔している
admonishment	=admonition
traditionalism	(宗教上の)伝統尊重主義
obstinately	飽くまで|頑として|飽く迄
straightness	善意|誠意|実|異性愛
midplane	正中線
crosslink	架橋
aggrandizement	大きく見せること|誇張すること
explainable	説明できる;弁明しうる
groupthink	集団思考
impermanent	永続しない|一時的な
unpopularity	不人気|不評判
donkin	ドンキン
ragamuffin	ぼろを着た子供(人)
paraformaldehyde	パラホルムアルデヒド|パラホルムともいう|ホルムアルデヒドの重合体
disgorge	吐き出す
unfree	held in servitude; "he was born of slave parents"|held in servitude|hampered and not free; not able to act at will|hampered and not free|not able to act at will
chiropody	podiatry
roughshod	(馬が)滑り止めのてい鉄を付けた
loner	一人で居たい人|孤独が好きな人
heterodyne	of or relating to the beat produced by heterodyning two oscillations|combine (a radio frequency wave) with a locally generated wave of a different frequency so as to produce a new frequency equal to the sum or the difference between the two
beanery	安い二流のレストラン
oncologic	of or relating to or practicing oncology; "oncological nurse"|of or relating to or practicing oncology
skinner	皮をはぐ人|毛皮商|荷車用家畜の御者|詐欺師
moolah	お金|銭|現なま|金
fingerling	a young or small fish
hafnium	ハフニウム(金属元素;原子記号は『Hf』)
ebullient	沸きこぼれる|沸騰している|あふれるばかりの|ほとばしり出る
ormandy	オーマンディ
tropism	向性|屈性(植物が一定の刺激の方へ|または反対方向に成長する性質)
murex	ホネガイ(熱帯地方の海産巻き貝の総称;古代人はこれから紫色染料を採った)
thermionic	熱イオンの
shantung	山東絹|シャンタン(つむぎ風の平織絹布)
genic	of or relating to or produced by or being a gene; "genic combinations"; "genetic code"|of or relating to or produced by or being a gene
busload	the quantity of cargo or the number of passengers that a bus can carry
grotesquely	恐ろしく|怪奇に|ひどく|気味悪く
spheroidal	having the nature or shape of an ellipsoid
cardura	ドキサゾシン
swelling	膨れる|隆起した|はれ|はれもの|こぶ|腫脹
thioridazine	チオリダジン
tiptop	絶頂|全盛|最高級の|すてきな|優秀な
teensy	ごく小さい
vacationer	休日の行楽客
fillip	活気づけるもの|刺激|指はじき|コツンと打つ|喚起する
niceness	きちょうめんさ
immunochemical	of or relating to immunochemistry
nacre	=mother-of-pearl
nuncio	(外国の宮廷・政府に駐在する)ローマ教皇大使
patois	(仏語)地方なまり
prunella	プルネラ|プルネラ
thereat	そこで|その時|そのために
unchurch	破門
phalarope	ヒレアシシギ(イソシギに似た小型の水鳥)
aragonite	アラレ石
vesey	ビージー
airbed	空気ベッド
rotenone	ロテノン
sachem	(北米インディアンの)首長
entwine	にからみつく|絡み合わせる|絡ませる|絡まる
senescent	初老の|老境にかかった
intemperate	不節制な|酒におぼれた
kelpie	(Scottish folklore) water spirit in the form of a horse that likes to drown its riders|water spirit in the form of a horse that likes to drown its riders|an Australian sheepdog with pointed ears
compunction	良心の呵責|悔恨
teleology	(哲学で)目的論;目的存在説
microbicide	殺菌剤･殺菌薬
velociraptor	ヴェロキラプトル
unceasingly	止め処無く|留処無く|続続|のべつ幕なし|打っ続け|引きも切らず|蜿蜒|留め処なく|縷縷|止めどなく
mycotoxin	マイコトキシン
moviegoer	よく映画を見に行く人|映画ファン
frightfully	恐ろしく
teleostei	large diverse group of bony fishes; includes most living species|large diverse group of bony fishes|includes most living species
catalytically	触媒
karakoram	カラコラム山脈
fierceness	凶暴さ;猛烈さ
temporality	the worldly possessions of a church
unpleasantly	不快に
shrinkable	capable of being shrunk; "a shrinkable fabric"|capable of being shrunk
spectacled	めがねをかけた|(動物が)めがね状の斑紋点のある
habitability	suitability for living in or on
mickle	多量|許多|山積み|百千|山盛り|あまた|数多|洪水|万斛
clubby	社交的な|排他的な
sagacious	賢明な(wise)
flounce	飛び出す|飛び込む
arachnoid	蜘蛛膜|クモ綱
missioner	宣教師
valise	(小型の)旅行かばん|スーツケース
pallette	one of the rounded armor plates at the armpits of a suit of armor
hirsutism	多毛症
distaff	糸巻き棒
bespectacled	めがねをかけた
mugwort	ヨモギ
bibliographer	書誌学者
aerolite	いん石
hepatobiliary	肝胆汁性の
agio	為替打ち歩
monocytic	単球の
appallingly	to an appalling extent; "the prisoners were appallingly thin"|to an appalling extent
misdemeanour	軽科|非行|軽罪|軽犯罪|微罪
mosey	《米話》ぶらつく|うろつく
cambium	形成層(植物の幹や根の木部と樹皮部の間にある柔らかな組織層)
penetrance	浸透度
fallot	French physician who described cardiac anomalies including Fallot's tetralogy (1850-1911)
carrousel	=carousel
stenographic	速記の|速記術の
pubis	恥骨|陰部|陰毛
brandish	振りまわす|大げさに示す
hairstreak	small butterflies having striped markings under the wings
zombi	ゾンビ|ゾンビ|ゾンビ|ゾンビー|自動人形|オートマトン|ゾンビ|ゾンビ|ゾンビー
gallstone	胆石
incomparably	in an incomparable manner or to an incomparable degree; "she is incomparably gifted"|in an incomparable manner or to an incomparable degree
thalassaemia	サラセミア
bearskin	熊の毛皮|熊皮製品(服)|黒い毛皮帽(英国近衛兵がかぶる)|粗いラシャ地
prang	a crash involving a car or plane|crash
leaper	someone who bounds or leaps (as in competition)
valdecoxib	a Cox-2 inhibitor (trade name Bextra) that relieves pain and inflammation without harming the digestive tract
wreathe	〈花など〉‘を'花輪にする|(花輪などで)〜‘を'飾る《+名+with+名》|〜‘を'覆う|包む
teleprompter	a prompter for television performers
destructively	破壊的
recitative	レチタティーヴォ|オペラ|オラトリオ|カンタータなどの中に置かれる独唱|叙唱|朗唱と訳される
factotum	家事いっさいをやる使用人
conterminous	隣接する|(時間・空間が)同一限界の
nociceptive	caused by or in response to pain; "a nociceptive spinal reflex"|caused by or in response to pain
kerf	(のこぎりなどで木につけた)切り込み|ひき目;(枝などの)切り口
blankie	(幼児語)毛布
barleycorn	大麦の粒
wherry	小さなこぎ舟
hankey	汗ふき|ハンケチ|鼻拭|ハンカチ|汗拭|汗手拭い|汗拭き|ハンカチーフ|ハンケチーフ|手巾
determinedly	断固として
calamitous	災難を伴う|不幸な|災難の多い|いたましい
stripy	筋(しま)のある
shantytown	a city district inhabited by people living in huts and shanties
workmanlike	職人らしい|腕利きの|腕のいい
sacrilegious	神聖を汚す|神聖冒涜の|罰当たりの
fatuous	(ひとりよがりで)愚かな|無意味な|まぬけの|頭がからっぽの|愚鈍な|ばかの|低能の
bewray	示す|垣間見せる
elocution	演説法|(特に公の場での)優れた話術
saccharum	tall perennial reedlike grass originally of southeastern Asia: sugarcane
trolleybus	トロリーバス
nondenominational	not restricted to a particular religious denomination; "a nondenominational church"|not restricted to a particular religious denomination
undergarment	下着
suborbital	(人工衛星などが)軌道をはずれた|軌道に乗らない　眼窩下軟骨
schwa	あいまい母音|シュワー(əで示される弱母音)|あいまい母音の発音記号
homogenate	ホモジネート|細胞小器官や構成要素や化学的組成を調べるため機械的に細胞破砕し|生体内の状態のまま均一な分画を得る手法(細胞分画法)
palliation	(罪などの)弁解|取りつくろうこと|(病気などの)一時的な抑え
overreach	打ち負かすこと|克服すること|行き過ぎる|無理をする|人をだます|追いつく|広がる|及ぶ|達する
misanthropy	(mɪsˈænθrəpi)人間嫌い|厭世|人間不信|(反)altruism(利他主義|博愛主義)|philanthropy博愛(主義)|慈善
hoagie	爆撃機
extemporaneous	(演説・演技などが)即席の
renovator	a skilled worker who is employed to restore or refinish buildings or antique furniture
incompetency	不行き届き|不行届き|菲才|不才|不器量|不能|不適任|能無し|無能さ|非才
irregardless	regardless; a combination of irrespective and regardless sometimes used humorously|regardless|a combination of irrespective and regardless sometimes used humorously
homunculus	マネキン|ホムンクルス|ホムンクルス
chambermaid	(ホテル・モーテルの)部屋係メイド
undigested	消化されない
perfidious	不誠実な|裏切りの|背信の
farsightedness	遠視
umbrage	不快
bicentenary	=bicentennial
introversion	内向;内向性
isotropy	等方性
portmanteau	(UK英)旅行かばん
porterage	運搬人(赤帽)の仕事|運搬料|運び賃
moralist	道徳主義者|道徳家
natatorium	スイミングプール|プール|スウィミングプール
whacko	気違
haycock	(畑のあちこちに作った円すい状の)干し草の小山
homogenizer	破砕機|ホモジナイザー
distinctness	明瞭
widgeon	ヒドリガモ
expiation	〈U〉(罪などの)償い|埋め合わせ|〈C〉(罪などの)償いとなること|償いの手段
ornithologist	鳥(類)学者
azurite	藍銅鉱
demoralise	腐敗させる|堕落させる|落胆させる|凹ます|凹ませる
micmac	ミクマク語|(カナダの大西洋岸地域に住むアルゴンキン語族の言語)
maunder	だらだら(とりとめなく)話す|ぶらつく
alehouse	=public house
spelunk	explore natural caves
pocketful	《a~》ポケット一杯(の〜)《+『of』+『名』》|たくさん(の〜)《+『of』+『名』》
practicability	実行できること|実用性
transcriptionally	転写
bluenose	清教従的な人|禁欲的な人
dreamily	夢のように|うとうとと
gibbet	晒す|曝す
exactitude	几帳面|厳正|厳密さ|正確さ|精密さ|精密度
antiparallel	逆平行
pelargonium	ペラルゴニウム
syndromic	症候群の
myristate	ミリスチン酸エステル|ミリスチン酸(化合物名)
uremia	尿毒症
cachexia	カヘキシー|悪液質
semisweet	苦甘い|うそ甘い|甘苦い|薄甘い
unverifiable	(of e.g. evidence) not objective or easily verified
dromedary	ヒトコブラクダ|(=Arabian camel)|背中のこぶはhump
rootless	wandering aimlessly without ties to a place or community; "led a vagabond life"; "a rootless wanderer"|wandering aimlessly without ties to a place or community
inviolate	(約束などが)破られていない|(場所が)汚されていない
cleanable	capable of being cleaned
nasopharynx	上咽頭
zoroaster	ゾロアスター
obsolescent	すたれかかった
militarist	軍国主義者
skywalk	an elevated walkway between buildings (usually enclosed)
cairngorm	黒水晶
pawl	(歯車の)歯止め|つめ
skidder	スリッパ
etodolac	a nonsteroidal anti-inflammatory drug (trade name Lodine)
discrepant	不一致|矛盾
anole	small arboreal tropical American insectivorous lizards with the ability to change skin color
tetrahydrocannabinol	テトラヒドロカンナビノール
novelization	ノベライゼーション
anomie	アノミー
overeat	食べすぎる
pectoralis	胸筋
polycythemia	赤血球増加|多血症
lordly	君主にふさわしい|堂々とした|立派な|横柄な|君主らしい|堂々と
dolorosa	ヴィア･ドロローサ(ラテン語Via Dolorosa「苦難の道」の意)|新約聖書によるイエスの最後の歩みのこと|ヴィア･クルキス(via cruces十字架の道)とも呼ばれる
assiduous	勤勉な|根気強い
dredger	浚渫(しゅんせつ)人夫|=dredge
stokowski	レオポルド・ストコフスキー
putrescine	プトレッシン|プトレシン
hemostatic	止血性
thenceforth	それ以後ずっと|その時以来
neologism	新語|新造語|新表現
oophorectomy	卵巣切除|卵巣摘出
giblet	鳥モツ
frappe	フラッペ|フラッペ|フラッペ|アイス|氷
worryingly	in a manner to cause worry
nonbank	ノンバンク|銀行ではない金融機関
stogy	a cheap cigar
hypokalemia	低カリウム血症
delist	上場廃止にする
ballpen	a pen that has a small metal ball as the point of transfer of ink to paper
portentous	もったいぶった|縁起の悪い|前兆の
conjurer	手品遣い|奇術師|手妻使い|手妻遣い|手妻使|魔術師|手品師|マジシャン|手妻遣|神がかり
ilx	being nine more than fifty
toller	a person who rings church bells (as for summoning the congregation)|someone employed to collect tolls
ptosis	眼瞼下垂
unbend	まっすぐにする|(心を)休める|くつろぐ
algerie	a republic in northwestern Africa on the Mediterranean Sea with a population that is predominantly Sunni Muslim; colonized by France in the 19th century but gained autonomy in the early 1960s|a republic in northwestern Africa on the Mediterranean Sea with a population that is predominantly Sunni Muslim|colonized by France in the 19th century but gained autonomy in the early 1960s
drowning	溺死
novocaine	procaine administered as a hydrochloride (trade name Novocain)
papoose	北米インディアンの赤ん坊|赤ん坊を背負う袋
disgorgement	吐瀉|吐出|嘔吐|反吐
vespucci	ベスプッチ
cordite	コルダイト
criminological	of or relating to or involved in criminology
fireweed	焼け跡の雑草
oilcloth	油布
grus	クレイン
canonically	in a canonical manner; "the deacon was canonically inducted"|in a canonical manner
steelmaker	a worker engaged in making steel
chromite	クロム鉄鉱
boehme	ベーム
wildtype	野生型(遺伝形質の種類)
synchronic	同期的|シンクロニック|シンクロニック|シンクロニック
pinta	1パイント(ヤード･ポンド法)の飲み物|1パイント=約473cc=8分の1ガロン　2|ピンタ島(ガラパゴス諸島)
venal	金で動かされる|買収できる|腐敗した
orthology	異種間の遺伝子が共通の祖先に由来する場合|オーソロガス(相同)という|外見や機能は似ているが|共通の祖先に由来しない相似(analogous)の対義語
corrugation	〈U〉波形にすること;波形のついた状態|うね状|〈C〉(波形を構成する)うね|溝|しわ
unsent	not dispatched or transmitted; "the letter remained unwritten and unsent"|not dispatched or transmitted
kibitzer	(特にカードゲーム)の見物人;おせっかい屋
astronomically	enormously; "the bill was astronomically high"|enormously
wearisome	退屈な|疲れさせる
apologetically	わびて|謝って|済まなそうに
clime	地方|国土(from northern climes|北の国から)|気候|(clime地方･気候|crime犯罪)
triskele	三脚巴
blowhard	《米話》ほら吹き
sociality	社交性|社会性
absurdist	不条理主義の|不条理主義者(作家)
accusatory	告訴の|非難の|非難めいた
licit	合法の
constitutionalist	an advocate of constitutional government
reseed	seed again or anew|maintain by seeding without human intervention; "Some plants reseed themselves indefinitely"|maintain by seeding without human intervention
bipartisanship	2党主義
bogy	おばけ|幽霊|人の悩ますもの|人につきまとうもの
electroencephalogram	脳電気図|脳波図
wrongness	不正行為
untraceable	消息不明
risch	スタイリッシュ
sublethal	致死量以下|亜致死の|亜致死性
inclinometer	傾斜計|伏角計|傾斜計|クリノメーター
mating	交配
abstinent	節度のある|禁欲的な|禁酒の
cumulate	山積み|溜る|積みかさなる|積み重なる|集積|蓄積|集まる|積みあがる|溜まる|堆積
empyrean	最高天(古代天文学で五天のうちで最高の天上界)|天空|大空|最高天の;天空の
unsex	〜‘を'性的能力を奪う|〈特に女性〉‘を'女らしくなくする
prettily	きれいに
disgustingly	in a disgusting manner or to a disgusting degree; "the beggar was disgustingly filthy"|in a disgusting manner or to a disgusting degree
phytochemistry	the branch of organic chemistry dealing with the chemistry of plants
innovativeness	革新
numberplate	ナンバープレート
transpacific	太平洋横断の|太平洋の向こう岸の
lapdog	小さな愛玩犬|吠え声ばかり大きい無力な人|盲信者|心酔者
wunderkind	神童|天才児|(実業界での若手)成功者
protuberance	隆起
mudcat	ナマズ
gassy	ガスが充満した;ガスを含む|ガス状(質)の
frizzle	[髪]‘を'ちぢらせる|カールにする《+『up』+『名』》|ちぢれる|(髪などの)ちぢれ|ちぢれ髪
sext	六度
epistolary	書簡(形式)の|書簡体の
blear	(涙などで)目がかすんだ|曇った(blurred)|(涙などで)〈目・視力〉'を'かすませる(blur)
cornea	角膜
dodder	よぼよぼになる|(老齢などのために)よろよろと歩く
fastidiosa	Xylella fastidiosa|ぶどうのピアース病(PD)を引き起こす細菌|ヨコバイが媒介し北米で広く蔓延|ナパバレーに大きな損失を与えている
shading	陰にすること|陰影法|わずかな変化(相違)
neap	小潮(こしお)(潮の干満の差が最小の日)
historicism	歴史主義
otology	the branch of medicine concerned with the ear
misleadingly	欺いて
dudgeon	立腹
linearize	直線化
ranier	a mountain peak in central Washington; highest peak in the Cascade Range; (14,410 feet high)|a mountain peak in central Washington|highest peak in the Cascade Range
frivol	横着
fulminant	sudden and severe; "fulminant pain"; "fulminant fever"|sudden and severe
unwisely	へらへら|ばかのように
sexless	男女の別のない|性的魅力のない|セックスレス
strop	(かみそりをとぐ)皮砥|〈かみそり〉‘を'皮砥でとぐ
horsefly	ウマバエ|ウシアブ|虻(あぶ)|(=gadfly)
reignite	ignite anew, as of something burning; "The strong winds reignited the cooling embers"|ignite anew, as of something burning
lateran	the site in Rome containing the church of Rome and the Lateran Palace
superintend	〈仕事・人・組織など〉‘を'監督する|指揮する|管理する
invigilator	婦長
tartaric	酒石の
sente	100 lisente equal 1 loti in Lesotho; one sente is worth one-hundredth of a loti|100 lisente equal 1 loti in Lesotho|one sente is worth one-hundredth of a loti
airheaded	浅墓|滅多|浅はか|軽躁
plenitude	豊富|十分
nucleophile	求核試薬|求核剤|試薬|電子密度が低い原子(主に炭素)へ反応し|多くの場合結合を作る化学種のこと
rosebush	バラの木(茂み)
unpardonable	not admitting of pardon; "unpardonable behavior"|not admitting of pardon
lofoten	ローフォテン諸島
arbovirus	アルボウイルス
griseofulvin	グリセオフルビン
tragus	a small cartilaginous flap in front of the external opening of the ear
premedical	医学部進学課程の
scurrilous	(言葉づかいの)下品な|野卑な
uncannily	不思議なほど
pyromania	放火癖
compellingly	強制的に|やむにやまれず
floorboard	床板
ethnographer	民族誌学者
fluphenazine	フルフェナジン
conferral	授与
foreland	崎|岬|地嘴|埼|岬角|碕
anele	administer an oil or ointment to ; often in a religious ceremony of blessing|administer an oil or ointment to|often in a religious ceremony of blessing
phlebitis	静脈炎
baronetage	the collective body of baronets|the state of a baronet
pinna	(動)羽|翼|ひれ|ひれ足(flipper)|耳殻|耳介(auricle|耳穴の周りにある音を集める構造)|(植)(シダの葉など複葉の)羽片
thromboplastin	トロンボプラスチン|トロンボキナーゼ
isocarboxazid	a monoamine oxidase inhibitor (trade name Marplan) that is used to treat clinical depression
toxemia	妊娠中毒症|毒血症
mevacor	ロバスタチン
quantitate	定量|定量化する
mazama	brockets
syncopation	(音楽の)切分音|シンコペーション(普通は弱い拍子にアクセントをつけてリズムを変えること)|(文法で)語の中略
corruptible	(人が)堕落しやすい|(物が)腐敗しやすい
pedlar	=peddler
woodcarver	makes decorative wooden panels
applicative	作用的な
impassive	無表情の|感情を示さない|無神経な|無感覚な
abasement	(品位・地位などの)低下|失墜;屈辱
smilax	サルトリイバラ(ユリ科の植物の一種)|クサナギカズラ(ユリ科のつる草;観賞用)
uneconomical	物体無い|不経済|無駄|物体ない|勿体ない|勿体無い
globule	(glάbjuːl)|液体の小球|小滴
jonquil	キズイセン(黄水仙)
eyecup	洗眼用コップ
nonscheduled	予定外の;(飛行機運航が)不定期の
bloodsucker	吸血動物|ヒル(leech)|搾取者|高利貸し
terroristic	テロリズムの|暴力主義的な
pomade	ポマード|〈髪〉‘に'ポマードをつける
bimetallic	2種の金属から成る|(金・銀)複本位制の
regulative	restricting according to rules or principles; "a regulatory gene"|restricting according to rules or principles
mycosis	真菌症|真菌感染
subtenant	(家・土地などの)また借り人|転借人
moorage	ドッキング|縛
tollhouse	通行料金徴収事務所
septicaemia	敗血症
agenesis	imperfect development; nondevelopment of a part|imperfect development|nondevelopment of a part
prickle	とげ|針
yeomanry	地方の地主|自作農|義勇農騎兵(現在では英国民義勇軍(Territorial Army)に編入されている)
haemorrhoid	痔核
lepanto	Turkish sea power was destroyed in 1571 by a league of Christian nations organized by the Pope
stochastically	確率的
aneroid	アネロイド気圧計
paleobiology	古生物学
outsized	特大の
audiogram	a graphical representation of a person's auditory sensitivity to sound
lanius	type genus of the Laniidae: typical shrikes
parvo	パルボウイルス
verisimilitude	ありそうなこと|本当らしく見えること|迫真性
currentness	the property of belonging to the present time; "the currency of a slang term"|the property of belonging to the present time
pondweed	蛭藻|蛭藻
dishonestly	in a corrupt and deceitful manner; "he acted dishonestly when he gave the contract to his best friend"|in a corrupt and deceitful manner
sideswipe	(すれ違いざまに)〜‘を'横殴りする
pinworm	ギョウチュウ(人間の腸に寄生する蟯虫)
pyrilamine	antihistamine used to treat rhinitis and pruritus
penknife	(壊中用の)小型ナイフ
misclassify	誤って分類する
terrifically	ひどく
prochlorperazine	プロクロルペラジン
protamine	プロタミン
pythium	any fungus of the genus Pythium
truelove	恋人|愛する人
perceiver	見る者|観察者|知覚者
myg	one ten thousandth of a centner
comradeship	僚友関係|同志の交わり;友情|同志愛
inopportune	時機を失った|折の悪い|不適当な|折あしく
bodkin	ひも通し[針]|千枚通し|(先に飾りのついた)ヘアピン
ceftazidime	セフタジジム
gumshoe	ゴム靴;《複数形で》スニーカー|《俗》刑事|探偵(たんてい)
secretase	a set of enzymes believed to snip pieces off a longer protein producing fragments of amyloid protein that bunch up and create amyloid protein plaques in brain tissue (the pathological hallmark of Alzheimer's)
plasticizer	可塑剤
obtainment	入手
europium	ユーロピウム(希土類元素;化学記号は『Eu』)
dapple	まだらにする|まだらの
tastebud	味蕾
poesy	=poetry
cheapness	安っぽさ|安価
cordovan	コードバン皮(柔らかななめし皮)
naivety	素朴|天真爛漫|素樸|純情
enki	water god and god of wisdom; counterpart of the Akkadian Ea|water god and god of wisdom|counterpart of the Akkadian Ea
intronic	イントロン(遺伝子関連)の|遺伝情報として転写はされるが最終的にはアミノ酸の塩基配列から除去される配列をintronという
soddy	煉瓦住宅
preceptorship	the position of preceptor
undistinguished	区別されない|平凡な
eyedropper	点眼器
italicise	イタリック体で印刷する|斜字体で印刷する
categorial	of or relating to the concept of categories
clustal	Clustal|広く用いられている多重整列プログラム|clustalWとclustalXがある
indaba	a council at which indigenous peoples of southern Africa meet to discuss some important question
countersink	(ねじなどの頭を埋めるために)〜‘に'さら穴をあける;〈ねじなどの頭〉'を'さら穴に埋める|(さら穴をあける)さらぎり|さら穴
lackadaisical	気力のない|意欲のない|怠惰な
ribald	下劣(野卑)な|みだら(不敬)な(ことを言う)
otoplasty	reconstructive surgery of the auricle of the external ear
seachange	急激な変化 = sea-change
omnipresence	同時にどこにでもいること|遍在
emend	〈原稿〉‘を'校正する|‘の'誤りを正す
shadowbox	シャドーボクシングをする(相手を予想して一人で動きの練習をする)
steriliser	オートクレーブ
foldaway	折り畳み式の
brusque	ぶっきらぼうの|無愛想な
functionalist	機能主義者|機能主義の
empathise	呑込む|会釈|わかる|同情|了解|諒解|分る|事解|領会|理解
indecipherable	解読できない
unserviceable	(壊れたり使い古して)使用できない|役に立たない
coarctation	縮窄|縮窄
etanercept	エンブレル|エタネルセプト
officious	おせっかいな|さしでがましい|非公式の
objectify	客観化
pilchard	ニシン科の魚
disorganise	remove the organization from
tweedle	歌う|唄う|囀る
unimodal	単様式
spindrift	(海の)波しぶき
snippy	痛烈な
controversially	involving controversy; "criticism too polemically stated"|involving controversy
recombinase	リコンビナーゼ|酵素(enzyme)の名
tektite	テクタイト(天然のガラス質物質)
octahedron	八面体
xxy	(genetics) abnormal complement of sex hormones in a male resulting in Klinefelter's syndrome|abnormal complement of sex hormones in a male resulting in Klinefelter's syndrome
invidia	spite and resentment at seeing the success of another (personified as one of the deadly sins)
gearshift	(特に自動車の)ギヤ転換装置
ellipticity	扁平率
antigravity	反重力(陽の質量の物体が陰の質量の物体と反発する力)
rheostat	加減抵抗器
oilman	石油企業家|石油業者|油田主
equivocation	あいまいな言葉
gustatory	味覚の
glaciate	cover with ice or snow or a glacier; "the entire area was glaciated"|cover with ice or snow or a glacier|become frozen and covered with glaciers
windage	弾丸に与える風の影響|偏流|(弾丸の)偏流度
redbrick	of or relating to British universities founded in the late 19th century or the 20th century
hummock	小さい丘(knoll)|(氷原の)氷の丘
laundress	洗濯女(人の家に行って|あるいは自分の家に持って帰って洗濯する女性);クリーニング屋の女性従業員
frap	make secure by lashing; "frap a sail"|make secure by lashing|take up the slack of; "frap a rope"|take up the slack of
polysemy	多義性
dovecote	a birdhouse for pigeons
kyphosis	脊柱後湾
vitrectomy	硝子体切除
hereinbefore	in the preceding part of the current text
demoiselle	未婚の女性
bottler	瓶詰め業者
erigeron	cosmopolitan genus of usually perennial herbs with flowers that resemble asters; leaves occasionally (especially formerly) used medicinally|cosmopolitan genus of usually perennial herbs with flowers that resemble asters|leaves occasionally (especially formerly) used medicinally
demobilisation	復員
unfitness	不向き|不能|不適任|無力
fraulein	a German courtesy title or form of address for an unmarried woman
avaricious	どん欲な|貪欲な
eveningwear	アフターダーク|夜会服|イブニングドレス
popish	ローマカトリック教的な|ローマカトリック教に特有の
asymmetrically	非対称|非対称的
zygotic	of or relating to a zygote
resinous	樹脂の・樹脂質の・ やにの多い
slapper	a hitter who slaps (usually another person) with an open hand; "someone slapped me on the back and I turned to see who the slapper was"; "my father was the designated spanker in our family"|a hitter who slaps (usually another person) with an open hand
yenta	(Yiddish) a vulgar shrew; a shallow coarse termagant|a vulgar shrew|a shallow coarse termagant|(Yiddish) a woman who talks too much; a gossip unable to keep a secret; a woman who spreads rumors and scandal|a woman who talks too much|a gossip unable to keep a secret|a woman who spreads rumors and scandal
avascular	無血管性
paramour	情夫|情婦|愛人|恋人
terazosin	テラゾシン
enunciation	発表|発音(ぶり)|(理論･主義などの)言明|宣言
returnee	帰国子女
noninstitutional	not institutional
kickstand	キックスタンド(自転車・オートバイなどを倒れないよう支える装置)
lionfish	ミノカサゴ
voiceprint	声紋(声の特徴を表す音響分析図)
glycolytic	解糖|糖分解
dropsy	=edema
kielbasa	キルバサ|ポーランドの豚肉･牛肉の薫製ソーセージ
gayness	同性|同性愛
nutria	ヌートリア(南米原産の水中生活に適応した動物|ビーバーに似る)
hardscrabble	(土地が)苦労してやっと生活できる|不毛の
thoracotomy	surgical incision into the chest walls opening up the pleural cavity
snuffer	a cone-shaped implement with a handle; for extinguishing candles|a cone-shaped implement with a handle|for extinguishing candles
cowpoke	=cowboy
moneyed	金のある|金持ちの|金まみれの
micelle	ミセル
discordance	=discord1|2
vivisect	〈動物〉‘を'生体解剖する|生体解剖をする
coffeepot	コーヒー沸かし器
handbill	広告ビラ|散らし
drizzly	霧雨の[降る]
sweatsuit	スウェットスーツ|スエットスーツ
unpolluted	純粋
angostura	アンゴスツラビターズ(南米産の木の皮から作り|アルコールの香料に用いる)
menander	comic dramatist of ancient Greece (342-292 BC)
mantelpiece	暖炉の前飾り
dreadnaught	battleship that has big guns all of the same caliber
imitator	模倣者|偽造者
cumulation	堆積|山|積み重ねたもの
stegosaurus	剣竜
meerschaum	〈U〉(パイプの火皿に用いる)海泡(かいほう)石|〈C〉火皿が海泡石製のパイプ
floodgate	(水量の調節をする)水門
chemicon	ケミコン(社名|分子生物学|遺伝子学関係)
impiety	不信心|不敬|不孝
hindquarter	(牛・羊などの体の)後四半部の肉・後部・臀部・《複数形で》(動物の足を含めた)腰から下の部分
rabbet	a rectangular groove made to hold two pieces together|join with a rabbet joint|cut a rectangular groove into
caesium	=cesium
suddenness	突然
baneful	有害な|有毒な
suppurative	relating to or characterized by suppuration
allegiant	忠順
butene	ブテン|ブチレン
retrovir	ジドブジン
furtively	ひそかに
betrayer	裏切り者|売国奴|誘惑者
lovebird	つがい鳥(ボタンインコの俗称)|《複数形で》《話》愛し合っている恋人同士
homogeneously	均一|均質
flunky	事大主義者
cycad	ソテツ(蘇鉄)
pish	くだらんこと|ウイスキー|フンと言う
pastureland	牧草地|牧野|牧場|放牧地|牧地|牧|草原
arrowroot	クズウコン(病人食として用いられた熱帯アメリカ産の植物)
jostle	乱暴に押す|押しのける|競いあう
subbase	the lowest molding of an architectural base or of a baseboard
handsaw	(片手で使う)手のこぎり
densification	圧縮
nostoc	ネンジュモ
misogynistic	hating women in particular
thermometry	温度測定
castrate	去勢する|精巣を除去する|骨抜きにする
humph	ふふん
splenomegaly	巨脾症|脾腫(ひしゅ)
maternally	in a maternal manner; as a mother; "she loved her students almost maternally"|in a maternal manner|as a mother
bandolier	(兵士が肩からかける幅広の)弾薬帯|負い革
flavouring	塩加減|シーズニング|調味料|加味|塩味|香辛料|塩梅
scrunch	ボリボリかむ|(紙などを)丸める|押しつぶす|ばりばり噛む
expwy	expressway
radiopharmaceutical	放射性医薬品
staggeringly	甚|いたく|痛く|とっと|甚く
schmo	うすのろ|まぬけ　馬鹿
thyroidectomy	甲状腺摘除
wrongdoer	悪事を働く人|犯罪者|悪事を働く者|非行者
hydrous	水を含む;(鉱物・化合物が)含水の
ilmenite	チタン鉄鉱
blotchy	シミだらけの
conk	パンチ|一撃|縮れ毛を(アルカリ溶液などで)伸ばすこと
anorectal	肛門直腸
haemodynamic	血行動態
pronominal	代名詞の|代名詞のような
klinefelter	クラインフェルター
cacique	black-and-red or black-and-yellow orioles of the American tropics
pillion	(馬に堂乗する人の)添え鞍|(オートバイなどの)後部座席
palladian	referring to or relating to or having the style of architecture created by Andrea Palladio; "the much imitated arch and column compositions known as the Palladian motif"|referring to or relating to or having the style of architecture created by Andrea Palladio
recidivist	常習犯
unswerving	(意志などが)確固とした|不動の
sealevel	(満潮時と干潮時の間の)平均海面|海面　海抜 = sea level = sea-level
cooly	クーリー
theretofore	それ以前に
sonority	鳴り響くこと|反響|朗々とした話
cosmopolis	国際都市
dabbler	カモ(鳥)|水遊びをする人|道楽半分に事をする人|素人
straightedge	直[線]定期
skuld	goddess of fate: a dwarf who personified the future
volapuk	one of the first artificial language constructed for use as an auxiliary international language; based largely on English but with some German and French and Latin roots|one of the first artificial language constructed for use as an auxiliary international language|based largely on English but with some German and French and Latin roots
sellotape	接着剤|セロテープ
nitrofurantoin	ニトロフラントイン
vociferously	in a vociferous manner; "he complained vociferously"|in a vociferous manner
monarchical	having the characteristics of or befitting or worthy of a monarch; "monarchical gestures"; "monarchal pomp"|having the characteristics of or befitting or worthy of a monarch|ruled by or having the supreme power resting with a monarch; "monarchal government"; "monarchical systems"|ruled by or having the supreme power resting with a monarch
opthalmic	of or relating to or resembling the eye; "ocular muscles"; "an ocular organ"; "ocular diseases"; "the optic (or optical) axis of the eye"; "an ocular spot is a pigmented organ or part believed to be sensitive to light"|of or relating to or resembling the eye
vanadate	a salt or ester of vanadic acid; an anion containing pentavalent vanadium|a salt or ester of vanadic acid|an anion containing pentavalent vanadium
tetraploid	4倍体(4つで1対から成る染色体のセットを持つ細胞)
perphenazine	ペルフェナジン
immodest	慎みのない
oviduct	卵管
damar	ダマル島
sympatric	同所性の|(種分化について同様か重なった地理的地域において起きる)
freethinker	自由思想家(既成の考え|特キリスト教会の型にはまった考え方にとらわれない人)
inadmissibility	unacceptability as a consequence of not being admissible
phenylbutazone	フェニルブタゾン
wassail	(もと英国で用いた)乾杯のあいさつ|《おもに文》酒宴|酒盛り|乾杯する;酒盛りする|〜‘に'乾杯する
asparaginase	アスパラギナーゼ
dinoflagellate	渦鞭毛藻
acinar	腺房|腺房
redecorate	改装する|模様替えをする|装飾し直す
occident	西洋|新世界|西半球
beatification	幸せにすること
bullring	闘牛場
oppositely	in an opposite position
biochemically	生化学的に
eviscerate	(議論などを)骨抜きにする|(動物の腸を)抜く
icecap	(高山・極地などの)万年雪
puka	South American shrub or small tree having long shining evergreen leaves and panicles of green or yellow flowers|small roundheaded New Zealand tree having large resinous leaves and panicles of green-white flowers
pseudonymous	ペンネームで書かれた|偽名(変名)を用いる
oxime	オキシム
berberis	large genus of shrubs of temperate zones of New and Old Worlds
premeditation	前もって慎重に計画すること
bauhinia	mountain ebony, orchid tree
tearfully	めそめそ|泣く泣く
salaat	the second pillar of Islam is prayer; a prescribed liturgy performed five times a day (preferably in a mosque) and oriented toward Mecca|the second pillar of Islam is prayer|a prescribed liturgy performed five times a day (preferably in a mosque) and oriented toward Mecca
agoraphobic	広場(空間)恐怖症にかかった
sinter	温泉沈殿物|湯の花|焼結製品|焼結する
villus	絨毛
victrola	a brand of gramophone
sternal	of or relating to or near the sternum
pugnacious	けんか好きな|けんか早い
parainfluenza	パラインフルエンザウイルスは|関連した数種類のウイルスを含み|感冒からインフルエンザ様症候群|肺炎まで多数の呼吸器疾患を引き起こす
bedeck	《文》(〜で)〜'を'飾りたてる《+『名』+『with』+『名』》
trumbo	ダルトン・トランボ
intercalation	閏
thermic	relating to or associated with heat; "thermal movements of molecules"; "thermal capacity"; "thermic energy"; "the caloric effect of sunlight"|relating to or associated with heat
sensitise	感作|感作|感作|感作
cyanogen	シアン
topicality	〈U〉話題になっていること(状態)|〈C〉《複数形で》時事問題
brolly	コウモリ傘|パラシュート
wintery	wintry
icosahedral	of or relating to an icosahedron
adventuresome	大胆な|勇敢な
versant	山腹|中腹
flaxen	亜麻の|亜麻製の|亜麻色の
pseud	如何様師|ペテン師|騙り|とっこ|詐欺師|欺瞞者|ぺてん師|いかさま師
mender	修理(改良)者
cytokinin	サイトカイニン
tempter	〈C〉誘惑者|《the T-》悪魔(the Devil)
precedential	having precedence (especially because of longer service); "precedential treatment for senior members of the firm"|having precedence (especially because of longer service)
vampirism	吸血鬼
hierarchic	=hierarchical
labetalol	ラベタロール
regularize	規制|律する|規正|紀律|管する|規定|統制|管理|規律|規整
aquaporin	アクアポリン|細胞膜に存在する細孔(pore)を持ったタンパク質|水分子のみを選択的に通過させることができ|細胞への水の取り込みに関係
holloware	silverware serving dishes
lovelorn	恋人に捨てられた;失恋に悩んでいる
salvageable	capable of being saved from ruin; "their marriage was not salvageable"|capable of being saved from ruin
counterrevolutionary	反革命主義者
unevenness	the quality of being uneven and lacking uniformity|the quality of being unbalanced
emissive	放射性の;放射の
burqa	ブルカ
tractate	論文
hydrolyze	加水分解する
copybook	習字の手本帳|《米》複写薄
hootenanny	フォークソングの集まり(会)
haem	ヘム
encasement	the act of enclosing something in a case
psychosexual	性心理の
brakeman	ブレーキ係|制動手
regretful	(人が)後悔している
yawl	(2本マストの)小型帆船|(オールでこぐ)船載ボート
pleaser	a pleasing entertainer; "he is quite the crowd pleaser"|a pleasing entertainer
marginality	周縁性
juristic	法律専門家の|法学者の|法律上の
valgus	外反
presort	並べ替え済み
syncretism	the union (or attempted fusion) of different systems of thought or belief (especially in religion or philosophy); "a syncretism of material and immaterial theories"|the union (or attempted fusion) of different systems of thought or belief (especially in religion or philosophy)|the fusion of originally different inflected forms (resulting in a reduction in the use of inflections)
bowline	もやい結び(船をつなぎ止めるときの結び方)
nixie	宛先不明郵便物
perceivable	感知できる|知覚できる|認知できる
screwup	the complete mismanagement or mishandling of a situation; "a typical bureaucratic screwup"|the complete mismanagement or mishandling of a situation
licentious	放縦な|放蕩な
milfoil	鋸草
byre	牛小屋|牛舎
abseil	(mountaineering) a descent of a vertical cliff or wall made by using a doubled rope that is fixed to a higher point and wrapped around the body|a descent of a vertical cliff or wall made by using a doubled rope that is fixed to a higher point and wrapped around the body|lower oneself with a rope coiled around the body from a mountainside; "The ascent was easy--roping down the mountain would be much more difficult and dangerous"; "You have to learn how to abseil when you want to do technical climbing"|lower oneself with a rope coiled around the body from a mountainside
accretive	growing by accretion
rubbing	摩擦|摩擦
intransigent	非妥協的な
wheatear	small songbird of northern America and Eurasia having a distinctive white rump
postbag	《a ~》《話》(ある人に一度に配達された)郵便物|=mailbag
oxazepam	オキサゼパム
haemolytic	溶血性
polyvalent	containing several antibodies each capable of counteracting a specific antigen; "a polyvalent vaccine"|containing several antibodies each capable of counteracting a specific antigen|having more than one valence, or having a valence of 3 or higher
varicocele	精索静脈瘤
subcompact	サブコンパクトカー(中型自動車(compact car)より一回り小さい車)
fusiform	tapering at each end
parenthetically	in a parenthetical manner; "he added parenthetically that he would not attend the wedding ceremony"|in a parenthetical manner
bounder	育ちの悪いがさつ者|下品な成り上がり者
agog	(期待･興奮で)わくわくして|～したくてうずうずして
nailhead	釘頭|釘頭
mastoid	乳様突起の|〈C〉乳様突起(耳の後ろの側頭骨にある)
liii	being three more than fifty
immunologically	免疫学的
millstream	水車用導水路の流れ
mithra	ancient Persian god of light and truth; sun god|ancient Persian god of light and truth|sun god
mimer	パントマイマー|イムアーティスト|マイマー|パントマイミスト
weightlifter	重量あげ競技者
grassroot	草の根
phosgene	ホスゲン
metastasize	転移する
nightdress	=nightgown
erecta	エレクタ (黄色オレンジ色の花が咲く花の名) 
whomp	張る
undecorated	not decorated with something to increase its beauty or distinction
ethnocentrism	自民族中心主義
hooliganism	バンダリズム
tartuffe	a hypocrite who pretends to religious piety (after the protagonist in a play by Moliere)
belligerence	交戦|闘争性
mantell	マンテル
gouty	痛風の|痛風にかかった
bisector	2等分線(面)
acellular	無細胞
oxytetracycline	オキシテトラサイクリン|オキシテトラサイクリン塩酸塩|テラマイシン
inviolability	侵してはならないこと|不可侵性
resister	抵抗する人
obstructionist	議事妨害者
galago	ガラゴ科
walkover	楽勝
hydronephrosis	水腎症
corbel	持ち送り積み(壁面から突き出た桁(けた)・はりの受け材)
neosporin	trade name for a topical drug containing several antibacterials; used as an ointment for skin irritations and in the form of eyedrops for minor eye infections|trade name for a topical drug containing several antibacterials|used as an ointment for skin irritations and in the form of eyedrops for minor eye infections
jubilate	悦ぶ|喜ぶ|歓喜
heth	the 8th letter of the Hebrew alphabet
epistaxis	鼻血|鼻出血
sylph	空気の精|ほっそりした美しい女
deoxycytidine	デオキシシチジン|シチジン
electrograph	an apparatus for the electrical transmission of pictures|electrical device used for etching by electrolytic means
syzygy	the straight line configuration of 3 celestial bodies (as the sun and earth and moon) in a gravitational system
medicolegal	法医学的
incongruent	not congruent
erogenous	(体のある部分が)性感を刺激する
abridgment	抄本|縮約
lexeme	(ˈlɛksiːm)|(文法)語彙素|言語学の形態論的単位|異なる形態だが同じ語の集合|例|child-children|go-goes-went-gone-going|big-bigger-biggest|各同じ語彙素
materialization	具体化|現れ|現われ|表れ|所産
humulin	a form of insulin (trade name Humulin) made from recombinant DNA that is identical to human insulin; used to treat diabetics who are allergic to preparations made from beef or pork insulin|a form of insulin (trade name Humulin) made from recombinant DNA that is identical to human insulin|used to treat diabetics who are allergic to preparations made from beef or pork insulin
cynosure	注目(賞賛)の的
sourpuss	(渋い顔をする)気難しい人|ひねくれ者
chalcopyrite	黄銅鉱(銅の原鉱)
expansionism	拡張論(政策)
shareowner	株主
systematize	順序立てる|組織立てる|系統分類|組織だてる|順序立つ|系統づける|系統立てる|体系づける|系統化|系列化
horseplay	馬鹿騒ぎ
mistreat	虐待|酷使する
radicchio	prized variety of chicory having globose heads of red leaves
kobo	小保
neurotrophin	ニューロトロフィン|神経栄養因子として|神経細胞の生存|発生|機能に必要とされるタンパク質
stiffener	堅くする人(物);(表紙・えりなどの)芯(しん);〈U〉補強材
extravasation	噴火|爆発|噴出
pavane	パバーヌ|パバーヌ
floret	小花
entreaty	懇願
flypaper	はえ取り紙
dunlin	ハマシギ
cohabit	同棲する
invitee	招待客
residuary	(法律上)残余遺産の取得権を持つ|残留物の
mournfully	しんみり|悲しそうに
officialdom	《集合的に》官僚|役人|《しばしば軽べつして》お役所風なやり方
wynd	小路|路地
passkey	=master key
canetti	カネッティ
vitrine	陳列棚|ケース|ショーケース
splitting	裂ける|割れる|割れるように痛む|キリキリ|腹が痛む様子
ichthyosis	魚鱗癬
headlock	ヘッドロック(レスリングで相手の頭を脇の下で締めつける技)
marvellously	驚くほど|すばらしく
doxology	栄光の賛歌|頌栄(しょうえい)(礼拝で歌う短い賛美歌)
okapi	オカピ
hyperbola	双曲線
rigatoni	リガトーニ
syndicalist	サンディカリズム主義者|サンディカリズム主義の
luxuriate	大いに楽しむ|ぜいたくをする|繁茂する|ぜいたくに暮らす|ふける
immunocompetent	免疫応答性
fundament	ベース|基礎|下地|基盤|基|基本|根底|根本|土台|根柢|尻|ヒップ|御居処|どんけつ|尻臀|臀部|臀|御尻|お尻|おいど|ベース|根元|基部|基礎|根っ子|最下部|基|基底|礎|根積
triazolam	トリアゾラム
phantasmagoria	(夢や想像上の)めまぐるしく移り変わる光景|走馬灯のように去来する幻影
papilla	乳頭(状小突起)|柔軟小突起
orderliness	秩序(順序)正しさ|行儀よいこと
homodimer	ホモダイマー|ホモ2量体(生化学)
glutinous	粘着性の
liniment	塗布薬|塗り薬
gula	食過ぎ|喰過ぎ|食過|食い過ぎ|食べ過ぎ|過食|暴食|食いすぎ|喰い過ぎ
underling	下役|手下
ulema	ウラマー
ivry	a battle (1590) in which the Huguenots under Henry IV defeated the Catholics under the duke of Mayenne
frypan	フライパン
primitivism	原始主義(自然ないし自然的なものを人間的価値の規準とする立場)
chateaubriand	French statesman and writer; considered a precursor of the romantic movement in France (1768-1848)|French statesman and writer|considered a precursor of the romantic movement in France (1768-1848)|a very thick center cut of beef tenderloin
tapenade	a spread consisting of capers and black olives and anchovies made into a puree with olive oil
hundredweight	ハンドレッドウェイト|センタル|ハンドレッドウェイト|ハンドレッドウェイト
dishware	瀬戸物
supercoil	スーパーコイル
hyphenate	ハイフンでつなぐ
tumorigenic	腫瘍形成性の
disbarment	弁護士資格のはく奪
burin	ビューリン
volution	観世水
antennal	触角の
rimu	tall New Zealand timber tree
coiffure	ヘアスタイル
brassard	腕章
aliment	食物(food);滋養物|扶養;扶養料
tokay	トーケイ|トーケイ
eupatorium	large genus of chiefly tropical herbs having heads of white or purplish flowers
spindly	細長い
matriarchal	characteristic of a matriarchy
ratan	=rattan
pupillary	of or relating to the pupil of the eye
fauld	a piece of armor plate below the breastplate
gavotte	ガボット(古いフランス舞踊;その曲)
gravida	the number of the pregnancy that a woman is in; "in her third pregnancy a woman is said to be gravida three"|the number of the pregnancy that a woman is in|a pregnant woman
ambassadorial	大使の|使節の
penetrative	浸透性の|入り込む|鋭い|鋭敏な;感銘を与える
rearm	再軍備する
kurrajong	カラジョング
leakproof	漏れ防止の
ninjutsu	the traditional Japanese method of espionage; involves stealthy movements and the use of camouflage|the traditional Japanese method of espionage|involves stealthy movements and the use of camouflage
betatron	ベータトロン
cartilaginous	軟骨の
quester	探求者|探究者
ignominy	屈辱|不名誉
odourless	having no odor; "odorless gas"; "odorless flowers"|having no odor
tempest	あらし|嵐|大嵐|暴風雨|大荒れ
reseat	〈劇場など〉‘に'新しい席を設ける|〈人〉‘を'再び座らせる
dismally	in a cheerless manner; "in August 1914 , there was a dismally sentimental little dinner, when the French, German, Austrian and Belgian members of the committee drank together to the peace of the future"|in a cheerless manner
unjustifiably	もっての外
browbeat	脅す
postbox	《おもに英》郵便ポスト(《米》mailbox)
keister	尻|ヒップ|御居処|どんけつ|尻臀|臀部|臀|御尻|お尻|おいど
stringently	厳重に|儼として|びしびし|厳として|ぴしぴし|厳に
ectodermal	＜ectoderm|外胚葉(発生初期における胚の外表面の細胞層|将来表皮や中枢神経系|感覚器官などに発達する)の|性の
cuirass	胴よろい;よろいの胸当て
popularise	俗了|大衆化
cornsilk	each of the long filamentous styles that grow as a silky tuft at the tip of an ear of Indian corn
solvability	解決しやすさ|解きやすさ
contrail	飛行機雲
superficiality	〈U〉(内容・性質が)表面的であること|皮相|浅薄さ|〈C〉浅薄なもの
spotlessly	in a spotless manner; "spotlessly clean"|in a spotless manner
immobilisation	固定化|固定化
estriol	エストリオール
adsorbate	吸着物
quoit	《複数形で》《単数扱い》鉄輪投げ|{C}(鉄輪投げの)鉄輪　尻の穴
eyedrop	a drop from an eye dropper|a method of irrigating the eye used by ophthalmologists
mountie	(カナダの)騎馬警官隊員
congener	同種|同類の物(人)|同属の動植物
pogge	northern Atlantic sea poacher
disulfiram	ジスルフィラム
adductor	内転筋|貝柱
momus	god of blame and mockery
avocation	副業|趣味|職業
buchenwald	a Nazi concentration camp for Jews in World War II that was located in central Germany
misrule	悪政|矢政|〜‘の'統治(政治)を誤る
unasked	問われない|求められない|頼まれない|招かれない
copiously	山山|うんと|たくさん|聢り|豊富|確り|ふんだんに|沢山|大量|多く
narthex	拝廊(教会の正面入口から本堂の至る広間になっている廊下)
aminophylline	アミノフィリン
somatotropin	成長ホルモン|ソマトトロピン
pantheist	汎神(はんしん)論者
wordfinder	a thesaurus organized to help you find the word you want but cannot think of