mosaicism	モザイク現象
microcephaly	小頭症
typha	ガマ
antepartum	出生前|出産前
bedchamber	寝室 (bedroom)
underactive	abnormally inactive
kuznets	クズネッツ
granulate	〈砂糖など〉‘を'粒[状]にする|〈紙・革など〉‘の'表面をざらざらにする|粒[状]になる|表面がざらざらになる
reprocess	再利用|リサイクル
upholsterer	いす張り職人;室内装飾人
testing	試験の|極めて困難な
intercommunication	相互通信|相互連絡
coelacanth	シーラカンス(白亜期以来絶滅したと考えられていたが|1938年に南アフリカ沖で発見された原始魚類)
defiler	a person or organization that causes pollution of the environment
intestacy	the situation of being or dying without a legally valid will
unstimulated	刺激されていない
matriarchy	女家長制|女族長制度
commoditization	コモディティ化|日用品化
homesteader	someone who settles lawfully on government land with the intent to acquire title to it
chian	of or relating to Chios
dorsally	in a dorsal location or direction
eolian	風の堆積(たいせき)作用による|風成の
acylation	アシル化
panoptic	全面的|総括的|全般的
tostada	a flat tortilla with various fillings piled on it|a crisp flat tortilla
swatter	ぴしゃっと打つ人(物)|はえたたき
defeatism	敗北主義
autograft	tissue that is taken from one site and grafted to another site on the same person; "skin from his thigh replaced the burned skin on his arms"|tissue that is taken from one site and grafted to another site on the same person
genotyped	遺伝子型を決定
volar	relating to the palm of the hand or the sole of the foot; "the volar surface"; "the palmar muscle"|relating to the palm of the hand or the sole of the foot
thermodynamically	熱力学的
scirpus	ホタルイ属
neoclassicism	(美術・文学などの)新古典主義
xeroderma	乾皮症
negligee	ネグリジェ
villous	絨毛
resuspend	再懸濁
interbreed	〈動物・植物〉‘を'異種のものと交配させる
puerperium	産褥期|産褥
bobolink	(北米産の)コメクイドリ
dawah	missionary work for Islam
bruxism	ブラキシズム
ergodicity	エルゴード性
branchial	of or relating to gills (or to parts of the body derived from embryonic gills)
saccharide	糖|糖類|含水炭素|サッカライド|サッカリド|炭水化物|糖分|糖質
forager	食糧徴発隊
androgyny	雌雄同性(同体)
disunion	分離|分裂|=disunity
shepherdess	女の羊飼い
decapitate	首を切る
rueful	後悔している
smugness	気取っていること
befit	に適する|ふさわしい|似合う
rawness	未熟さ|不完全|痛み|ひりひりすること|不案内|未経験|乳臭
bunuel	ブニュエル
garlicky	relating to or tasting or smelling of garlic; "garlicky sauce"|relating to or tasting or smelling of garlic
holmium	ホルミウム(希土類金属元素;化学記号は『Ho』)
zanuck	ザナック
endemism	nativeness by virtue of originating or occurring naturally (as in a particular place)
secateurs	せん定ばさみ|植木ばさみ
exploitive	tending to exploit or make use of
shovelhead	small harmless hammerhead having a spade-shaped head; abundant in bays and estuaries|small harmless hammerhead having a spade-shaped head|abundant in bays and estuaries
echinococcosis	エキノコックス症
derivational	characterized by inflections indicating a semantic relation between a word and its base; "the morphological relation between `sing' and `singer' and `song' is derivational"|characterized by inflections indicating a semantic relation between a word and its base
antipode	direct opposite; "quiet: an antipode to focused busyness"|direct opposite
dignify	に威厳をつける|に威厳を添える
equinoctial	春分(秋分)の|昼夜平分の|春分(秋分)に起こる
velvetleaf	イチビ
lobectomy	肺葉切除術
swagman	an itinerant Australian laborer who carries his personal belongings in a bundle as he travels around in search of work
enology	the art of wine making
mouthy	おしゃべりの|声高な|大言壮語する
allocatable	配分できる|割り付け可能な|割り振り可能な|割り当てできる
inheritor	(遺産)相続人|後継者
remorseless	無慈悲な
procarbazine	プロカルバジン
yardmaster	(鉄道の)構内主任
internalise	内面化
redoubtable	恐るべき|あなどりがたい
stickle	(特に|ささいなことを)くどくど言う|(〜に)難色を示す《+『at』+『名』》
minge	vulgar term for a woman's pubic hair or genitals
vanillin	バニリン
headbutt	butt with the head; "The soccer player headbutted his oponent and was sent off the field"|butt with the head
natation	the act of someone who floats on the water
antechamber	控えの間|ロビー
seasonable	季節(時節)に合う|時節がらの|《文》時機を得た
stereotypically	in a stereotypical manner
palmy	ヤシ(シュロ)の多い|繁栄する|勝利を得た|意気揚々とした|椰子の茂った|手のひらへのむち打ち
herstory	一女性の生涯|女性の目から見た歴史|女性史
unplaced	(競技・試合などで)入賞していない|等外の
capiz	カピス州
worldclass	ワールドクラス
equipt	provided or fitted out with what is necessary or useful or appropriate; "a well equipped playground"; "a ship equipped with every mechanical aid to navigation"|provided or fitted out with what is necessary or useful or appropriate
photomosaic	arrangement of aerial photographs forming a composite picture
crawdad	ザリガニ|ザリガニ
sportswoman	女子運動(競技)家
centromeric	動原体性
ravish	夢中にする
gluteus	殿筋
umbilicus	へそ
dubiously	不審
battlement	《しばしば複数形で》(塔・城壁の頂上の)銃眼つき胸壁
orison	祈り
atelectasis	無気肺
gamester	ばくちうち|とばく師(gambler)
rededication	a new dedication; "the rededication of the Temple of Jerusalem"|a new dedication
silkwood	a fast-growing tropical American evergreen having white flowers and white fleshy edible fruit; bark yields a silky fiber used in cordage and wood is valuable for staves|a fast-growing tropical American evergreen having white flowers and white fleshy edible fruit|bark yields a silky fiber used in cordage and wood is valuable for staves
deliriously	やたらに|精神が錯乱して|非常に|夢中になって|無性に
byword	通り言葉|はやりことば
osteomalacia	骨軟化症
sphalerite	閃亜鉛鉱
bewail	嘆き悲しむ
mumbling	indistinct enunciation|ineffectual chewing (as if without teeth)
redonda	an island in Antigua and Barbuda
cisterna	槽
autoradiographic	of or relating to or produced by autoradiography
plasmapheresis	血漿瀉血
referable	capable of being assigned or credited to; "punctuation errors ascribable to careless proofreading"; "the cancellation of the concert was due to the rain"; "the oversight was not imputable to him"|capable of being assigned or credited to
chondrosarcoma	軟骨肉腫
rigueur	(仏)絶対条件|厳格|厳しさ
lopid	ゲムフィブロジル
serval	サーバル
playschool	a small informal nursery group meeting for half-day sessions
costless	フリー|無償性
doleful	悲しい|悲しげな|憂いに沈んだ|陰鬱な
spellbinder	(聴衆を魅了する|特に政治家の中の)雄弁家
baize	ベーズ(玉突き台などに張る緑色の柔らかい毛織地)
debasement	品位の低下|悪化|凋落
ethene	エチレン
ornately	華美に|華麗に|飾り立てて
dreadlock	ドレッド(多数|細く三つ編みした髪型)
shrewdness	抜け目なさ|利口
sodoku	the form of ratbite fever occurring in the Far East
interstice	隙間|割れ目|裂目|穴|間隔
tractability	the trait of being easily persuaded
dunker	an eater who dips food into a liquid before eating it; "he was a dunker--he couldn't eat a doughnut without a cup of coffee to dunk it in"|an eater who dips food into a liquid before eating it|a basketball player who is able to make dunk shots|an adherent of Baptistic doctrines (who practice baptism by immersion)
brutalize	残忍にする|非人間的にする
lingam	リンガ
dicer	ダイサー(食物をさいの目diceに切るための器具)|a mechanical device used for dicing food|(生命科学)低分子2本鎖RNAを切り出す酵素
rhamnus	type genus of the Rhamnaceae: buckthorns
etagere	a piece of furniture with open shelves for displaying small ornaments
samosa	サモサ
antispasmodic	鎮痙薬
dogleg	(道路など犬の脚のように)くの字に曲がったもの
colorimetry	quantitative chemical analysis by color using a colorimeter
isogenic	同系の
turbofan	ターボファン(ジェット推進機関の一種)
assayer	分析(試金)者
goldmark	ゴルトマルク
dualist	an adherent of dualism
nonsmoker	非喫煙者
arthralgia	関節痛
thermostatically	by thermostat; in a thermostatic manner; "the temperature is thermostatically controlled"|by thermostat|in a thermostatic manner
furze	ハリエニシダ(《英》gorse)
misconceive	〜‘を'誤解する|思い違いをする(misunderstand)
neighbourly	exhibiting the qualities expected in a friendly neighbor
perianth	花被
alembic	ランビキ(昔の蒸留器|浄化器)
inglenook	炉辺|炉端
deification	神としてあがめること|神に祀ること|神格化
sensitiveness	感じやすさ|敏感さ|感じ易さ|センシビリティ|感受性|センシビリティー|感性|感度|敏感性|感度|感応性|感じやすさ|鋭感|感覚|感受性|鋭敏|感性|感度
redshank	a common Old World wading bird with long red legs
cultist	熱狂的な人|狂信者
chamaecyparis	a genus of Chamaecyparis
hydatid	水胞体
overprotective	過保護な
mendicant	物もらい;托鉢僧
threepenny	下らない
profilin	プロフィリン|筋肉タンパク質(Muscle Protein)の一種でアクチン重合調節等の機能を持つ
silvertip	灰色熊
giddiness	めまい|めまいがする|目がくらむ|うわついた|軽薄な
taraxacum	an asterid dicot genus of the family Compositae including dandelions
meaningfulness	有意|深長さ|有意義
commensal	食卓を共にする|(動植物が)片利共生的な|(異なる価値観･慣習を有する個人･集団と)共生する
antiquark	the antiparticle of a quark
retributive	報復の|応報の|retributive justice因果応報|報い
eatable	(食物が)食べられる[状態にある]|(特に手を加えていない)食料品(food)
photographically	写真術によって;写真のように
thoroughgoing	《名詞の前にのみ用いて》全くの(utter)|完ぺきな|徹底的な
downregulated	下方制御された|減少された|ダウンレギュレートされた
flagon	(食卓用または聖餐(せいさん)式用)細口びん|大型のぶどう酒びん
verticillium	a fungus of the genus Verticillium
rhodochrosite	a mineral consisting of manganese carbonate; a source of manganese|a mineral consisting of manganese carbonate|a source of manganese
wormy	虫のついた|虫の食った;虫だらけの|虫けらのような;浅ましい
tangency	＜tangeny|接触|2つのものが触れたり物理的に接触したりする接点
scattershot	やみくもの|めくら滅法の|でたらめの
octant	八分儀
demiurge	デミウルゴス
clonic	間代性
photocathode	光陰極
barefooted	素足で|はだしで|裸足の|素足の
backstretch	バックストレッチ(競技場のゴールと反対側の直線走路)
antiparticle	反粒子
clerestory	採光窓、高窓層(教会堂などで)採光用の高窓が並んだ側壁)|《米》高窓;)電車の天井両側にある)通風窓
graniteware	a kind of stone-grey enamelware
flecainide	フレカイニド
grifter	賭博師|(サーカス･縁日などで)見世物や賭事の店を出す人|詐欺師|ぺてん師|浮浪者
electrum	an alloy of gold and silver
armillary	of or relating to bracelets
biannually	隔年
epididymal	精巣上体の
demoralization	風紀を乱すること|堕落|退廃|(軍隊・軍人の)士気をくじくこと
steerer	操舵手
killjoy	興をさます人
forefather	祖先(ancestor)
pebbly	小石の多い
unrevealed	not made known
burgeon	発芽する|急速に発展する|芽|若枝
riskless	thought to be devoid of risk
descender	ディセンダ|ディセンダ|ディセンダ
abash	《通例受動態で用いて》〜'を'恥じ入らせる;〜'を'まごつかせる|面くらわせる
innervate	刺激する
sacristy	聖具室
charitably	慈悲深く|寛大に
preordain	〈神・運命が〉〜‘を'あらかじめ定める
torticollis	斜頚
offerer	someone who presents something to another for acceptance or rejection
amnesic	健忘
dendrogram	系統樹|ある主題を系統的に表現するのに樹木の形態を模したもの
slumlord	(スラム街の特に悪徳な)アパート家主
slather	量|多数|どっさり|厚く塗る|たっぷりと使う
synonymously	in a synonymous manner; "the two terms are used synonymously"|in a synonymous manner
interestingness	興味を起こさせる力
sylvanus	(Roman mythology) god of woods and fields and flocks; Pan is the Greek counterpart|god of woods and fields and flocks|Pan is the Greek counterpart
evilness	姦邪|不善|悪質|横道|邪悪|奸邪|邪|悪さ|悪
epizootic	家畜流行性
paten	パテナ(聖体祭儀のときパンをのせる金属製の皿)
stagflation	景気後退下のインフレ|スタグフレーション
curiosa	好色本
cannulation	カニューレ挿入|気管挿管
technocracy	〈U〉テクノクラシー|技術家主義(専門技術者に産業の支配・統制を任せようという理論);〈C〉技術家集団|(C)技術家主義の国家
kilovolt	キロボルト|kv
oracular	神託(託宣)の(ような)|威厳のある
technocrat	専門技術者|テクノクラート
homological	similar in evolutionary origin but not in function
undefended	無防備
transferrable	伝達性|伝達性
irrecoverable	(金・時間などが)取り戻せない;(損失・災害などが)回復できない
titillate	くすぐる(=tickle)
jujutsu	柔術
serail	ハーレム|後宮|后宮|内廷|ハレム
ingenue	純情娘|純情な少女
ovariectomy	卵巣切除|卵巣摘出
curtilage	庭|ガーデン
hallux	母趾
doxy	情婦|妾|姦夫
secularize	世俗化する
backcloth	=backdrop
manakin	マヌカン|マネキン|ファッションモデル|雛型|モデル|マネキン人形|マヌカン|マネキン
satisfyingly	満足させるように|十分に|満足させるほど
bemusement	惑い|混迷|戸惑い|迷い|困惑|当惑
chaw	a wad of something chewable as tobacco|chew without swallowing; "chaw tobacco"|chew without swallowing
metalanguage	〈U〉メタ言語(言語を論じるための表現・語句)
trackage	鉄道線路;軌道延長
amberjack	鰤
arcsin	the inverse function of the sine; the angle that has a sine equal to a given number|the inverse function of the sine|the angle that has a sine equal to a given number
rakish	みだらな|粋な|ハイカラな
roble	large tree of Trinidad and Guyana having odd-pinnate leaves and violet-scented axillary racemes of yellow flowers and long smooth pods; grown as a specimen in parks and large gardens|large tree of Trinidad and Guyana having odd-pinnate leaves and violet-scented axillary racemes of yellow flowers and long smooth pods|grown as a specimen in parks and large gardens|tall graceful deciduous California oak having leathery leaves and slender pointed acorns
effervescence	(喜び)興奮|沸騰|あわ立ち|はつらつさ
oxacillin	オキサシリン
aengus	アンガス
dehiscence	(biology) release of material by splitting open of an organ or tissue; the natural bursting open at maturity of a fruit or other reproductive body to release seeds or spores or the bursting open of a surgically closed wound|release of material by splitting open of an organ or tissue|the natural bursting open at maturity of a fruit or other reproductive body to release seeds or spores or the bursting open of a surgically closed wound
rhymer	詩人
unworthiness	不敏|不適|不穏当
pindolol	ピンドロール
peptone	ペプトン(たんぱく質がペプシンによって加水分解したもの)
pinchers	=pincers
exhume	(死体)を墓から掘り出す|を明るみに出す|を復活させる
unflagging	衰えない|疲れを知らない
codefendant	共同被告人
adiposity	肥満
gitano	a Spanish male Gypsy
laryngectomy	喉頭切除
collectivization	the organization of a nation or economy on the basis of collectivism
corroborative	(信念などを)強固にする|(人･証拠など)確証的な
oddment	残り物|はんぱ物;がらくた
conspectus	概観|概説|要約|摘要
antimetabolite	an antineoplastic drug that inhibits the utilization of a metabolite
disabuse	の迷いを解く|捨てさせる
tufa	トゥファ(温泉などに沈殿した炭酸石灰から成る多孔質の石灰石)
leaker	a surreptitious informant; "the president wanted to know who the leakers were"|a surreptitious informant
nadolol	ナドロール
eukaryote	真核生物(=eucaryote)|動物|植物|菌類|原生生物など|身体を構成する細胞の中に細胞核を有する生物|真核生物以外の生物は原核生物(prokaryote)と呼ばれる
photomicrograph	顕微鏡写真
hilar	of or relating to or located near a hilum
nonperformance	失着|不行き届き|不行届き|不注意|等閑|怠慢|過怠|無視|仮初め|不始末
diorite	閃緑岩
hardihood	大胆(boldness);ずぶとさ|厚かましさ
advective	of or relating to advection
roustabout	波止場人夫;油田人夫;サーカス小屋の人夫
hyaluronidase	ヒアルロニダーゼ
grapheme	文字記号|キャラクター|書記素|文字
onside	(フットボールなどで選手が)正規の位置にいる|オンサイドにいる|正規の位置に|オンサイドに
greenness	濃緑|翠|翠色|翠緑|緑|若緑
bedstraw	any of several plants of the genus Galium
psychically	from a psychic point of view; "he was psychically blind"|from a psychic point of view
recrimination	非難し返すこと|逆襲|責め合い
cinderblock	シンダーブロック(中空で軽量の建築用コンクリートブロック)
misbranded	branded or labeled falsely and in violation of statutory requirements; "confiscated the misbranded drugs"|branded or labeled falsely and in violation of statutory requirements
sphenoid	蝶形骨
thyrotoxicosis	甲状腺機能亢進症
aureole	(聖者・殉教者などの絵に見られる)光の輪|輪光|後光|(太陽・月にかかる)かさ
deodorize	eliminate the odor from; "This stick will deodorize your armpits"|eliminate the odor from
mediatrix	a woman who is a mediator
iridescence	(シャボン玉などの)にじ色|玉虫色
unsanctioned	without explicit official permission; "unsanctioned use of company cars"|without explicit official permission
physostigmine	フィゾスチグミン
cognisance	意識|意識すること|認識
trainman	列車乗務員
morus	桑|モールス信号
ballplayer	野球選手
asphyxiate	〜'を'窒息[死]させる|窒息[死]する
loir	ロアール川
embouchure	〈C〉(吹奏楽器の)吹口(すいこう)|〈U〉(吹口への)くちびるの当て方
overtop	〜‘の'上にそびえる|〜‘より'高い|〜‘より'すぐれる
evolutionism	進化論|進化主義
thoughtlessly	不親切に|無慈悲に|軽率に|不注意に|よく考えないで|考えなしに
symbolist	記号学者|記号使用者
pyromaniac	放火狂
lumpen	ルンペン|浮浪者(の)
plasticine	a synthetic material resembling clay but remaining soft; used as a substitute for clay or wax in modeling (especially in schools)|a synthetic material resembling clay but remaining soft|used as a substitute for clay or wax in modeling (especially in schools)
metathesis	複分解
forewing	(四枚羽を持った昆虫の)前翅(し)
mansard	(またmansard roof)マンサード屋根|二重こう配屋根|マンサード屋根下|屋根裏部屋
demagoguery	民衆扇動
periodontist	a dentist specializing in diseases of the gums and other structure surrounding the teeth
bucko	若者 (my ～)|若いの|君|(俗)いばりちらす(やつ)|筏師
forthrightly	まともに
whacker	とてつもなく大きいもの|大うそ|大ぼら
unfaithfulness	背信|不義|不誠実
globalise	make world-wide in scope or application; "Markets are being increasingly globalized"|make world-wide in scope or application
skeptically	懐疑的に
disorient	向きを狂わせる|混乱させる
mezzotint	〈U〉メゾチント彫刻(あらくした銅版面の所々をならして明暗をつける法)|〈C〉メゾチント版
guanaco	グアナコ
starless	星(星明かり)のない
noesis	了知|ナレッジ|知識|認識|認知|ノレッジ|ノリッジ
bedraggle	引く
hamamelis	deciduous shrubs or small trees: witch hazel
mercaptopurine	メルカプトプリン
ineradicable	根絶できない|根深い
glucotrol	an oral antidiabetic drug (trade name Glucotrol) that stimulates the release of insulin from the pancreas
trapezium	《米》不等辺四辺形|《英》台形
fontanelle	泉門
anencephaly	無脳症
unimaginably	もっての外
ravenously	がつがつ
goitre	甲状腺腫
ionize	イオン化する|電離する
plutocracy	〈U〉金権政治|(政治を左右する)富豪階級|財閥
dispassionately	冷静に
sundew	モウセンゴケ(食虫植物)
weighbridge	橋ばかり(車両と積荷を同時に計る計器)
hyperbilirubinemia	高ビリルビン血症
shortchange	サボる
diazo	ジアゾ
cincinnatus	キンキナトゥス
teagarden	屋外軽食堂|茶畑
yack	ヤク|おしゃべり
booboo	《俗》ばかげたあやまち|どじ|へま
heterosexism	discrimination in favor of heterosexual and against homosexual people
keloid	ケロイド
agranulocytosis	顆粒球減少症
trouper	旅芸人
attainder	(死刑などの判決後の)私権剥奪(はくだつ)
cadi	(イスラム教国の)裁判官
funfair	移動式遊園地|=amusement park
petrography	岩石分類学|記載岩石学
patronymic	父の名を取った名|父称|姓|名字の
homozygote	ホモ接合体
hotpot	ホットポット(羊肉・じゃがいも・玉ねぎなどを煮こんだ料理)
pome	梨果
preterist	a theologian who believes that the Scripture prophecies of the Apocalypse (the Book of Revelation) have already been fulfilled
mischievously	in a disobedient or naughty way; "he behaved badly in school"; "he mischievously looked for a chance to embarrass his sister"; "behaved naughtily when they had guests and was sent to his room"|in a disobedient or naughty way
mousy	おとなしい|おどおどした|ネズミ色の|ネズミの|ネズミの多い|ネズミ臭い|内気な
communistic	共産主義[者]の|共産主義的な
illicitly	違法|不法
colly	穢す|汚す
blepharitis	眼瞼(けん)炎(まぶたの炎症)
immunofluorescent	免疫
ecor	環境保全運動の商標
dyestuff	染料
metacarpal	中手骨
trustor	(law) a person who creates a trust by giving real or personal property in trust to a trustee for the benefit of a beneficiary; a person who gives such property is said to settle it on the trustee|a person who creates a trust by giving real or personal property in trust to a trustee for the benefit of a beneficiary|a person who gives such property is said to settle it on the trustee
appropriator	専有する人|盗用(横領)する人|《英》教会禄(ろく)の設定を受けた宗教法人
derisively	にったり
provisioner	a supplier of victuals or supplies to an army
kohlrabi	カブラタマナ;キャベツの一種
oligarch	one of the rulers in an oligarchy
spoliation	強奪|略奪
unsentimental	facing facts or difficulties realistically and with determination
bedding	寝具類|bedclothes|(牛馬の)敷き藁
pleasantness	心地よさ|楽しさ
pennywhistle	笛|ティン・ホイッスル
sandfly	スナバエ
terminable	終わらせることのできる;(契約などが)期限のある|有期の
phosphorescence	リン光[を出すこと];青光り
balladeer	バラｰド歌手|ポピュラー歌手|民謡歌手
dirigible	操縦できる
geriatrician	老人病専門医
dominical	of or relating to or coming from Jesus Christ|of or relating to Sunday as the Lord's Day
unaired	lacking fresh air; "a dusty airless attic"; "the dreadfully close atmosphere"; "hot and stuffy and the air was blue with smoke"|lacking fresh air
salvelinus	イワナ
mugging	強盗|暴力スリ
lustily	in a healthy manner; "the young plants grew lustily"|in a healthy manner
bakehouse	ベーカリー|パン屋
skinfold	皮下脂肪
luxuria	情欲|性慾|欲情|淫欲|愛欲|肉慾|色情|婬情|獣欲|愛慾
neptunium	ネプトニウム(放射性元素;化学記号は『Np』)
opencast	露天掘りの
bimetal	バイメタル
sixfold	6倍の|6重の|6倍に|6重に
panchromatic	(写真のフイルムなどが)全整色の|全色の|パンクロの
pedagogically	in a didactic manner; "this is a didactically sound method"|in a didactic manner
camptothecin	カンプトテシン(CPT)は細胞毒性のあるアルカロイド(Alkaloid)|DNA酵素の働きを阻害する|抗がん剤として中国原生のカンレンボクの樹皮と幹から単離された
wineglass	ワイングラス
dyscalculia	impaired ability to learn grade-appropriate mathematics
clubfoot	内反足|えび足|〈U〉内反足である状態
unchain	〜‘の'鎖を解く|‘を'自由にする
antediluvian	大昔の|時代遅れの(人)
acetabulum	寛骨臼
ritualize	make or evolve into a ritual; "The growing up of children has become ritualized in many cultures"|make or evolve into a ritual
narrowboat	a long boat that carries freight and is narrow enough to be used in canals
maleness	雄性|男らしさ
irreligious	無宗教の
debriefing	教書
bondholder	公債証書(社債券)所有者
dingus	なんとかいう物(人)
chorion	絨毛膜
vaulter	an athlete who jumps over a high crossbar with the aid of a long pole
sakti	シャクティー
oenology	the art of wine making
laggard	遅れる人
beany	a small skullcap; formerly worn by schoolboys and college freshmen|a small skullcap|formerly worn by schoolboys and college freshmen
sial	the granitelike rocks that form the outermost layer of the earth's crust; rich in silicon and aluminum|the granitelike rocks that form the outermost layer of the earth's crust|rich in silicon and aluminum
tractive	exerting traction and serving to pull
numismatist	古銭学者
hindbrain	菱脳
greengrocer	青物商人|やお屋
whacko	気違
scholasticism	(中世の)スコラ哲学
comptrollership	the position of comptroller
adjunction	別れ目|分かれ目|分点|ジャンクション|分岐駅
effeminacy	男らしくないこと|優柔不断
unmindful	(〜を)気にかけない|(〜に)むとんじゃくな《+of+名(wh-節)》
magnetohydrodynamics	磁気流体力学
coppery	銅の[ような]|銅を含んだ|銅色の
cercopithecus	オナガザル
waterwheel	水車
pallium	大脳皮質|外套|外套膜|外套|外套
ceramist	陶器製造者|陶工|陶芸家
cabala	カバラ|カバラ
cannibalistic	人食いの;共食いの
indescribably	言語道断
gimpy	不自由
lineout	(ラグビーで)ラインアウト
unruffled	平静な
noncombustible	不燃性
horrify	ぞっとさせる
emendation	〈U〉(〜の)校正《+『of』+『名』》|〈C〉《しばしば複数形で》訂正[箇所]
coppersmith	銅細工師
orudis	ケトプロフェン
anaesthetize	麻酔
acerola	アセロラ
cytometer	血球計算器
cowslip	キバナノクリンザクラ|リュウキンカ
polygyny	一夫多妻|(植物の)多雌ずい性
intoxicant	酔わせる;心を浮き立たせる|酔わせるもの;(特に)アルコール飲料
palaeoecology	古生態学
supernaturally	超自然
enfranchisement	選挙権(公民権|自治権)の賦与|解放|釈放
ramekin	ラミキン(チーズやパン・卵などを混ぜて1人前ずつ焼いた料理)|ラミキン料理用の皿
gravitationally	with respect to gravitation; "gravitationally strong forces"|with respect to gravitation
scarily	in an alarming manner; "the disturbing thing about the Minister's behavior is that far from being artificial, it too often rings frighteningly true"|in an alarming manner
craftiness	ずるさ|悪がしこさ
marketing	マーケティング|市場取引|市場で売買すること|買い物
jaffar	ジャアファル
perceptibly	知覚できるように|目立って
reflectometer	反射率計
wizened	しなびた
gametophyte	配偶体
numerate	〜‘を'数える|数え上げる|《おもに英》足(た)し算引き算の能力のある|数学の分かる
townsman	都会人|町内の人
polymerize	重合|重合
underly	基礎となる
scratching	キーキー
phacelia	any plant of the genus Phacelia
playsuit	プレースーツ(婦人・小供用スポーツ着);(小供の)遊び着
ligustrum	genus of Old World shrubs: privet
principalship	the post of principal
prophase	前期|前期
mildness	柔和さ|温和な性質|適度な状態|おだやかさ
luckless	不幸な|不運な
arabis	annual to perennial woody herbs of temperate North America, Europe and Asia: rockcress
cucumis	cucumbers; muskmelons|cucumbers|muskmelons
cavalryman	(1人の)騎兵
ossuary	any receptacle for the burial of human bones
hypotonia	低圧
housetop	屋根(roof)
falloff	減少|衰退
procurer	(男性の)売春婦周旋屋
agonize	苦しむ|悶える|苦闘する|苦しめる
indigestible	消化しにくい|不消化の
sorbus	a genus of shrubs or trees of the family Rosaceae having feathery leaves
lordosis	an abnormal inward (forward) curvature of the vertebral column
kingmaker	(政党の)実力者|有力者|国王擁立者(Henry6世とEdward4世を擁立したEarl of Warwickを指す)
kenaf	インド大麻
fanatically	in a passionately fanatic manner; "he followed the teachings of his guru fanatically"|in a passionately fanatic manner
sidelight	サイドランプ|横からの光線|付随的な情報|わき窓
astilbe	アスチルベ
flashover	フラッシュオーバー
troglodyte	穴居人|隠者|世事にうとい人
inclosure	=enclosure
voluptuousness	豊富|曲線美
flashbulb	フラッシュバルブ|閃光電球
prodrug	プロドラッグ(そのままでは不活性な医薬品|投与されると|生体による代謝作用を受けて活性代謝物へ変化し|薬効を示す)
cassowary	ヒクイドリ(ニューギニア・オーストラリア産)
petrolatum	ワセリン
panga	刃が長く広い刀|大なた
seraglio	(イスラム教国の)後宮|ハレム
underexpose	〈写真のフィルム〉‘を'露出不足にする
carious	カリエス(caries)性の|カリエスにかかった
noncitizen	非市民
souvlaki	スブラキ
thwack	ピシャリと打つこと|バシッと叩くこと|試み|分け前|をピシャリと打つ
triggerfish	any of numerous compressed deep-bodied tropical fishes with sandpapery skin and erectile spines in the first dorsal fin
warehouseman	a workman who manages or works in a warehouse
pueraria	genus of woody Asiatic vines: kudzu
micropayment	ネット上のコンテンツを利用する際にかかる少額の料金
stablemate	a horse stabled with another or one of several horses owned by the same person
theoretician	理論家
modernistic	現美主義[者]の;現代的な|新しい
grotty	きたない|不潔な|不快な
fissionable	(原子が)核分裂を起こす|核分裂性の
inappropriateness	不適|不穏当|不適|不穏当
squamata	diapsid reptiles: snakes and lizards
guiltily	罪を犯して|やましい気持ちで|気まずそうな顔をして
flub	失敗(する)|へま(をする)
turncoat	変節者|裏切り者
nard	甘松(かんしょう)香(古代人が用いた香油)
treater	取り扱う人|処理する人|人におごってやる人
longsuffering	しんぼう強い|我慢強い
aurally	耳から|耳で|聴覚的に|聴覚で
hankie	汗ふき|ハンケチ|鼻拭|ハンカチ|汗拭|汗手拭い|汗拭き|ハンカチーフ|ハンケチーフ|手巾
weigher	an official who weighs and records the weight
shitless	extremely frightened; "he was scared shitless"|extremely frightened
hypercapnia	the physical condition of having the presence of an abnormally high level of carbon dioxide in the circulating blood
dinesen	ディネーセン
shrive	(司祭が)〜‘の'ざんげを聞いて罪の許しを与える|司祭にざんげする;〈司祭が〉ざんげを聞く
admiringly	with admiration; "he looked at his wife admiringly"|with admiration
intone	吟唱(ぎんしょう)する|詠唱する|抑揚をつける
saiga	goat-like antelope of central Eurasia having a stubby nose like a proboscis
saleswoman	女店員|女性販売員
awfulness	ひどく不愉快なこと
hobnob	懇談|親しくつきあう|親しく話をする
photophobia	羞明|羞明
movingly	ぐんと
encamp	〈兵士・部隊など〉‘を'野営させる|(テントで)〈部隊などが〉野営する
henceforward	=henceforth
bmdo	an agency in the Department of Defense that is responsible for making ballistic missile defense a reality
frustum	円錐(すい)台(円錐の上部を切り取った形)
viroid	ウイロイド
monthlong	1カ月
womanize	女三昧|女性化
tautological	(同じ意味の言葉が)重複した|類語反復の
braw	煌びやか|はでやか|派手やか|綺羅びやか|派手
uncorrupted	(of language) not having its purity or excellence debased; "uncorrupted English"; "learn to speak pure English undefiled"- Van Wyck Brooks|(of language) not having its purity or excellence debased|not decayed or decomposed|not debased; "though his associates were dishonest, he remained uncorrupted"; "uncorrupted values"|not debased
jingoistic	(盲目的な)対外強硬主義(者)の|主戦論(者)の
unfertilized	not having been fertilized; "an unfertilized egg"|not having been fertilized
medicinally	in a medicinal manner
smoothy	妖魔
lungfish	肺魚
surplice	サープリス(聖職者|聖歌隊などが着る|そでの広い長い白の法衣)
factitious	人為的な|人工の|故意に作られた
striving	苦労|ご苦労|労苦|骨折り
globigerina	marine protozoan having a rounded shell with spiny processes
transcendentalist	先験論者;超絶論者
fitfully	五月雨
asperity	(気質・態度・語調などの)とげとげしさ|荒々しさ|(気候・生活などの)厳しさ|辛さ|困難
chancy	危なっかしい|危険な|当てにならない|不確かな
imminence	切迫(した事情)
desalt	脱塩
holdfast	留具|留め具
caber	(力試しの競技で投げる)木の柱|柱投げ競技
demur	(特に良心のとがめから)異議を唱える
beachball	ビーチボール
stockinette	メリヤス編み
monstrously	恐ろしく|恐ろしく|怪奇に|ひどく|気味悪く
communicant	聖餐(せいさん)を受ける人|聖体拝受者|(情報などを)伝達する人
spathiphyllum	スパティフィラム属
probabilistically	by the use of probability theory; "we can calculate the position of the particles probabilistically"|by the use of probability theory
accost	呼びかける|話しかける|ことばをかけて近寄る
prophetically	預言(予言)的に|預言(予言)して
neutralisation	中立化|ニュートラル|中立|中和
quirkiness	珍妙さ|奇僻|ひと癖|奇癖|風変わり|一癖|奇矯|奇異|風変り|粋狂
typographer	活版印刷工|活版植字工
fugacity	揮散力|揮散力
diaphanous	透けて見える|透明な|ほのかな|かすかな
flextime	フレックスタイム
fiendishly	悪魔のように|ひどく|大変に
rhombic	resembling a rhombus
burglarize	押し入り強盗をする
orthopedist	整形外科医
goniometer	測角器
equalise	同点にする|同点になる|匹敵|平均|対抗
angulation	アンギュレーション|アンギュレーション
baluster	手すり子(手すり・らんかんの小柱;通例屋外で石造のもの)|《複数形》で=balustrade
peradventure	たぶん|おそらく|《『if』または『lest』の後に用いて》偶然に|ひょっとして
psychobabble	using language loaded with psychological terminology
bedevil	(人を)悪魔に取りつかせる|混乱させる|苦しめる
spermicidal	destructive to spermatozoa
stocktake	an instance of stocktaking; "the auditor did not attend the stocktake or check the valuations"|an instance of stocktaking
earwig	ハサミムシ(寝ている人の耳に入り害をすると考えられた)
radiolocation	電波探知法
ijtihad	イジュティハード
conspecific	an organism belonging to the same species as another organism|belonging to the same species; "cultivated cabbage and wild cabbage are conspecific"|belonging to the same species
arachnophobia	a morbid fear of spiders
speculatively	with speculation; in a speculative manner; "he looked at her speculatively"|with speculation|in a speculative manner
cortege	《集合的に》従者の列|行列|(特に)葬列
autolysis	自己分解
diamagnetic	反磁性の|逆磁気の
contradistinction	(〜との)対比|対照的区別《+『to』+『名』》
terpene	テルペン
baster	a cook who bastes roasting meat with melted fat or gravy|a sewer who fastens a garment with long loose stitches|a tube with a rubber bulb used to take up and release melted fat or gravy in order to moisten roasting meat
manorial	荘園の|領地の
inglorious	不名誉な|恥ずべき
pennisetum	チカラシバ
whereat	《疑問副詞》何に|なんで(at what)|《関係副詞》|《制限用法》[〜に]〜する[ところの](at which)|《非制限用法》そこで|すると(whereupon)
parch	をからからにする|あぶる|をからからに乾かす|を炒る|干上がる|からからになる
misconstrue	解釈を誤る|(人･行為など(の意図)を)誤解する
yid	ユダヤ人
normalizer	正規化器
invar	インバー
amoy	最小値
diviner	巫|占者|占師|占い師|卜者
celandine	クサノオウ(ケシ科の植物)
irreducibly	削減できないほどに
monoplane	単葉飛行機
reify	〈抽象観念など〉‘を'具体化する|具象化する
moonflower	ヨルガオ
recognizably	すぐ分かる
semipro	=semiprofessional
autoloading	半自動
cancan	カンカン踊り(女性が脚を高く振り上げスカートを振る踊り)
insupportable	我慢できない|根拠のない|支持できない|耐えられない
gastrocnemius	腓腹筋
undisguised	あからさまの|むき出しの
plebe	士官候補生
adulteress	姦通した女(人妻)|姦婦(かんぷ)
syntagma	a syntactic string of words that forms a part of some larger syntactic unit
haberdasher	《英》小間物商人|《米》男子用服飾品商人
sugi	杉
decidua	脱落膜
autochthonous	(植物などが)土地原産の|土着の
tenderizer	a substance (as the plant enzyme papain) applied to meat to make it tender
osteology	骨学
lobar	of or relating to or affecting a lobe; "lobar pneumonia"|of or relating to or affecting a lobe
retrogression	後退|逆行|退化
vocalise	話す|陳ずる|言う|発声|言う
macaroon	マカロン(卵白・砂糖・アーモンドなどで作った菓子)
binger	someone addicted to crack cocaine
unalloyed	(感情などが)純粋な(pure)|本物の
ferromagnetism	強磁性
mannerly	礼儀正しい|ていねいな
twangy	(弦をはじいたように)ビーンという|(声が)鼻にかかった
mudguard	(車の車輪の上にある)泥よけ
lactalbumin	ラクトアルブミン
headstall	(馬具の)おもがい(面繋)
ovule	胚珠(はいしゅ)
venial	(罪・過ちが)重くない|許されるべき|ささいな
indiscipline	訓練不足(欠如)|不規律
hansom	つじ馬車(御者台は後部に一段高くなっている)
nonchalance	むとんちゃく|無関心
pentameter	(詩の行の)五歩格|五歩格の詩|五歩格の
windbag	おしゃべりな人|(バグパイプの)空気袋
boarding	板張り
capelin	カラフトシシャモ
worktable	仕事台
pimozide	ピモジド
callously	冷淡に
fiberoptics	the transmission of light signals via glass fibers
dysarthria	impaired articulatory ability resulting from defects in the peripheral motor nerves or in the speech musculature
resoundingly	(音など)鳴り響く|めざましい|顕著な
doubtlessly	疑いもなく|疑いも無く|正しく|まさしく
meathead	《俗》まぬけ|ばか
waterer	someone who waters plants or crops|an assistant who supplies drinking water
lycopodium	ヒカゲノカズラ
utopianism	ユートピアニズム|ユートピア的理想主義|ユートピア的理想論
brocket	small South American deer with unbranched antlers|male red deer in its second year
hepatomegaly	abnormal enlargement of the liver
maladjusted	調節の悪い
caprine	being or pertaining to or resembling a goat or goats; "caprine creatures"; "a caprine strain of virus"; "a caprine voice"|being or pertaining to or resembling a goat or goats
jacobin	a member of the radical movement that instituted the Reign of Terror during the French Revolution
epistasis	エピスタシス|遺伝学において|異なる遺伝子座間の相互作用が一つの形質に影響すること
catechin	カテキン
bombproof	防弾の|爆弾の通らない
dialyze	透析
constrictive	締めつける|圧縮する
stratocumulus	層積雲
proficiently	器用
egis	=aegis
meadowsweet	シモツケソウ(白またはピンクの花をつける)
insincerity	〈U〉不誠実|不まじめ|〈C〉不誠実な言葉(行動)
pokeweed	ヤマゴボウ属
erysipelas	丹毒(たんどく)(連鎖球菌により生じる急性伝染病)
persecutor	迫害する者
cupric	第二銅の|銅を含んだ
slobber	だらしなくやる
manoeuvrability	操縦性
coital	性交の|交接の
acquirement	〈U〉(不断の努力・習慣などによって)(〜を)取得(習得)すること《+『of』+『名』》|〈C〉《しばしば複数形で》(身につけた)学識|技能
unproblematic	シンプル|易しい|わかりやすい|易い|単純|分り易い|単簡|簡易|簡単|分りやすい
landholder	地主;借地人
physicalism	唯物論
nabumetone	ナブメトン
electrodeposition	電着
unvented	not provided with vents
burgher	公民|市民
lacquerware	漆器
archrival	第一級の競争相手|大敵
unstained	汚れのない
lycanthrope	ワーウルフ
pilsener	ピルゼンビール(こはく色の軽い貯蔵ビール)|ピルゼングラス(特にビール用の底が先細りのグラス)
phalaris	a genus of grasses with broad leaves and a dense spike of flowers
ruination	〈U〉破滅|崩壊|荒廃;破産|〈C〉破滅(崩壊)の原因|破滅をもたらすもの
seminiferous	輸精
progressivity	advancement toward better conditions or policies or methods
monocle	単眼鏡|片めがね(目のくぼみにはめて用いる)
undyed	not artificially colored or bleached; "unbleached blonde hair"; "her hair is uncolored"; "undyed cotton"|not artificially colored or bleached
chiasm	キアズマ|交差
spicule	針状のもの|(海綿などの)針骨|針片|(植物の)小穂(すい)状花　交接針
willfulness	我がまま|我侭|わがまま|我が侭|我が儘|我儘
vocalic	母音の|母音を含む|母音のような
circumcise	〜‘に'割礼を施す
salonica	セサロニキ|サロニカ
swampland	沼沢地
calcination	か焼(かしょう)(石灰を焼いて生石灰にすること)
saponin	サポニン
theodicy	the branch of theology that defends God's goodness and justice in the face of the existence of evil
misstate	〜‘に'ついて間違って(偽って)述べる
granulocytic	顆粒球
opaline	=opalescent|〈U〉乳白ガラス
totara	valuable timber tree of New Zealand yielding hard reddish wood used for furniture and bridges and wharves
unclothe	〜‘の'衣服を脱がす|‘を'裸にする
quantitate	定量|定量化する
whap	ぶん殴る|打ん殴る|ぶっ飛ばす|打っ飛ばす
mutualism	共生
snowberry	セッコウボク(北米産のスイカズラ科の低木;ピンク色の花と白い実をつける)
cranch	噛砕|潰す|噛砕く|挽く|粉砕|打ち砕く|噛る|噛みしだく|齧る|碾く
capulin	Mexican black cherry tree having edible fruit|Mexican black cherry
middy	《話》=midshipman|=middy blouse
verdin	アメリカツリスガラ
pervasively	in a pervasive manner
encrustation	(堅い外皮や表面で)覆うこと;覆われている状態|(宝石・貴金属を)ちりばめること
gargantua	a voracious giant in Francois Rabelais' book of the same name
microbrew	地ビール
diathermy	透熱療法(高周波の電流を利用した治療法)
platy	small stocky Mexican fish; popular aquarium fish|small stocky Mexican fish|popular aquarium fish
malleus	つち骨(中耳の三つの骨のうちで最も外側にある)
conversationalist	座談家|話し好きな人|話し上手
overgrow	《受動態で》〈草などが〉〜‘に'一面に生える|はびこる|〜‘より'大きくなる|はびこる|大きくなり過ぎる
busybody	世話好きな人
unpopulated	居住者のいない|人の住んでいない
chinoiserie	シノワズリ
bedclothes	寝具|夜具(マットまたは敷きぶとん以外のシーツ|毛布|掛けぶとんなど)
perilla	small genus of Asiatic herbs
coastwise	沿岸の|海岸に沿って
sulfadiazine	サルファダイアジン
leatherwork	革細工
impertinence	不適切|無礼
cocobolo	a valuable timber tree of tropical South America
languidly	in a languid and lethargic manner; "the men languidly put on their jackets"|in a languid and lethargic manner
lowboy	低い脚のついたたんす
sedulously	せっせと|勤勉に|入念に
stipendiary	俸給を受けている|有給の|有給治安判事
breadbox	a container used to keep bread or cake in
earworm	音楽が頭にこびりついて離れない現象|耳の中の虫(例え)
christological	of or relating to Christology
voraciously	がつがつ
unemployable	(年齢・欠陥などで)雇えない|雇用できない
hemoptysis	喀血
autoantibody	自己抗体
lateralization	側性
darky	黒ん坊
aplasia	形成不全
mym	a metric unit of length equal to 10,000 meters
pyrrolidone	ピロリドン|一般的な有機溶媒で無色の液体|インクジェットカートリッジ等に使用
isomerism	異性
epinephelus	genus of groupers or sea bass
lutra	in some classifications considered a genus of the subfamily Lutrinae
cyprinus	type genus of the family Cyprinidae: carp
prepubertal	思春期前
rinderpest	牛疫|牛ペスト(家畜の伝染病)
fleabane	ノミヨケ草
devisee	someone to whom property (especially realty) is devised by will
cruddy	汚い
siloxane	any of a large class of compounds that have alternate silicon and oxygen atoms
upraise	《おもに文》〜‘を'持ち上げる|起こす|〈地層〉‘を'隆起させる
disorientate	=disorient
tendentious	(文書･発言)傾向的な|宣伝的な|偏向した
recessional	(礼拝式後)司祭と聖歌隊が退場のときに歌う|(礼拝式後の)退出の賛美歌
workaday	平日の|仕事日の
roundworm	回虫
organdy	オーガンジー|オーガンディー
martensite	マルテンサイト
toxicologic	毒物学的
surveil	keep under surveillance; "The police had been following him for weeks but they could not prove his involvement in the bombing"|keep under surveillance
smasher	強打者|ビューティ|契情|辨天|ビューティー|佳人|小町|弁天|美形|別嬪|シャン|大ヒット|大成功|大当たり
enjoyably	楽しく
thrum	=strum|〈テーブルなど〉‘を'指でコツコツたたく|=strum|(テーブルなどを)指でコツコツたたく《+on+名》|〈大型機械が〉低いうなり音をたてる|つま弾くこと(音);コツコツ[擬声音]
unfruitful	not fruitful; not conducive to abundant production|not fruitful|not conducive to abundant production
loquat	ビワ(=Japanese medlar)|medlarは「西洋カリン」
necrophagia	feeding on corpses or carrion
anthropomorphism	擬人説|神人同形法(人間以外のもの|特に神に人間の形態・属性があるとする説)
whitecap	=white horse
burgle	夜盗する
icterus	黄疸|黄疸
mebendazole	メベンダゾール
townie	resident of a college town not affiliated with the college
tendril	巻きひげ|つる
trapezius	僧帽筋
pneumonic	肺の
nubby	of textiles; having a rough surface; "a sweater knitted of nubbly homespun yarns"|of textiles|having a rough surface
silicide	ケイ化物
baulk	=balk
waterbuck	ウォーターバック
quaff	〜‘を'がぶがぶ飲む|痛飲する|がぶ飲みする|痛飲する|がぶ飲み|痛飲
papery	紙のような|薄い
solemnize	observe or perform with dignity or gravity; "The King solemnized this day of morning"|observe or perform with dignity or gravity|perform (the wedding ceremony) with proper ceremonies|make solemn and grave; "This ceremony solemnized our hearts"|make solemn and grave
depersonalization	離人神経症|離人症|離人症|離人症
tobacconist	たばこ業者|たばこ屋の主人(店員)
meshwork	網細工
westernization	西洋化|欧化
foreshorten	〈物・風景〉‘を'遠近法で描く|〈物体・風景〉‘を'縮小する
pulsatilla	includes a group of plants that in some classifications are included in the genus Anemone: pasqueflowers
colouring	人工着色料|着色料|色|色彩|色相|カラー|色合い|色合|色調|彩り|彩色|呈色
cohere	首尾一貫している|結合する|密着する
quango	a quasi nongovernmental organization; an organization that is financed by the government yet acts independently of the government|a quasi nongovernmental organization|an organization that is financed by the government yet acts independently of the government
licentiousness	不品行|不行状|不行跡|放蕩
grantsmanship	補助金獲得術(方法)
aridity	不毛|無味乾燥
incomprehension	理解していないこと|無理解
unshaken	揺れない|びくともしない
secularisation	俗化
edentulous	having lost teeth
limply	弱々しく
chaffinch	ズアオアトリ(ヨーロッパ産の小型の鳴き鳥)
poundage	没収|留置
loincloth	下帯|腰巻き|ふんどし
madrasa	マドラサ
plainsman	平原(草原)の男の住民
misjudge	の判断を誤る|誤って判断する
combinatory	marked by or relating to or resulting from combination|relating to or involving combinations|able to or tending to combine
cental	センタル|ハンドレッドウェイト
metonymy	代喩|換喩(法)|あるものを密接な関係のある事物や属性で表現する修辞法|kingの代わりにcrownを|the Presidentの意でthe White Houseを用いるなど
charcuterie	a delicatessen that specializes in meats
anaemic	=anemic
euglena	ミドリムシ
proconsul	(古代ローマの)地方総督;(近世の)植民地総督
nonthermal	not involving heat; "nonthermal luminescence"|not involving heat
algren	United States writer (1909-1981)
reduplication	畳語|畳語|畳語|繰り返し
minium	鉛丹
albuminuria	蛋白尿
engagingly	愛想よく|魅力的に
gentility	洗練|上品|生まれの良さ|上流気取り|上品ぶった態度
notepaper	=writing paper2
nearsighted	近視の
laudatory	賞賛の
thiopental	チオペンタール
mudslinging	(特に政治家の)泥試合|中傷|個人攻撃
laminitis	蹄葉炎
ursine	クマの|クマに関する|クマに似た
ciliated	繊毛性
bridgeable	capable of being connected by a bridge or as if by a bridge
suggestively	陰に
rhodonite	a pink or red mineral consisting of crystalline manganese silicate; used as an ornamental stone|a pink or red mineral consisting of crystalline manganese silicate|used as an ornamental stone
cytokinin	サイトカイニン
butterbur	small Eurasian herb having broad leaves and lilac-pink rayless flowers; found in moist areas|small Eurasian herb having broad leaves and lilac-pink rayless flowers|found in moist areas
quadruped	四足(よつあし)獣(通例哺乳(ほにゅう)類)|四つ足の
mamo	black honeycreepers with yellow feathers around the tail; now extinct|black honeycreepers with yellow feathers around the tail|now extinct
woosh	move with a sibilant sound; "He whooshed the doors open"|move with a sibilant sound
honourably	光栄
unexploited	undeveloped or unused; "vast unexploited (or undeveloped) natural resources"; "taxes on undeveloped lots are low"|undeveloped or unused
chivalric	characteristic of the time of chivalry and knighthood in the Middle Ages; "chivalric rites"; "the knightly years"|characteristic of the time of chivalry and knighthood in the Middle Ages
trichloride	三塩化物
applejack	《米》リンゴブランデー(発酵させたリンゴ酒を蒸溜して作る)
lurcher	ラーチャー
womankind	婦人|女性
conformer	配座異性体(Life Science生命科学)
anhinga	fish-eating bird of warm inland waters having a long flexible neck and slender sharp-pointed bill
niter	硝酸カリウム|硝石
cruciferous	of or relating to or belonging to the plant family Cruciferae
pyxis	蓋果|蓋果|蓋果
lymphoblast	リンパ芽球
peacoat	ピージャケット
myometrium	the smooth muscle forming the wall of the uterus
decisionmaker	意思決定者
cecal	of or like a cecum
litoral	リトラル
avionic	of or relating to avionics
palpitation	動悸
haughtily	ごう慢に|横柄に
diffusely	in a diffuse manner; "the arteries were diffusely narrowed"|in a diffuse manner
balkanization	＜Balkan|バルカニゼーション|バルカン化|小国乱立状態
sweetmeat	砂糖菓子|キャンデー|ボンボン;果物の砂糖づけ
taenia	a narrow headband or strip of ribbon worn as a headband|tapeworms parasitic in humans which uses the pig as its intermediate host
orchiectomy	睾丸摘出術
chrysoprase	クリソプレーズ
tousle	〈髪など〉‘を'乱す|もつれさせる
venire	(sheriff に対する)陪審員召集令状;召換状
perforate	〜‘に'穴をあける|‘を'突き通す|〈紙など〉‘に'ミシン目を入れる|(穴で)切り取り線をつける|(〜に)穴をあける|(〜を)貫通する《+『into(through)』+『名』》
bouffant	フワフワした髪型|ふっくらした|膨れた|ダブダブした
klansman	Ku Klux Klanの団員
prolegomena	=prolegomenon
amebiasis	アメーバ症
halberd	ほこやり(中世に用いられた|やりとまさかりを兼ねたもの)
entombment	埋葬
outflank	〈敵〉‘の'側面に回る|〈相手〉‘の'裏をかく|‘を'出し扱く
vouchsafe	〈返事・特典など〉‘を'賜る|与える
hereabouts	このあたりに
blackguard	《軽べつして》げす;悪漢|ごろつき|〈人〉‘に'悪態をつく|〜'を'ののしる
unitarianism	ユニテリアン主義
horsehead	any of several silvery marine fishes with very flat bodies
warplane	軍用機
halcion	トリアゾラム
rhetorician	修辞学者;大げさな言葉を使う人
garrulous	おしゃべりの|口数の多い|饒舌な|多弁な|冗長な
duette	二重奏|デュエット|デュオ|二重奏|デュエット|デュオ
pinchbeck	ピンチベック(銅と亜鉛の合金;金に見える)|偽物
roundhead	a brachycephalic person|a supporter of parliament and Oliver Cromwell during the English Civil War
pyrrhic	a metrical unit with unstressed-unstressed syllables|an ancient Greek dance imitating the motions of warfare|of or relating to a war dance of ancient Greece; "pyrrhic dance movements"|of or relating to a war dance of ancient Greece|of or relating to or containing a metrical foot of two unstressed syllables; "pyrrhic verses"|of or relating to or containing a metrical foot of two unstressed syllables|of or relating to or resembling Pyrrhus or his exploits (especially his sustaining staggering losses in order to defeat the Romans); "a Pyrrhic victory"|of or relating to or resembling Pyrrhus or his exploits (especially his sustaining staggering losses in order to defeat the Romans)
motormouth	someone who talks incessantly; "I wish that motormouth would shut up"|someone who talks incessantly
amontillado	pale medium-dry sherry from Spain
lepomis	bream
batholith	バソリス|底盤|深成岩
bellboy	ベルボーイ(呼びりんに応じて荷物運びや使い走りをするホテル・クラブのボーイ;《米》bellhop)
serviette	ナプキン
photogravure	グラビア印刷;〈C〉グラビア写真
sloppily	だらしなく;いいかげんに
circumscription	制限;境界[線]|周囲;区域|(幾荷で|円の)外接
galatian	a native or inhabitant of Galatia in Asia Minor (especially a member of a people believed to have been Gauls who conquered Galatia in the 3rd century BC)
appointive	任命(任用)による
bencher	(英国で)法曹学院(Inn of Court)評議員
amiably	感じよく
sundog	幻日
deicer	デフロスター
blowhole	(トンネル・地下室などの)通風孔|(クジラの)噴気孔|(鋳物の)気泡(ほう)|(アザラシなどが呼吸するための)氷の中の穴
shoplift	〜‘を'万引きする|万引きする
iconoclasm	the orientation of an iconoclast
fulsome	(お世辞などが|過度のために)飽き飽きする|鼻につく|あくどい|お世辞たらたらの
schmalz	シュマルツ
gauzy	薄織のような|薄く透き通る
ascendance	優越|優勢|優位
knowledgeably	博識に|うんちくを傾けて
whippersnapper	小さな人物|こしゃくなやつ|若造
badmouth	《俗》〜'を'けなす|こっぴどくやっつける
paddlefish	primitive fish of the Mississippi valley having a long paddle-shaped snout
footplate	the platform in the cab of a locomotive on which the engineer stands to operate the controls
longhand	普通の手書き
sonication	超音波処理
tuatara	昔蜥蜴|ムカシトカゲ
marcher	行進者|国境地方の住民
incorrectness	不正確さ
anticline	背斜褶曲(しゅうきょく)(岩石層が中軸より左右側に下方傾斜した地層構造)
gramicidin	グラミシジン
aneurysmal	relating to or affected by an aneurysm
ignitable	引火性
lvii	being seven more than fifty
legerdemain	手品(の早わざ)|ごまかし|虚偽|こじつけ
sleepwalk	簡単なこと|夢中歩行|夢遊する
insectivorous	食虫性の|虫を食う
moated	《名詞の前にのみ用いて》堀で囲まれた(守られた)
scrollwork	うず形装飾|雲形模様
owlet	フクロウの子|小型のフクロウ
amoebic	=amebic
godforsaken	(人が)神に見放された|(土地が)荒れ果てた
dilatory	のろい|遅々とした|遅れた
unco	ずんと|大きに|極々|いとも|一段|殊の他|殊の外|一きわ|ぐんと|至りて
czarist	ロシア帝政の|ロシア皇帝の|独裁的な|帝政支持者
gossipy	(人が)ゴシップ好きの|(会話などが)ゴシップに満ちた
methyltestosterone	メチルテストステロン
incommensurate	(〜と)釣り合いのとれない|不相応な《+『to』+『名』》|(〜とは)比較にならない|同一規準で計れない《+『to』+『名』》
polyatomic	多原子
orogeny	造山作用(運動)
arccos	the inverse function of the cosine; the angle that has a cosine equal to a given number|the inverse function of the cosine|the angle that has a cosine equal to a given number
touchable	触れることのできる
cryptorchidism	停留睾丸
brickbat	(特に人に投げつける)れんがの砕片[に似たもの]|《話》にくまれ口|しんらつな言葉
maginot	マジノ
tabulator	タビュレーター(タイプライターの図表作製装置)
saroyan	サロイヤン
albite	曹長石
ramify	〜‘を'枝のように分ける;〜‘を'網の目のように広げる|枝のように分かれる;網の目のように広がる
heteroptera	カメムシ亜目
passel	多数|大きな数|大集団
laminaria	type genus of the family Laminariaceae: perennial brown kelps
synodical	教会会議の = synodic　会議の　相合の
roomer	(通例食事なしの)間借り人
evisceration	surgical removal of an organ (or the contents of an organ) from a patient|the act of removing the bowels or viscera; the act of cutting so as to cause the viscera to protrude|the act of removing the bowels or viscera|the act of cutting so as to cause the viscera to protrude|altering something (as a legislative act or a statement) in such a manner as to reduce its value; "the adoption of their amendments would have amounted to an evisceration of the act"|altering something (as a legislative act or a statement) in such a manner as to reduce its value