sparseness	=sparsity
cancellous	海綿状
volute	らせん|渦巻|巻き|巻|捲線|コイル|鼻甲介
ebullition	爆発
anticlimactic	急降法(anticlimax)の|急降的な
avowedly	明らかに|確かに
qadhafi	カダフィ
gypsophila	カスミソウ属
epididymitis	painful inflammation of the epididymis
moldable	可塑的|可塑性
fondu	フォンデュー|フォンデュ|フォンデュー
antidiuretic	a drug that limits the formation of urine
catapres	クロニジン
clamorous	騒々しい|喧騒
scullery	皿洗い場(大きな家の台所に付属した食器を洗ったりしまったりする小部屋)
nisei	a person born in the United States of parents who emigrated from Japan
bookfair	fair organized by publishers or booksellers to promote the sale of books|bazaar at which books are sold or auctioned off in order to raise funds for a worthy cause
disconsolate	悲しみに沈んだ|わびしい|やるせない|気のめいるような|悲しい
accordionist	アコーディオン演奏者
bedfellow	政治的同士|仲間
unhygienic	非衛生
convolvulus	サンシキヒルガオ(アサガオの一種)
mutism	無言症|無言
tympani	=timpani
quadrangular	四角(辺)形の
wicketkeeper	(クリケットの)ウィケット・キーパー(三柱門の後方にいて通ってくるボールを捕るプレイヤー)
profiteer	暴利をむさぼる人
automatism	(心臓などの)自動運動|自動作用|(人間の行動の)機械的行動
whimsically	in a fanciful manner; "the Christmas tree was fancifully decorated"|in a fanciful manner
trematode	吸虫類(寄生虫の一種|肝臓ジストマなど)　・扁形動物門吸虫綱の動物; 寄生虫
bottlecap	a cap that seals a bottle
blowfly	死肉や傷口に産卵するクロバエ
unhip	時代感覚のない|流行遅れの
outdoorsy	characteristic of or suitable to outdoor life; "a rugged outdoorsy life"|characteristic of or suitable to outdoor life
predicative	断定的な|断定する|叙述的な|述語|叙述語
undershoot	〈飛行機が〉〈滑走路〉‘の'手前で着陸する|〈弾丸・矢などが〉〈目標・的〉‘まで'達しない
lugger	ラガー|lugsail(ラグスル|四辺形の帆の一種)を有する小帆船
gangly	ひょろ長い|のっぽの|ひょろひょろした
unpromising	心細い
angiology	脈管学
telencephalon	終脳
spang	leap, jerk, bang; "Bullets spanged into the trees"|leap, jerk, bang
cardiomegaly	心肥大
pulpy	ドロドロの|果肉の|果肉状の|柔軟な|汁の多い
stepbrother	義兄|義弟
lederhosen	ハーフパンツ
partaker	(〜を)共にする人;(〜の)分担者|関係者《+『of』(『in』)+『名』》
pigmy	=pygmy
bulbar	involving the medulla oblongata; "bulbar paralysis"|involving the medulla oblongata
charnel	納骨堂
extremum	極|極端|極点
broody	(brúːdi)巣につきたがっている(a broody hen)|むっつり考え込んだ|不機嫌な
dialectal	方言の|通り言葉の|方言(通り言葉)に特有の
unproved	not proved; "unproved allegations"; "unproved assumptions"|not proved
untracked	未踏の|無軌道|前人未踏の|人跡未踏の
anticlockwise	=counterclockwise
nucleophile	求核試薬|求核剤|試薬|電子密度が低い原子(主に炭素)へ反応し|多くの場合結合を作る化学種のこと
prompting	せりふ付け|激励|鼓吹|鼓舞|後見|吹き込むこと|扇動
transparence	透明性|透明度
broadloom	広幅織りじゅうたん(縫い目がなく|特に54インチ(137cm)以上の幅がある)
obligingly	好意で|親切にも|思いやりで
funding	資金調達
grandee	大公(スペイン・ポルトガルの最高貴族)|(一般に)身分の高い人|貴人|高官
barkeep	バーテンダー|バーテン
emasculation	去勢|骨抜き|無力化
sigmoidal	S字状の
earplug	耳栓
unexpressed	not made explicit; "the unexpressed terms of the agreement"; "things left unsaid"; "some kind of unspoken agreement"; "his action is clear but his reason remains unstated"|not made explicit
isobutylene	used also in making gasoline components
solipsistic	唯我論主義者の|自己中心[主義]的な
goethite	a red or yellow or brown mineral; an oxide of iron that is a common constituent of rust|a red or yellow or brown mineral|an oxide of iron that is a common constituent of rust
selvage	耳
glycopeptide	糖ペプチド
manfully	潔く
drainpipe	排水管|下水管
contrapuntal	(作曲法で)対位法の|対位法による
ophidian	蛇蝎|長蛇|ヘビ|大蛇|蛇蠍|スネーク|長虫|蛇
tracery	(建築)はざま飾り|トレーサリー(ゴシック式窓上方の装飾的骨組み)
coltsfoot	tufted evergreen perennial herb having spikes of tiny white flowers and glossy green round to heart-shaped leaves that become coppery to maroon or purplish in fall|perennial herb with large rounded leaves resembling a colt's foot and yellow flowers appearing before the leaves do; native to Europe but now nearly cosmopolitan; used medicinally especially formerly|perennial herb with large rounded leaves resembling a colt's foot and yellow flowers appearing before the leaves do|native to Europe but now nearly cosmopolitan|used medicinally especially formerly
electrodynamic	電気力の;電気力学の
slackness	無気力|惰気|ずぼら
fluorescently	蛍光
pangolin	toothless mammal of southern Africa and Asia having a body covered with horny scales and a long snout for feeding on ants and termites
ascendent	尊属|祖|高祖|先祖|始祖|ルーツ|曩祖|先つ祖|先世|祖先|先人
behoove	ふさわしい|必要である|にとって義務である
nonflammable	不燃性の
tailrace	放水路
arborvitae	any of several Asian and North American conifers of the genera Thuja and Thujopsis
crumpet	小麦粉と酵母で作る塩味|または甘い軽食パン|主にイギリスおよびイギリス連邦諸国で食される
seemly	ふさわしい|適切な;礼儀にかなった|たしなみのよい|上品な
scutellaria	タツナミソウ属
forswear	誓ってやめる
pointlessly	in a pointless manner; "he spent his life in pointlessly tiresome drudgery"|in a pointless manner
pancreatin	パンクレアチン
technophile	a person who is enthusiastic about new technology
myelofibrosis	骨髄線維症
microliter	マイクロリットル
scullion	(男子の)皿洗い人|台所の下動き|下劣な人
naughtiness	わんぱく
deciliter	デシリットル|dl
timework	時間給の仕事
allometric	非比例的
fastidiousness	凝り性
anorectic	摂食障害|摂食障害
demoniac	悪魔に取りつかれたような人|鬼
penury	貧乏|欠乏
conjuror	手品遣い|奇術師|手妻使い|手妻遣い|手妻使|魔術師|手品師|マジシャン|手妻遣|神がかり
wainscot	羽目板|腰板|〈壁〉‘に'羽目板を張る
supernal	天空にある|高い|天上の|天の(heavenly)
antithyroid	抗甲状腺の
curcuma	ウコン
womenfolk	《話》婦人たち|女性たち|(一家の)女たち
comedown	(地位・身分・名誉などの)失墜・下落・零落
unorganised	無機的|無機的
lepas	type genus of the family Lepadidae
amelanchier	North American deciduous trees or shrubs
oboist	オーボエ奏者
nonrandom	非ランダム
maidenhair	アジアンタム(ハコネソウ・クジャクソウなどのシダ類)
corydalis	a plant of the genus Corydalis with beautiful compound foliage and spurred tubular flowers|annual or perennial herbs of Himalayan China and South Africa|type genus of the Corydalidae
woodpile	まきの山
jocular	(人･事が)おどけた|こっけいな|おかしい|ひょうきんな
mantid	predacious long-bodied large-eyed insect of warm regions; rests with forelimbs raised as in prayer|predacious long-bodied large-eyed insect of warm regions|rests with forelimbs raised as in prayer
senhor	a Portuguese title of respect; equivalent to English `Mr'|a Portuguese title of respect|equivalent to English `Mr'
microdissection	顕微解剖
tightwad	しみったれ
indurate	〈岩・組織など〉‘を'硬くする|硬化する|〜‘を'無感覚にする|がんこにする|〜‘を'慣れさせる|硬くなる|硬化した;無感覚な
gyrate	螺旋状の|旋回する
fathomless	測れないもど深い|底なしの|不可解な
comprehensibility	理解できること|分かり易さ
insularity	島であること|島国根性|孤立|狭量
rehouse	〈人〉‘を'新しい家に住まわせる|よい住居に移す
arcsecond	秒|二番
minibike	小型オートバイ
weeper	呼び出し
icepick	アイスピック
laterite	紅土|ラテライト
endearingly	かわいらしく|心を引きつけるように
sturdiness	たくましさ;がんじょう;がん強
haematopoietic	造血性
calamine	カラミン(異極鉱;化粧水などに使われる)
kingsnake	any of numerous nonvenomous North American constrictors; feed on other snakes and small mammals|any of numerous nonvenomous North American constrictors|feed on other snakes and small mammals
muckrake	《話》醜聞をあばく|政治の腐敗を暴露する
monarda	モナルダ
unfreeze	溶ける|熔融|融かす|熔化|鎔ける|溶かす|溶融|解凍|蕩かす|解かす|放つ|放す
pressurise	加圧|加圧|加圧
sheepfold	羊を入れるおり(囲い)
cautery	腐食剤|焼灼
spiciness	香ばしさ|痛快さ
plentifully	in a bountiful manner
wakeful	寝ずに見張っている|眠れない
centrism	中道政治
hyponym	下位語|狭義語
groaner	a person who groans
physiography	(fìziάgrəfi)自然地理学|地形学(geomorphology)
signalization	a conspicuous indication
shearwater	ミズナギドリ
mystically	in a mystical manner; "chant mystically"|in a mystical manner
antral	(解剖学)腔の|空洞の
homelike	自宅のような|家庭的にくつろいだ気分の|気楽な
deoxyribose	デオキシリボース
externalization	客観化|客観化
dracaena	ドラセナ
didder	びくびくする|ガタガタ|揺らぐ|動揺|揺ぐ|ぶるぶるする|震撼|打震える|がくがく|震える
fiddlehead	クサソテツ
preservationist	someone who advocates the preservation of historical sites or endangered species or natural areas
unsociable	打ち解けない|人づき合いの悪い
epigastric	of or relating to the anterior walls of the abdomen; "epigastric artery"|of or relating to the anterior walls of the abdomen|lying on or over the stomach
electroplate	〜‘に'(通例銀の)電気めっきをする
neutropenic	好中球減少
kolinsky	チョウセンイタチ[の毛皮]
coziness	快さ
ascitic	of or relating to or resulting from an abnormal accumulation of protein and electrolyte rich fluid in the peritoneal cavity
indiscernible	目に見えない|識別できない
appreciatively	感謝して
drear	=dreary
buffoonery	おどけ|clowning
fungicidal	殺真菌性
upfield	高磁場
climacteric	肉体の転換期;厄(やく)年|更年期
anthesis	開花
rashness	不注意|命知らず|向こう見ず|無鉄砲|軽はずみ|無謀
tantalizingly	誘うように|魅力的に|じらすように
hayloft	(馬小屋の納屋の2階にある)干し草置き場
typhon	テュポン
consistence	整合性|一貫|一致|一貫性
fledge	羽毛でおおう
dkl	デカリットル
metalworker	金属細工師(職工)
curser	のろう人|悪態をつく人|ののしる人
coverslip	顕微鏡スライドの上で見本をカバーするガラスの小さくて細い部分
myrica	deciduous aromatic shrubs or small trees
missis	嚊
veridical	本当の|真成|リアル|真の|本当|まぶ|実際的|真実|真誠
kinfolk	宗族|一門|一族|家筋|眷族|眷属|家門|血族|氏族|家系
prohibitionist	酒類製造販売禁止論者
totalisator	computer that registers bets and divides the total amount bet among those who won
mesencephalon	中脳
buttonwood	アメリカスズカケノキ(北米産)
megillah	長ったらしい説明|くどい話
letterer	レタリング専門家
agrimony	キンミズヒキ
digitise	デジタル化
coadjutor	補佐司教|補助司教|助手|補佐役
weltanschauung	世界観|宇宙観
swad	a bunch; "a thick swad of plants"|a bunch
leukocytosis	白血球増多症
nightwalker	夜間うろつきまわる人(泥棒|売春婦など)
isoptin	ベラパミル
hemin	ヘミン
unsuitability	不適
nonpregnant	非妊娠
endue	〈人〉‘に'(資質・才能などを)与える|授ける《+『名』〈人〉+『with』(『in』)+『名』》
chophouse	焼き肉専門店
raita	an Indian side dish of yogurt and chopped cucumbers and spices
underwing	moth having dull forewings and brightly colored hind wings
chthonic	dwelling beneath the surface of the earth; "nether regions"|dwelling beneath the surface of the earth
slub	節
factorisation	因数分解
bacillary	桿菌性|桿菌性
unregenerate	悔い改めない|更生しない|強情な|がんこな
sorrowfully	悲しそうに|悲しんで
iniquitous	不正の|不法の;邪悪な
blub	cry or whine with snuffling; "Stop snivelling--you got yourself into this mess!"|cry or whine with snuffling
stria	(平行に並んでいる)細い溝(筋)|条線(氷河運動により岩の表面についたかき傷;鉱物の結晶面に走る平行線)|(円柱についている)縦溝
chlorambucil	クロランブシル
intumescent	abnormally distended especially by fluids or gas; "hungry children with bloated stomachs"; "he had a grossly distended stomach"; "eyes with puffed (or puffy) lids"; "swollen hands"; "tumescent tissue"; "puffy tumid flesh"|abnormally distended especially by fluids or gas
ascomycete	any fungus of the class Ascomycetes (or subdivision Ascomycota) in which the spores are formed inside an ascus
cannae	カンナエ
halma	ハルマ(飛び将棋の商標名)
myxoma	粘液腫
righthander	右利き
araucaria	any of several tall South American or Australian trees with large cones and edible seeds
architrave	台輪(だいわ)(古典建築のentablatureの最下部で柱の上に直接のる)|(ドア・窓の)化粧縁|装飾縁
fratricide	〈U〉兄弟(姉妹)殺し|兄弟(姉妹)殺しをした人
agonizingly	in a very painful manner; "the progress was agonizingly slow"|in a very painful manner
dishonourable	lacking honor or integrity; deserving dishonor; "dishonorable in thought and deed"|lacking honor or integrity|deserving dishonor
unprovable	not provable; "it was both unproved and unprovable"|not provable
smilingly	with smiles; in a smiling manner; "the girl reminded her smilingly of their childhood spent together"|with smiles|in a smiling manner
polyoma	ポリオーマ
horseshit	たわごと|くだらないこと|くだらん|ばかな
chiton	ヒザラガイ|ヒザラガイ
butanone	メチルエチルケトン
seating	座席
tombaugh	トンボー
curare	クラーレ(南米原住民が矢じりに塗る植物から採った毒)
quahog	ホンビノスガイ(殻の厚い食用貝)
intrusiveness	aggressiveness as evidenced by intruding; by advancing yourself or your ideas without invitation|aggressiveness as evidenced by intruding|by advancing yourself or your ideas without invitation
assize	〈U〉判事と陪審員による裁判|《複数形》《英》巡回裁判(ロンドンから定期的にイングランドの各州に裁判官が派遣されて行う裁判)
gingersnap	ショウガ入りクッキー
ducat	ダカット金貨(昔欧州で使用された)
notochord	脊索
lespedeza	shrubby or herbaceous plants widely used for forage, soil improvement, and especially hay in southern United States
epigraphy	墓碑銘学|《集合的に》碑銘|碑文
democratise	民主化|民主化
boatbuilder	舟大工
openwork	(彫金・織物などの)すかし細工
hundredfold	100倍の
lopper	a long-handled pruning saw with a curved blade at the end and sometimes a clipper; used to prune small trees|a long-handled pruning saw with a curved blade at the end and sometimes a clipper|used to prune small trees
unsupportable	not able to be supported or defended
basileus	バシレウス
capybara	カピバラ
ephemerid	short-lived insect
induration	硬化
stroheim	シュトロハイム
padder	足蹠
sudsy	resembling lather or covered with lather
stonecrop	ベンケイソウ|弁慶草
slowpoke	のろま|時代遅れの人
rarify	凝る|精密化する|精緻化する|一捻|一捻り
goethals	ゴーサルズ
shallowly	in a shallow manner
towboat	引き船
ventrally	in a ventral location or direction
sclerotinia	any fungus of the genus Sclerotinia; some causing brown rot diseases in plants|any fungus of the genus Sclerotinia|some causing brown rot diseases in plants
cyanamid	シアナミド
broncho	=bronco
corpulent	でっぷりと太った|肥満した
abolitionism	(特に米国の)奴隷制度廃止論
myalgic	筋痛
contrarily	これに反して|逆に|《話》意地悪く|へそ曲がりに
buret	ビュレット
dripless	designed to prevent dripping; "a dripless faucet"; "dripless candles"|designed to prevent dripping
coreference	the grammatical relation between two words that have a common referent
imuran	アザチオプリン
tombola	《おもに英》富くじ式のゲーム
elute	溶出する
veldt	elevated open grassland in southern Africa
tinct	染める
banditry	追いはぎ(強盗)すること
barbwire	荊棘線|有刺鉄線
anaphor	a word (such as a pronoun) used to avoid repetition; the referent of an anaphor is determined by its antecedent|a word (such as a pronoun) used to avoid repetition|the referent of an anaphor is determined by its antecedent
mystification	ごまかし|煙にまくこと|神秘化|迷わすこと
rurality	a rural characteristic or trait; "a place with the rurality of a turnip field"|a rural characteristic or trait
moshav	モシャブ
pshaw	ふん|ちぇっ
anolis	New World chameleons
thumbtack	画びょう(《英》drawing pin)
homogenizer	破砕機|ホモジナイザー
collarless	カラーレス
institutionalise	送る|送込む|入れる
chinstrap	(帽子・ヘルメットなどの)あごひも
apoplectic	卒中(性)の|卒中の発作|おこって|ひどく興奮して
waterscape	海景|水観
vacillate	ぐらつく
redpoll	ベニヒワ
palaeontological	of or relating to paleontology
fitly	適正|然る可く|然るべく|適切|しかるべく|よしなに|適宜
skywards	=skyward
gradualism	漸進主義
meningoencephalitis	髄膜脳炎
canid	イヌ科動物
bacteriostatic	of or relating to or causing bacteriostasis
incivility	無作法(な行為)
stultify	台なしにする|無意味にする|無効にする
butterflyfish	蝶蝶魚
viscerally	in an unreasoning visceral manner|in the viscera; "he is bleeding viscerally"|in the viscera
astronomic	極大|天文学的
nonphysical	無体
unctuous	なめらかな|脂質の
taxability	賦課
briony	a vine of the genus Bryonia having large leaves and small flowers and yielding acrid juice with emetic and purgative properties
calcaneus	踵骨
obturator	a prosthesis used to close an opening (as to close an opening of the hard palate in cases of cleft palate)
gastroscopy	胃内視鏡
overexertion	excessive exertion; so much exertion that discomfort or injury results|excessive exertion|so much exertion that discomfort or injury results
uncolored	地色の|無色の|着色してない
animato	(音楽の演奏の指示で)活発な(に)|元気のよい(よく)
insignificantly	軽微
libration	秤動
decentralise	分散
oversteer	〈車などが〉ハンドルがきき過ぎる
zingiber	tropical Asiatic and Polynesian perennial plants: ginger
vesalius	ベサリウス
rissa	律紗
koine	共通語
metaphysician	形而上学者
unamended	(of legislation) not amended
descale	〜‘から'湯あかを除く
ampule	(注射液を入れる)アンプル
dozy	ねむい
puccinia	type genus of the Pucciniaceae; a large genus of parasitic fungi including many that are destructive to various economic plants|type genus of the Pucciniaceae|a large genus of parasitic fungi including many that are destructive to various economic plants
perinatology	the branch of obstetrics concerned with the anatomy and physiology and diagnosis and treatment of disorders of the mother and the fetus or newborn baby during late pregnancy and childbirth and the puerperium
miscast	〈役者〉‘を'不適当な役に割りふる;〈劇〉‘に'へたな役のふり当てをする
raising	調達
dustpan	ちりとり
smoothen	均らす|押し均す|押しならす|均す|押均す|研ぐ|摩する|研き上げる|研く|みがき上げる|研摩|磨ぐ|磨く|研磨
groundsman	グラウンドキーパー
nonjudgmental	refraining from making judgments especially ones based on personal opinions or standards; "sympathetic and nonjudgmental"|refraining from making judgments especially ones based on personal opinions or standards
redroot	perennial woodland native of North America having a red root and red sap and bearing a solitary lobed leaf and white flower in early spring and having acrid emetic properties; rootstock used as a stimulant and expectorant|perennial woodland native of North America having a red root and red sap and bearing a solitary lobed leaf and white flower in early spring and having acrid emetic properties|rootstock used as a stimulant and expectorant
quoter	a communicator (speaker or writer) who uses quotations
lassitude	体のだるさ|倦怠|無気力|疲労|だるさ
bluet	青い花の咲く植物の総称;ヤグルマソウなど
nonclassical	非古典的
trichinosis	旋毛虫病
sugarcoat	〈丸薬など〉‘を'砂糖で包む|〈不快なこと〉‘を'よく見せかける|糖衣
pictograph	絵文字|象形(しょうけい)文字|ピクトグラフ|統計画(数字の代わりに絵や図を用いて表す)
thunnus	tunas: warm-blooded fishes
relevantly	with relevance
foxhunt	キツネ狩り
leibnitz	ライプニッツ
femoris	大腿骨
thunderclap	雷鳴|青天のへきれき
permissiveness	寛容さ
ambitiously	野心的に
moonless	without a moon or a visible moon; "the dark moonless night"; "a moonless planet"|without a moon or a visible moon
changeless	変わることのない|不変の
sagely	賢明に|思慮深く
spacy	stupefied by (or as if by) some narcotic drug
unfavourably	悪し様に
immortelle	mostly widely cultivated species of everlasting flowers having usually purple flowers; southern Europe to Iran; naturalized elsewhere|mostly widely cultivated species of everlasting flowers having usually purple flowers|southern Europe to Iran|naturalized elsewhere
valorous	=valiant
endurable	耐えられる|がまんできる
spinet	スピネット(ピアノの前身の小型ハープシコード)|小型ピアノ
enervate	の気力を奪う|の気力を弱める
abortifacient	a drug (or other chemical agent) that causes abortion|causing abortion
prolix	冗長な|冗漫な
cotangent	コタンジェト|余接
curium	キュリウム(放射性元素;化学記号は『Cm』)
waterspout	排水管(口)|雨どい|たつ巻
quickset	cuttings of plants set in the ground to grow as hawthorn for hedges or vines; "a quickset of a vine planted in a vineyard"|cuttings of plants set in the ground to grow as hawthorn for hedges or vines|grown from cuttings planted directly in the ground; "a quickset hawthorn hedge"|grown from cuttings planted directly in the ground
sidelong	横の|斜めの|横から|斜めに
mls	MLS
limnological	of or relating to limnology
jingoism	(感情的な)愛国主義|(盲目的な)主戦論
phacoemulsification	extracapsular surgery for cataracts in which ultrasonic sound breaks the cortex and nucleus of the lens into small fragments that are then vacuumed away through a small tube
rolling	うねっている|転がること|転がすこと|回転|横転
salai	East Indian tree yielding a resin used medicinally and burned as incense
hornless	角のない
pansexual	a person who participates in (or is open to) sexual activities of many kinds
urbanise	impart urban habits, ways of life, or responsibilities upon; "Birds are being urbanized by people in outdoor cafes feeding them"|impart urban habits, ways of life, or responsibilities upon|make more industrial or city-like; "The area was urbanized after many people moved in"|make more industrial or city-like
cholangiography	roentgenographic examination of the bile ducts after a contrast medium has been injected
idiosyncrasy	特異性|特異な性格|特異体質
rearmament	再軍備|再武装|再武装する
nebraskan	a native or resident of Nebraska
gamow	ガモフ
pentoxide	an oxide containing five atoms of oxygen in the molecule
baedeker	ベデカー
smidge	微量
noninfectious	非伝染性
levator	挙筋|(きょきん|まぶたや唇など|身体の部分を持ち上げる働きをする筋肉)
whoredom	売笑|売淫|淫売|売春|売色
gigot	lamb leg suitable for roasting
codger	おじいさん|おいぼれ|じじい|偏屈者|変人
donjon	(昔の城の)天守閣
gigue	ジグ|ジッグ
halite	岩塩
epicondylitis	上顆炎
acclivity	《まれ》上り坂
bisector	2等分線(面)
carambola	East Indian tree bearing deeply ridged yellow-brown fruit|deeply ridged yellow-brown tropical fruit; used raw as a vegetable or in salad or when fully ripe as a dessert|deeply ridged yellow-brown tropical fruit|used raw as a vegetable or in salad or when fully ripe as a dessert
coastland	land in a coastal area
traversable	capable of being traversed; "highway crews soon had the roads travelable"|capable of being traversed
cyproheptadine	シプロヘプタジン
unreduced	not altered by reduction
boneset	フジバカマ|フジバカマ|藤袴
clothespin	(UK英)洗濯挟み(clothes peg)
paleness	蒼白|無色素|青白
groveling	totally submissive
gambol	ふざけ|はねまわり
bigmouth	おしゃべり屋
alack	(悲しみの叫びで)ああ
frijole	インゲンマメ
psoas	腰筋
miaow	=meow
discourteous	失礼な|ぶしつけな(impolite)
anastomotic	of or relating to or exhibiting anastomosis
dimness	しおらしさ|薄暗さ
risible	笑い性の|笑いたがる|笑いを引き起こす|おかしい
antisubmarine	対潜水艦
breeding	子を産む|繁殖|飼育|しつけ|養育|生い立ち|育ち|増殖
accentuation	アクセントをおくこと|アクセントのおき方|強調
cypraea	type genus of the family Cypraeidae: the typical cowries
semimonthly	半月ごとの|月2回の|半月ごとに|月2回|月2回の刊行物
escheat	a reversion to the state (as the ultimate owner of property) in the absence of legal heirs
peshmerga	a member of a Kurdish guerilla organization that fights for a free Kurdish state
inauthentic	intended to deceive; "a spurious work of art"|intended to deceive
nitroglycerine	ニトログリセリン
goosefoot	藜|アカザ
daunt	おどす|威圧する|ひるませる|気力をくじく
gillie	a young male attendant on a Scottish Highlander chief|a shoe without a tongue and with decorative lacing up the instep
uncompromisingly	頑固
geoscientist	地球学者
poky	獄所|鉄窓|牢屋|牢舎|牢|豚箱|人屋|獄舎|刑務所|鉄格子|せせこましい|せせこましい
glassblower	ガラス吹き工
indispose	不適当にする|不適格とみなす|不向きにする|不適格にする|苦しめる
strategical	戦略上
precess	move in a gyrating fashion; "the poles of the Earth precess at a right angle to the force that is applied"|move in a gyrating fashion
wpn	weapon
potholder	(布製の)なべつかみ
landholding	ownership of land; the state or fact of owning land|ownership of land|the state or fact of owning land|a holding in the form of land
melasma	褐色斑
haptoglobin	ハプトグロビン
tagliatelle	タリアテッレ
obovate	(of a leaf shape) egg-shaped with the narrower end at the base
maniacally	in a maniacal manner or to a maniacal degree; "he was maniacally obsessed with jealousy"|in a maniacal manner or to a maniacal degree
gambrel	飛節
musset	ミュッセ
amidships	船(航空機)の中央部に(で)
dhal	キマメ
deforest	remove the trees from; "The landscape was deforested by the enemy attacks"|remove the trees from
moneybag	富|金持ち|金持ちで欲ばりな人|金袋|金入れ|財布
vervet	South African monkey with black face and hands
cinchona	〈C〉キナの木(南米産)|〈U〉キナ皮(キナの木の樹皮でキニーネ(quinine)などの薬剤を採る)
champollion	シャンポリオン
glamorize	に魅力を添える|に魅力を与える
conjoin	〜'を'結合(連合)させる|結合する
ninny	ばか(者)|まぬけ|乳首|乳房
intracellularly	細胞内に
beeves	beefの複数形
substitutional	代理の|代用の
mounter	a skilled worker who mounts pictures or jewels etc.|someone who ascends on foot; "a solitary mounter of the staircase"|someone who ascends on foot
cony	ハイラックス|ナキウサギ|兎|コニー|アナウサギ|家兎|兎|ウサギ|ラビット
lymphadenitis	リンパ節炎
toper	ジューサー|酒好き|酒飲み|飲んだくれ|大虎|小虎
flurazepam	フルラゼパム
preternatural	異常な
succinylcholine	スクシニルコリン
centime	サンチーム(フランスの貨幣;1|100フラン)
schnorr	居候
microtus	voles of the northern hemisphere
earldom	〈U〉伯爵の身分|〈C〉伯爵の領地
indubitable	疑う与地のない;明白な|確かな
morone	carnivorous fresh and salt water fishes
unprintable	印刷(出刷)に不適当な
assimilative	capable of mentally absorbing ; "assimilative processes", "assimilative capacity of the human mind"|capable of mentally absorbing |capable of taking (gas, light, or liquids) into a solution; "an assimilative substance|capable of taking (gas, light, or liquids) into a solution
exceptionality	(いい意味で)例外的なこと|まれなこと
countertenor	カウンターテナー|西洋音楽で成人男性歌手のパートの一つで|女声に相当する高音域を歌う|カウンターテノールともいう|カウンターテナーの歌手
oligodendrocyte	a cell of the oligodendroglia
decorous	上品な|礼儀正しい|端正な|気品のある|謹厳な
auriculare	the craniometric point at the center of the opening of the external acoustic meatus
aralia	any of various plants of the genus Aralia; often aromatic plants having compound leaves and small umbellate flowers|any of various plants of the genus Aralia|often aromatic plants having compound leaves and small umbellate flowers
durably	長持ちして|永続的に
rightwards	= rightward
edging	縁
imbecility	〈U〉低能;愚かさ;〈C〉愚行
dogsled	犬橇
younker	青少年|若い衆|若い者|若衆|若人|青年|ユース
gnomish	used of small deformed creatures
ectoplasm	(霊媒の体から出る)心霊体
kalka	the Mongol people living in the central and eastern parts of Outer Mongolia|the language of the Khalkha that is the official language of the Mongolian People's Republic
doorkeeper	門衛|守衛
ineffectively	効果なく
lent	貸した
sycophantic	おべっか使いの|ごますりの
mesodermal	relating to or derived from the mesoderm
transitively	他動詞的に|他動詞として
linage	行数|行数
bounteous	=bountiful
centrefold	センターフォールド
toucher	a person who causes or allows a part of the body to come in contact with someone or something
bluetongue	a viral disease of sheep and cattle that is transmitted by biting midges
oleoresin	オレオレジン
meloidogyne	ネコブセンチュウ|ナシ･サツマイモやトマトの根に寄生し瘤状にする病原菌
marginalise	relegate to a lower or outer edge, as of specific groups of people; "We must not marginalize the poor in our society"|relegate to a lower or outer edge, as of specific groups of people
abysmally	堪らなく|はなはだ|酷く|転た|ひどく
embroiderer	someone who ornaments with needlework
whispering	ささやき|うわさ(話)
interlanguage	共通語
humbleness	ほの暗さ|謙遜|謙譲|卑下|謙遜|謙虚さ|謙譲|謙譲さ
haughtiness	高慢|傲慢
aliveness	生存性|有情
willowy	柳の多い|(人が)しなやかな
uncured	not seasoned; "uncured pelts"|not seasoned
overachiever	a student who attains higher standards than the IQ indicated
terbium	テルビウム(希金属元素;化学記号はTb)
fiberfill	化繊綿(枕などの詰め物に使うポリエステルなどの合成繊維)
omentum	a fold of peritoneum supporting the viscera
disaccharide	二糖|二糖類
proneness	being disposed to do something; "accident proneness"|being disposed to do something
betide	〈不幸・災難が〉〈人〉‘に'起こる|‘の'身にふりかかる|(〜に)起こる《+『to』+『名』》
rotogravure	輪転グラビア印刷[物]
indexical	指標表現の
speleology	洞穴学
emolument	俸給|報酬|手当
cauterize	(医)(傷口などを)焼灼(しょうやく)する|(良心･感情)まひさせる
squealer	キーッとなるもの|悲鳴をあげる人(動物)|《話》密告者
mujahidin	ムジャーヒディーン
handwheel	a wheel worked by hand|control consisting of a wheel whose rim serves as the handle by which a part is operated
matzoh	マツァ|マッツァー|マッツォ
railhead	鉄道(線路)の終端|レールの頭部
prithee	願わくば　何とぞ(please)
encirclement	〈U〉包囲;(外交的・戦略的)包囲政策|〈C〉1周
laager	a camp defended by a circular formation of wagons
bicuspid	(歯などが)2つの尖(せん)部(突起)を持つ|小臼歯(きゅうし)
pentangle	a star with 5 points; formed by 5 straight lines between the vertices of a pentagon and enclosing another pentagon|a star with 5 points|formed by 5 straight lines between the vertices of a pentagon and enclosing another pentagon
topographically	組織分布的
plasmacytoma	プラズマ細胞腫
ethnos	people of the same race or nationality who share a distinctive culture
diffidence	弱気|内気|自信のなさ
bestowal	〈C〉贈物|〈U〉〈C〉授与
mendacious	偽りの
verbascum	genus of coarse herbs and subshrubs mostly with woolly leaves
stereoscope	立体(実体)鏡
foreperson	the presiding member of the jury and the one who speaks on their behalf
adhesiveness	粘着|接着性|粘着性|接着
nephrite	軟玉
emotionalism	感情に送りやすい傾向|感情に訴えること
hydroxychloroquine	anti-inflammatory drug (trade name Plaquenil) used in the treatment of rheumatoid arthritis and malaria and lupus erythematosus
unrelieved	単調さを破るもののない|変化のない
ostracise	除籍|つま弾き|払う|つま弾|放り出す|追放|爪はじき|撥ねる|放逐|爪弾
flummox	〈人〉‘を'まごつかせる|当惑させる
unimagined	not imagined even in a dream
mahonia	マホニア|柊(ひいらぎ)南天(複数形mahonias)|常緑低木と小さな高木(北米|中米|アジア)
neoclassic	characteristic of a revival of an earlier classical style
gladiatorial	(古代ローマの)剣闘士のような
residentially	住居的
confraternity	(宗教などの)団体|協会|結社
coincidently	happening at the same time
cultivable	耕作(裁培)できる|教化できる
embraceable	包容(容認)できる
dependably	信頼して|当てにして
inadvertence	不注意|うかつさ|(不注意による)まちがい|手落ち
guilloche	an architectural decoration formed by two intersecting wavy bands
larn	学修|修める|修得|修する|学び取る|学習|習う|学ぶ|学びとる|修学
sympathectomy	交感神経切除
jynx	wrynecks
cimicifuga	small genus of perennial herbs of north temperate regions: bugbane
parer	皮をむく道具(人)
believably	in a believable manner; "he acted believably sincere"|in a believable manner
homebody	家に引きこもりがちな人・家庭的な[マイホーム主義の]人
synovium	滑膜
molarity	モル濃度
bacchanal	酒神バッカスの信徒|(酒宴での)男女入の乱れたどんちゃん騒ぎ|酒神バッカスの|どんちゃん騒ぎの
mellifluous	(声･音楽など)なめらかな|流暢な|甘美な
pretentiousness	虚飾|衒気|尊大|気取り|己惚れ|僭称|気どり|自惚れ|付け焼き刃
recessionary	退却(撤退)の|景気後退の|(宗教儀式で)退場の
immortalize	に不朽の名声を与える|不滅にする|に永遠性を与える
parallelize	place parallel to one another
neoconservatism	新保守主義
unkindly	つれなく|不親切に|不人情に|冷たく
outpouring	ほとばしり|流出|流露
coxsackievirus	コクサッキーウイルス
externalize	regard as objective|make external or objective, or give reality to; "language externalizes our thoughts"|make external or objective, or give reality to
gunplay	撃ち合い
zeugma	use of a word to govern two or more words though appropriate to only one; "`Mr. Pickwick took his hat and his leave' is an example of zeugma"|use of a word to govern two or more words though appropriate to only one
phosphocreatine	クレアチン燐酸
jitney	(短距離の路線を走る)小型バス
goosey	having or revealing stupidity; "ridiculous anserine behavior"; "a dopey answer"; "a dopey kid"; "some fool idea about rewriting authors' books"|having or revealing stupidity
acebutolol	アセブトロール
jiggly	ゆれ動く|不安定な|性的興味をそそる
yardbird	囚徒|囚人|刑徒|在監者|受刑者|徒刑囚|服役囚|既決囚
noncommittal	曖昧な|どちらともつかない
autarky	〈U〉(国家の)経済的自給自足|〈C〉(また『autarchy』)経済的自給自足国家
cuboid	直方体
striver	努力する人|戦う人
pinnate	(葉が)羽状の
glissando	〈U〉グリサンド奏法(キイ・弦の上に指先をすべらせる奏法)|〈C〉グリサンド楽節|グリサンド奏法の(で)
devourer	someone who eats greedily or voraciously
skyjacker	飛行機乗っ取り犯人
sphygmomanometer	血圧計
cottony	綿の;綿のような
appenzeller	a smaller of the four Swiss breeds
chapati	チャパティー|チャパティ
nonmagnetic	非磁性
polyploidy	倍数性
digitalize	デジタル化
towage	麻屑|牽引|けん引
amnion	羊膜
limekiln	石灰焼きがま
pardner	相棒|仲間
wondrously	驚くほど
anarchistic	無政府主義[者]の;《軽べつして》破壊主義[者]の
turbinate	鼻甲介|鼻甲介|鼻甲介
kalmia	カルミア属|カルミア
dissidence	(意見などの)相違|不一致
unquestioningly	in an unquestioning manner; "he followed his leader unquestioningly"|in an unquestioning manner
lysimachia	loosestrife: a cosmopolitan genus found in damp or swampy terrain having usually yellow flowers; inclined to be invasive|loosestrife: a cosmopolitan genus found in damp or swampy terrain having usually yellow flowers|inclined to be invasive
anteroom	(またantechamber)(主室や大広間に通じる)控えの間|次の間|待合室(waiting room)
inclose	=enclose
canter	馬のかけ足
doorframe	戸わく
chancroid	軟性下疳
cypripedium	genus of chiefly American perennial leafy-stemmed orchids: lady's slippers; sometimes includes species of genus Paphiopedilum|genus of chiefly American perennial leafy-stemmed orchids: lady's slippers|sometimes includes species of genus Paphiopedilum
unready	準備ができていない
ellul	エリュール
microdot	photograph reduced to the size of a dot (usually for purposes of security)
gamesmanship	(スポーツで)反則すれすれの巧妙な勝ち方
ossify	〜‘を'骨化させる|(骨のように)〜‘を'硬化させる|骨化する|(人・考え方が)がん固になる|融通がきかなくなる
erythematous	紅斑性
babushka	a woman's headscarf folded into a triangle and tied under the chin; worn by Russian peasant women|a woman's headscarf folded into a triangle and tied under the chin|worn by Russian peasant women
tibialis	脛骨
chirk	make a shrill creaking, squeaking, or noise, as of a door, mouse, or bird
barnstorm	芝居の地方巡業をする|《米》地方遊説する
galangal	カヤツリグサ
sluggishly	もさもさ|のろのろ|のそり|だらだら|のっそり|のそのそ|もっそり
beardless	ひげのない|青二才の
midrib	(葉の)中肋(ろく)|中脈
mensuration	《文》測定|(長さ・面積・体積の)測定法|求積法
cheerless	喜びのない|楽しみのない|陰気な;わびしい
ethmoid	篩骨
lycanthropy	(folklore) the magical ability of a person to assume the characteristics of a wolf|the magical ability of a person to assume the characteristics of a wolf
incus	砧骨
pastis	パスティス
untrimmed	not trimmed; "shaggy untrimmed locks"|not trimmed
nativism	原住民保護主義(政策)
workboard	a horizontal board that provides a supported surface for manual work
preciousness	the quality possessed by something with a great price or value|the positive quality of being precious and beyond value|the quality of being fastidious or excessively refined
uveal	ブドウ膜
excitingly	豪快
unprejudiced	偏見のない|公平な
vermonter	a native or resident of Vermont
alces	elk or moose
arianism	アリウス主義
reproducibly	再現性
pricing	価格設定
otolaryngologist	耳鼻科医
ergosterol	エルゴステロール
dissimulation	しらばくれること|見せかけ;偽善|偽装
glom	take by theft; "Someone snitched my wallet!"|take by theft
analyticity	解析性
indapamide	インダパミド
pictorially	in a pictorial manner; "depth is established pictorially"|in a pictorial manner
anodize	〈金属〉'を'陽極酸化する(電解で酸化皮膜をつけること)
reengineer	リエンジニアリング
barish	Kamarupan languages spoken in the state of Assam in northeastern India
kabbala	カバラ|カバラ
gunflint	the piece of flint that provides the igniting spark in a flintlock weapon
monazite	モナズ石
emotionality	主情|感情的傾向|エモーショナリスム|感情本位|エモーショナリズム
bladderwrack	similar to and found with black rockweed|a common rockweed used in preparing kelp and as manure
gettable	入手できる|手にはいる|獲得できる
substantiality	the quality of being substantial or having substance
anthropocentric	人間中心的な(万事を人間の経験・価値観で解釈する)
totemic	トーテム信仰のcf|totem
messiness	目茶苦茶|取り散らかっていること|滅茶苦茶|乱雑|めちゃめちゃなこと|乱れ|めちゃくちゃ|滅茶滅茶|取り散らかし|乱雑
bascule	a structure or device in which one end is counterbalanced by the other (on the principle of the seesaw)
woodcarving	a carving created by carving wood
nonslip	designed to reduce or prevent slipping; "a nonslip surface"|designed to reduce or prevent slipping
agrippina	小アグリッピナ|大アグリッピナ
corkboard	a heat-insulating building material consisting of cork granules that are made into sheets by compressing and baking
theatricality	an artificial and mannered quality
upmost	最高の　最上の　一番の　最重要の　真っ先に　=uppermost
belabor	(議論|仕事)長々とする(続ける)
scraggly	ギザギザの|でこぼこの|不揃いの|まばらな|モジャモジャの|発育の悪い
cheekbone	ほお骨
margay	マーゲイ
lumbago	腰痛
chiropodist	足治療の専門医
aloneness	孤独癖|孤独好き
veau	子牛
exegete	(特に)聖書解釈学者
acclimatise	get used to a certain climate; "They never acclimatized in Egypt"|get used to a certain climate
kilohertz	キロヘルツ(周波数の単位;《略》『kHz』)
botanically	植物学士|植物学的に
arrhythmic	lacking a steady rhythm; "an arrhythmic heartbeat"|lacking a steady rhythm|without regard for rhythm
plaintively	in a plaintive manner; "the last note of the song rang out plaintively"|in a plaintive manner
mouthpart	口器(節足動物の口の周辺にある付属器官)
traipse	だらだら歩く
threateningly	in a menacing manner; "the voice at the other end of the line dropped menacingly"|in a menacing manner
profligacy	豊富|おびただしさ|不品行|だらしなさ|放蕩|浪費
propene	プロピレン
precooked	cooked partially or completely beforehand; "frozen precooked meals from the supermarket"|cooked partially or completely beforehand
ascus	子嚢
spiritism	超俗|霊性
tailless	尾のない
cagliostro	カリオストロ
prioress	女性の小修道院長;(時に)女子修道院の女副院長(abbessの次に位する)
wirework	mesh netting made of wires
flatterer	追従者|上手者|佞人|幇間
doob	trailing grass native to Europe now cosmopolitan in warm regions; used for lawns and pastures especially in southern United States and India|trailing grass native to Europe now cosmopolitan in warm regions|used for lawns and pastures especially in southern United States and India
revivalism	再流行の動き(きざし)|信仰復興運動
locution	話しぶり|言い方|語法|言葉づかい|言い回し
carbolic	石炭酸の
diagnosable	capable of being diagnosed
lyssa	恐水病|狂犬病
fornicate	〈未婚や夫婦でない男女が〉性交渉を持つ|密通する
paulownia	桐(キリ|タンス等に使われる木)
yarmulke	ヤムルカ|ユダヤ教正統派の男性信者が教会や家庭でかぶる小さな頭布
swansong	(白鳥が死ぬまぎわに歌うと想像された)美しい歌|《比喩的に》(詩人・音楽家などの)最後の作品
diapause	休眠
muskellunge	オオカワマス(北米産カワマス属の大きな釣魚)
outsize	特大の
bluntness	ぶっきらぼう|率直
ulcerate	潰瘍を生じる|〜に潰瘍を生じさせる
gesticulate	身振りで話す|身ぶり手振りで表現する|活発な身ぶりをする
tailstock	support consisting of the movable part of a lathe that slides along the bed in alignment with the headstock and is locked into position to support the free end of the workpiece
skulk	こそこそ隠れる|ずるける|隠れる|こそこそ動く
heterosis	雑種強勢
athwart	(海事用語で)横切って;逆らって|《まれ》〜を横切って;〜に逆らって
literalism	文字通りに解釈すること|直訳調|写実主義
navicular	せん状骨|舟状
godhood	神格|神性
tunny	マグロ(tuna)
whitethorn	thorny Eurasian shrub of small tree having dense clusters of white to scarlet flowers followed by deep red berries; established as an escape in eastern North America|thorny Eurasian shrub of small tree having dense clusters of white to scarlet flowers followed by deep red berries|established as an escape in eastern North America
microtome	ミクロトーム
bellbird	any of several tropical American birds of the genus Procnias having a bell-like call
plugger	someone who is an active supporter and advocate
brancusi	コンスタンティン・ブランクーシ
columbarium	納骨堂
grazier	a rancher who grazes cattle or sheep for market
jimsonweed	チョウセンアサガオの一種(有毒)
meritless	without merit; "a sorry horse"; "a sorry excuse"; "a lazy no-count, good-for-nothing goldbrick"; "the car was a no-good piece of junk"|without merit
phytoestrogen	植物性エストロゲン|エストロゲンはステロイドホルモンの一種で|卵胞ホルモンまたは女性ホルモンと呼ばれる
boronic	of or relating to boron
blameworthy	非難すべき|とがめるべき
akka	アッコ
keycard	a plastic card that has a magnetically coded strip that is scanned in order to operate a mechanism
arbovirus	アルボウイルス
immoderate	度を越えた
acuteness	鋭さ|熱心さ|切迫|鋭さ|鋭敏|聡明|切迫|鋭さ
complainer	不平家|苦情を言う人
unaccountably	どういうわけか
fluorochrome	蛍光色素
antigonus	アンティゴノス
rhomboid	偏菱(へんりょう)形|長斜方形|ひし形の|長斜方形の
fatback	豚のわき腹上部の脂身[肉](通例塩漬けにされる)
exobiology	宇宙生物学(地球外の生物を研究する学問)
snowcapped	(山が)雪をいただいた
jurisprudential	relating to the science or philosophy of law or a system of laws
sanely	正気で|分別をもって
gruffly	in a gruff manner; "`No,' he replied gruffly"|in a gruff manner
soppy	びしょびしょの;(天気が)雨ふりの(rainy)|《英話》ひどく涙もろい|めそめそした
guidepost	道標|道しるべ|指針|指標
capacitate	〜'を'可能にする;〈人〉‘に'能力(資格)を与える
aneurism	動脈瘤
permissibility	admissibility as a consequence of being permitted
ostinato	オスティナート
welkin	空(sky)
berceuse	ララバイ|子守唄|子守歌|ベルスーズ|揺籃歌|子守り歌
matrilineal	based on or tracing descent through the female line; "matrilineal inheritance"|based on or tracing descent through the female line
photostat	写真版|写真版|写真版
untraditional	not conforming to or in accord with tradition; "nontraditional designs"; "nontraditional practices"|not conforming to or in accord with tradition
daringly	in an original manner; "daringly he took the first step"|in an original manner|in an adventurous manner; "daringly, he set out on a camping trip in East Africa"|in an adventurous manner
fireguard	(炉の前の)囲い金網|ストーブ囲い(fender)
breviary	(カトリックの)日課祈祷書
unburied	not buried
centralism	中央集権制|中央集権主義
entertainingly	in an entertaining manner; "Byron's consumed memoirs possessed the merit of being well and entertainingly written"|in an entertaining manner
insatiate	満足することない|飽くことのない
intolerably	耐えられないほどに
discomfiture	(希望・計画の)挫折|当惑|困惑
rhapsodic	ラプソディの|狂想的な|大げさな|熱狂的な
threepence	〈C〉旧3ペンス硬貨|〈U〉旧3ペンス[の金額・価値]
hoarder	財宝管理人;ためこみ屋
pyogenic	化膿性
tilter	someone who engages in a tilt or joust|a device for emptying a cask by tilting it without disturbing the dregs
haslet	heart and liver and other edible viscera especially of hogs; usually chopped and formed into a loaf and braised|heart and liver and other edible viscera especially of hogs|usually chopped and formed into a loaf and braised
bootes	a constellation in the northern hemisphere near Ursa Major
effacement	消すこと|削除
curacy	(おもに英国国教会の)牧師補(curate)の職
unmercifully	without pity; in a merciless manner; "he was mercilessly trounced by his opponent in the House"|without pity|in a merciless manner
ringway	環状道路|バイパス|環状線
milord	御前(ごぜん)様|だんな
madwoman	気違い女|狂女
titillation	くすぐり
terpsichore	ダンス|踊り|踊|舞踏|舞踊|舞蹈|舞
congeal	(液体を)凍らせる|凝結させる(する)|ゼラチン状になる(become gelatinous)
vascularity	血管分布
rabbinate	rabbis collectively|the office or function of a rabbi
counterterrorist	対テロ
arrogate	(自分の物に)〈権力・特権など〉'を'不当に帰する(占める)《+『to』 one『self』+『名』》|(自分に)〜‘が'あると理由もなく言う《+『to』one『self』+『名』》
quieten	静かになる《+『down』》|‘を'静かにさせる
boffo	resoundingly successful and popular; "for years he was a boffo box office certainty"|resoundingly successful and popular
overvaluation	過大評価
chary	用心深い|細心な;(〜に)用心深い《+『of』+『名』(do『ing』)》|遠慮がちな|つつましい|《補語にのみ用いて》(〜を)出し惜しむ|しぶしぶ(〜)する《+『of』(『in』)+『名』(do『ing』)》
enucleation	surgical removal of something without cutting into it; "the enucleation of the tumor"|surgical removal of something without cutting into it
stoically	じっとする
latecomer	遅参者
sousaphone	スーザフォン(チューバ(tuba)に似た大型の低音金管楽器)
wouldest	=wouldst
parasail	パラセール
mizzen	(3本マスト船の)後帆|=mizzenmast
manumission	奴隷(どれい)(農奴)からの解放;解放証書
complot	徒党
subkingdom	亜界
gondolier	ゴンドラの船頭
vanishingly	so as to disappear or approach zero; "errors are vanishingly rare"|so as to disappear or approach zero
patrimonial	父親譲りの|世襲の
unresolvable	not easily solved; "an apparantly insolvable problem"; "public finance...had long presented problems unsolvable or at least unsolved"- C.L.Jones|not easily solved|not capable of being resolved; "unresolvable confusion"|not capable of being resolved
arsenical	a pesticide or drug containing arsenic|relating to or containing arsenic; "arsenic vapor"|relating to or containing arsenic
abaxially	in an abaxial manner
shote	=shoat
fireclay	(耐火れんが・るつぼを作る)耐火粘土
abruption	an instance of sudden interruption
europeanisation	欧化
chemopreventive	化学予防
isopod	等脚目
debaser	a person who lowers the quality or character or value (as by adding cheaper metal to coins)
czarina	帝政ロシアの皇后
overexploitation	酷使
protectiveness	a feeling of protective affection|the quality of providing protection; "statistical evidence for the protectiveness of vaccination"|the quality of providing protection
feminisation	女性化
pullet	(1年未満の)めすのひな
insectivore	食虫動物(植物)
civilize	教化する|洗練する
snidely	with a sneer; in an uncomplimentary sneering manner; "`I don't believe in these customs,' he said sneeringly"|with a sneer|in an uncomplimentary sneering manner
phial	=vial
zebu	コブウシ(アジア・アフリカで飼育されている家畜)
describable	capable of being described
contrariwise	これに反して|(順序・方向などが)板対に|逆に|《話》ひねくれて|意地悪く
arrant	(悪い意味で)評判の|この上ない
appealingly	in an appealing manner; "the table was set appealingly"|in an appealing manner
breadbasket	《話》穀倉地帯|《俗》胃袋
appertain	(〜に)属する|関連する《+『to』+『名』》
separatrix	固相線
helichrysum	large genus of mostly African and Australian herbs and shrubs: everlasting flowers; in some classifications includes genus Ozothamnus|large genus of mostly African and Australian herbs and shrubs: everlasting flowers|in some classifications includes genus Ozothamnus
muramidase	リゾチーム
piecework	出来高払いの仕事
declamation	雄弁[術];〈C〉大げさな演説
miscarry	〈人・人の計画などが〉失敗する|しくじる(fail)|《英》〈手紙などが〉誤って配達される|不着になる|流産する
tangelo	タンジェロ(ミカンとグレープフルーツの交配種)
curtsy	お辞儀|お辞儀
pouf	お釜|ホモ
orrery	太陽系儀(太陽系の惑星・衛星の位置や動きを示す器具)|オーラリ
complacently	in a self-satisfied manner; "he complacently lived out his life as a village school teacher"|in a self-satisfied manner
buxus	type genus of the Buxaceae
mapmaking	製図
rockery	=rock garden
praseodymium	プラセオジム(希土類元素;化学記号はPr)
backslider	背教者|堕落者
untalented	不佞
setaria	annual or perennial grasses of warm regions: bristlegrasses
unmerited	not merited or deserved; "received an unmerited honorary degree"|not merited or deserved|not merited; "unmerited treatment of a potentially fine subject"|not merited
insubordinate	従順でない|反抗的|反抗的な;(〜に)従わない《+『to』+『名』》
whippoorwill	(北米産の)ヨタカの一種
lxiii	being three more than sixty
thallus	葉状体
overripe	too ripe and beginning to turn soft
chorister	聖歌隊員|(特に)少年聖歌隊員|《米》聖歌隊指揮者
lepidopteran	insect that in the adult state has four wings more or less covered with tiny scales
fulminate	声高に非難する|抗議する|爆発音を出す|電光のようにひらめく
nonproductive	(土壌・畑・鉱山などが)生産物を産出しない|生産能力のない|生産と直接関係のない
dukedom	〈U〉公爵の位|〈C〉公国|公爵領
dowitcher	オオハシシギ(くちばしの長い北米産のシギ)
passerine	スズメの目の|燕雀(えんじゃく)目に属する|スズメ目の鳥(ヒバリなどを含む)
ironworker	鉄工
directionless	当てのない|無目的|当ても無い
efface	(記憶)を消す|(文字など)を削除する|ぬぐい去る
anterograde	of amnesia; affecting time immediately following trauma|of amnesia|affecting time immediately following trauma
hemopoietic	造血性
transfectant	トランスフェクタント|形質移入体
bufflehead	ヒメハジロ
dazzlingly	in a manner or to a degree that dazzles the beholder
sneezy	inclined to sneeze
habanera	ハバネラ(キューバ起源の2拍子のスローダンス・その曲)
wouk	ウォーク
otosclerosis	hereditary disorder in which ossification of the labyrinth of the inner ear causes tinnitus and eventual deafness
bleakness	むき出し
hyperglycaemia	高血糖
originalism	the belief that the United States Constitution should be interpreted in the way the authors originally intended it
stabber	someone who stabs another person
whalebone	鯨のひげ
malaprop	誤用
thimbleberry	shrubby raspberry of eastern North America having showy rose to purplish flowers and red or orange thimble-shaped fruit|white-flowered raspberry of western North America and northern Mexico with thimble-shaped orange berries|raspberry native to eastern North America having black thimble-shaped fruit
monopsony	(economics) a market in which goods or services are offered by several sellers but there is only one buyer|a market in which goods or services are offered by several sellers but there is only one buyer
protista	原生生物
aluminate	a compound of alumina and a metallic oxide
herpetologist	a zoologist who studies reptiles and amphibians
allylic	アリル
szell	セル
retrospection	回想|追想;回顧|思い出
ungovernable	統御できない|抑えきれない
procardia	ニフェジピン
incise	〜‘に'切り込みを入れる;〜‘を'刻む
gloriosa	グロリオーサ
wittily	頓知をきかせて
hydrometer	液体比重計
foolery	〈U〉愚かなふるまい|愚劣;〈C〉(個々の)ばかげた行為(考えなど)
miff	むっとすること|むかっ腹|むっとさせる
deepness	深さ|深度|深遠
ropewalk	なわ製造所
culiacan	クリアカン
habitant	住民|居住者|住居者|住人
bocci	Italian bowling played on a long narrow dirt court
bedsore	(病人の)床ずれ
spittoon	=cuspidor
limulus	type genus of the family Limulidae
episcopacy	〈U〉《文》監督(主教|司教)の職(任期)|《the~》主教(司教)団
phylloxera	type genus of the Phylloxeridae: plant lice
occiput	後頭
thunderer	an epithet for Jupiter|a noisemaker that makes a sound like thunder
andantino	(音楽の演奏の指示で)アンダンティーノ(アンダンテ(andante)よりやや速い)|アンダンティーノの楽章(楽曲)
seigniorage	charged by a government for coining bullion
wantonness	the trait of lacking restraint or control; reckless freedom from inhibition or worry; "she danced with abandon"|the trait of lacking restraint or control|reckless freedom from inhibition or worry|the quality of being lewd and lascivious
caramelise	be converted into caramel; "The sugar caramelized"|be converted into caramel|convert to caramel
bowwow	ワンワン|犬の鳴き声|《小児語》わんわん
actinomyces	放線菌
madrasah	マドラサ
grot	窟|岩屋|石屋|洞窟|洞|洞穴
eyepatch	a protective cloth covering for an injured eye
redeposit	再析|再析
earmuff	耳おおい
druidism	the system of religion and philosophy taught by the Druids and their rites and ceremonies
teasel	any of several herbs of the genus Dipsacus native to the Old World having flower heads surrounded by spiny bracts
flinty	火打ち石の;火打ち石の多い|火打ち石のように堅い;残酷な|冷酷な(cruel)
upbraid	叱責する|とがめる|しかる
glycosaminoglycan	グリコサミノグリカン|動物の結合組織を中心に存在する軟骨の主な構造成分で|目の角膜にも見られる
branchlet	枝|小枝
fascicule	分冊
overcompensate	(〜に対して)補償し過ぎる《+『for』+『名』》
narcoleptic	ナルコレプシー
seismologist	地震学者
flatus	腸内にたまるガス
delphinus	a constellation in the northern hemisphere near Pegasus and Aquila|type genus of the Delphinidae
unbowed	(ひざ・腰が)曲がっていない|《文》屈服しない
countertransference	逆転位
yellowhammer	キアオジ(ヨーロッパ産ホオジロ属の小鳥)|北米産のキツツキの一種
unbox	remove from a box; "unbox the presents"|remove from a box
ceremoniously	慇懃に|仰々しく
nutation	章動
danu	Celtic goddess who was the mother of the Tuatha De Danann; identified with the Welsh Don|Celtic goddess who was the mother of the Tuatha De Danann|identified with the Welsh Don
dominie	《おもにスコットランド》学校教師|《方言》牧師
blouson	ウエストを締め上をゆったりさせた婦人用上着
hollowness	無意味なこと
unvoiced	声に出さない|口に出さない|無声の|無声音の
hyperextension	過伸展
waffler	someone who speaks or writes in a vague and evasive manner
haematoma	血腫
tenosynovitis	inflammation of a tendon and its enveloping sheath
passado	(fencing) an attacking thrust made with one foot forward and the back leg straight and with the sword arm outstretched forward|an attacking thrust made with one foot forward and the back leg straight and with the sword arm outstretched forward
snifter	《米》ブランデーグラス(西洋ナシ形のグラス)|《俗》(酒の)少量|ほんの一口|ちょっぴり一杯《+『of』+『名』》
scaremonger	世間を騒がせる人|デマをとばす人
defoliant	落葉剤
beguine	ビギン|ルンバに似た南米のダンス|ビギンの曲
degustation	taking a small amount into the mouth to test its quality; "cooking was fine but it was the savoring that he enjoyed most"|taking a small amount into the mouth to test its quality
neostigmine	ネオスチグミン
hypophyseal	of or relating to the hypophysis
tumorigenicity	腫瘍(しゅよう)原性
astigmatic	乱視の
nephrosis	ネフローゼ症候群
tersely	簡潔
unexceptional	例外でない|通例の|例外を認めない|《混同して》
workmate	僚友
sorex	type genus of the family Soricidae: shrews
fascistic	relating to or characteristic of fascism; "fascist propaganda"|relating to or characteristic of fascism
uninsurable	not capable of being insured or not eligible to be insured
dumpsite	捨て場|掃き溜め|あくた場|ゴミ捨て場|芥場|塵溜め|捨場
natality	出生率
maturely	熟して|円熟して|熟慮して
coloratura	コロラチューラ(声楽の装飾的高音部)|〈C〉コロラチューラソプラノ歌手
jemmy	オーバーコート|羊の頭
chemisorption	化学吸着
armful	(〜の)腕いっぱいの量《+『of』+『名』》
nervy	筋骨たくましい|神経過敏な
anticyclone	高気圧
nurseryman	苗畑の所有者|苗木屋
thumbscrew	つまみねじ|親指を締め上げる昔の拷問具
cardamon	カルダモン|カルダモン
jdam	a pinpoint bomb guidance device that can be strapped to a gravity bomb thus converting dumb bombs into smart bombs