amain	at full speed; with great haste; "the children ran down the hill amain"|at full speed|with great haste|with all your strength; "he pulled the ropes amain"|with all your strength
chokecherry	the fruit of the chokecherry tree|a common wild cherry of eastern North America having small bitter black berries favored by birds
cavil	けちをつける|あら探しをする
huskily	しわがれ声で
gastronomical	=gastronomic
unwarrantable	incapable of being justified or explained
anent	〜について|に関して
cytolysis	pathological breakdown of cells by the destruction of their outer membrane
cytotoxin	細胞毒
petfood	ペットフード
unfenced	not enclosed by a fence
hydrocolloid	親水コロイド
ethosuximide	エトサクシミド
determinist	宿命論者|運命論者
airlike	resembling air or having the form of air
norgestrel	ノルゲストレル
syncretic	relating to a historical tendency for a language to reduce its use of inflections; "modern English is a syncretic language"|relating to a historical tendency for a language to reduce its use of inflections|of or characterized by syncretism
individualisation	個別化|個体化
cerastium	耳菜
icing	着氷|アイシング|アイシング|アイシングザパック
refinisher	a skilled worker who is employed to restore or refinish buildings or antique furniture
heterodoxy	〈U〉(宗教上の)異端|〈C〉異端の教義|異説
verruca	(特に足の裏の)たこ|いぼ
quidnunc	a person who meddles in the affairs of others
schefflera	large genus of shrubby and climbing tropical plants having showy digitately compound foliage
lambast	がみがみ言う|をひどく殴る
squarish	正方形の|角ばった
arithmetically	with respect to arithmetic; "this problem is arithmetically easy"|with respect to arithmetic
unlovely	非絵画的|魅力がない|美しくない
abjure	宣誓して捨てる
aneuploid	having a chromosome number that is not an exact multiple of the haploid number
plenteous	= plentiful・『豊富な』|たっぷりの|たくさんの;豊富に生じる
doubletalk	きまじめな調子で意味のない言葉を挾んで相手を煙にまく話し方|内心とはかけ離れた話|むやみに難解な話し方
rusher	(football) a ball carrier who tries to gain ground by running with the ball|a ball carrier who tries to gain ground by running with the ball|someone who migrates as part of a rush to a new gold field or a new territory|a person who rushes; someone in a hurry; someone who acts precipitously|a person who rushes|someone in a hurry|someone who acts precipitously
pumpkinseed	small brilliantly colored North American sunfish
uncorrectable	incapable of being controlled or managed; "uncontrollable children"; "an uncorrectable habit"|incapable of being controlled or managed
debauch	〈人〉'を'堕落させる;〈生活など〉'を'退廃させる|放蕩(ほうとう)|道楽;らんちき騒ぎ
spackle	powder (containing gypsum plaster and glue) that when mixed with water forms a plastic paste used to fill cracks and holes in plaster
dormition	celebration in the Eastern Orthodox Church of the Virgin Mary's being taken up into heaven when her earthly life ended; corresponds to the Assumption in the Roman Catholic Church and is also celebrated on August 15th|celebration in the Eastern Orthodox Church of the Virgin Mary's being taken up into heaven when her earthly life ended|corresponds to the Assumption in the Roman Catholic Church and is also celebrated on August 15th
cypre	large tropical American tree of the genus Cordia grown for its abundant creamy white flowers and valuable wood
splotch	染み|汚れ|斑点|汚れがつく|染みがつく|染みの原因になる|に染みをつける|を汚す
unrehearsed	即興的|俄仕立て
flamboyance	華麗さ|けばけばしさ
agammaglobulinemia	無ガンマグロブリン血症
imperatively	in an imperative and commanding manner
philadelphus	any of various chiefly deciduous ornamental shrubs of the genus Philadelphus having white sweet-scented flowers, single or in clusters; widely grown in temperate regions|any of various chiefly deciduous ornamental shrubs of the genus Philadelphus having white sweet-scented flowers, single or in clusters|widely grown in temperate regions
ratite	飛べない走鳥類|(ダチョウ|エミュー等)
pennyworth	(〜の)1ペニーで買える分量|1ペニー分(の〜)《+『of』+『名』》|わずか|少量(の)《+『of』+『名』》
crofter	小作農
tankage	the quantity contained in (or the capacity of) a tank or tanks|the charge for storing something in tanks|the act of storing in tanks
gramp	おじいちゃん
adenoidectomy	アデノイド切除
mflop	メガフロップス|メガフロップ
exorbitantly	非常識
customhouse	税関(《英》customs house)
rigmarole	くだらない（まとまりのない）長話　くだらない長々としたやり方（手続き）　無駄話
vaccinee	a patient who has been vaccinated
audibility	聞き取れること|可聴度
calkin	a metal cleat on the bottom front of a horseshoe to prevent slipping
anovulation	the absence of ovulation due to immaturity or post-maturity or pregnancy or oral contraceptive pills or dysfunction of the ovary
dragoman	(アラビア・トルコ・ペルシアなどの)通訳
cogency	(理由・議論などの)説得力|なるほどと思わせること
butterfish	any of numerous small flat Atlantic food fish having smooth skin|small marine fish with a short compressed body and feeble spines|slippery scaleless food fish of the northern Atlantic coastal waters
convalesce	病気から回復する
songster	歌手|歌の作者;詩人|鳴き鳥(songbird)
protirelin	プロチレリン
supersession	(〜に)取って代わること|(〜の)代替|代用《+of+名》
lushness	豊富
unsocial	非社会的な;非社交的な;家庭生活が優先する
vertiginous	グルグル回る|目が回るような|目まぐるしい|目まいがする|旋回する|不安定な|変わりやすい
theobroma	cacao plants
electrocardiograph	心電計
commingle	混ざり合う
dejectedly	in a dejected manner; "when she came back Sophie and Esther were sitting dejectedly in the kitchen"|in a dejected manner
pictographic	絵文字の|象形文字の
tamely	in a tame manner; "the labour movement allowed itself to be run out of power tamely"|in a tame manner
congee	a Chinese rice gruel eaten for breakfast|(architecture) a concave molding|a concave molding|formal permission to depart; "he gave me his conge"|formal permission to depart|an abrupt and unceremonious dismissal|depart after obtaining formal permission; "He has congeed with the King"|depart after obtaining formal permission|perform a ceremonious bow
sailcloth	帆布|ズック|帆木綿
suggestibility	susceptibility or responsiveness to suggestion
undereducated	poorly or insufficiently educated
phlegmatic	ほとんど感情を示さない|痰の多い|粘液質の|無気力な
adelgid	any of various insects that feed and form galls on conifers
pyrogen	any substance characterized by its great flammability|any substance that can cause a rise in body temperature
boohoo	泣きわめく|泣きわめく声|ワーワー
dispossess	(特に法律に基づいて)(財産・土地などを)〈人〉‘から'取り上げる|没収する《+『名』〈人〉+『of』+『名』〈物〉》
bimolecular	二分子
draftsperson	a skilled worker who draws plans of buildings or machines
dermaptera	earwigs and a few related forms
xerographic	of or relating to xerography
skycap	(空港の)手荷物運搬係|赤帽
gibe	(for)|ばかにする|とがめだてする|あざける|からかい
drily	=dryly
languorous	けだるい
wattmeter	電力計
digitiser	デジタイザ|アナログ-デジタルコンバータ|アナログ-デジタルコンバーター|デジタイザー
foulness	不浄|汚れ|汚物|垢
dicotyledon	双子葉植物
osteoma	骨腫
thermopile	熱電対列
dysgenesis	発育不全
slithery	ずるずる(するする)すべる|つるつるした
schlep	(持ち)運ぶ|引っ張って行く|のろのろ動きまわる|ぶらぶらする|無能なやつ|面倒な仕事|大変な苦労
cockamamie	ばかばかしい|くだらない
paralyse	麻痺させる|無力にする|麻痺
pointillism	点描画法(フランスの新印象派の画家たちの技法)
sneakily	コソコソと|こっそりと|隠れて
pterygium	either of two thickened triangular layers of conjunctiva extending from the nasal edge of the eye to the cornea; it arises from irritation of the pinguecula|either of two thickened triangular layers of conjunctiva extending from the nasal edge of the eye to the cornea|it arises from irritation of the pinguecula
rumple	〜‘を'しわにする|くしゃくしゃにする|しわになる|くしゃくしゃになる|しわ(wrinkle)
weigela	deciduous shrub widely cultivated for its white or pink or red flowers
tarsier	メガネザル(インドネシア産;長い尾と大きな目を持つ小形の猿)
haltingly	ぎくぎく|つっかえつっかえ
ropey	筋張った
submucosa	the connective tissue beneath mucous membrane
pichi	Peruvian shrub with small pink to lavender tubular flowers; leaves yield a tonic and diuretic|Peruvian shrub with small pink to lavender tubular flowers|leaves yield a tonic and diuretic
freebee	something that is free (usually provided as part of a promotional scheme); "the road map was a freebie"|something that is free (usually provided as part of a promotional scheme)
disapprobation	=disapproval
tetany	clinical neurological syndrome characterized by muscular twitching and cramps and (when severe) seizures; associated with calcium deficiency (hypoparathyroidism) or vitamin D deficiency or alkalosis|clinical neurological syndrome characterized by muscular twitching and cramps and (when severe) seizures|associated with calcium deficiency (hypoparathyroidism) or vitamin D deficiency or alkalosis
glumly	むっつりして
archdeaconry	archdeaconの職(地位|任期|住息)
vulpine	キツネの|キツネのような;(キツネのように)ずるがしこい
inspirer	a leader who stimulates and excites people to action
pomelo	ザボン|晩白柚|ザボン
pectus	胸元|胸先|胸板|胸|チェスト|胸糞|胸座|胸部|胸郭|胸間
mexiletine	メキシレチン
ambrosial	(ambrosiaのように)非常に美味な|かんばしい
adaxially	in an adaxial manner
lacewing	any of two families of insects with gauzy wings (Chrysopidae and Hemerobiidae); larvae feed on insect pests such as aphids|any of two families of insects with gauzy wings (Chrysopidae and Hemerobiidae)|larvae feed on insect pests such as aphids
restrictively	in a restrictive manner; "this relative clause is used restrictively"|in a restrictive manner
goalpost	ゴールポスト
homogenisation	均一化|均質化
waggish	こっけいな|おどけた;いたずら好きの
dullard	のろま|ばか
synecdoche	提喩法|代喩|シネクドキ|全体とその一部についての言い換え
helenium	genus of American herbs with flowers having yellow rays: sneezeweeds
phagocyte	食細胞
groundsheet	=ground cloth
dogsbody	あくせく働くやつ|下っぱ
provender	かいば|まぐさ|《おどけて》(人の)食物
sourly	機嫌悪く|むっつり|むっと
infeasibility	the quality of not being doable
matronly	既婚婦人らしい|品のある|落ち着いた|(若い女性が)太めの
blabbermouth	口の軽い人
dolomitic	relating to or consisting of dolomite
tiddler	《話》非常に小さい魚|《呼び掛けに用いて》ちびっ子|《俗》半ペニー銅貨
ungracious	無作法な|粗野な
overawe	〜‘を'威圧する|怖がらせる
mothball	防虫剤|をしまい込む
holidaymaker	休日の行楽客|休日を楽しむ人
flippantly	in a flippant manner; "he answered the reporters' questions flippantly"; "this cannot be airily explained to your children"|in a flippant manner
pancreatectomy	膵切除
limonite	褐(かつ)鉄鉱
gack	ギャー
phimosis	an abnormal tightness of the foreskin preventing retraction over the glans
airworthy	(航空機またはその部品が)航空に耐える|耐空性の
underskirt	アンダースカート(スカートの下にはくもの;ペチコートなど)
proapoptotic	アポトーシス(細胞死)促進性の
squinty	斜視の|横目の
gaddi	a cushion on a throne for a prince in India
linocut	リノリウム版画法;〈C〉リノリウム版画
sulfanilamide	スルファニルアミド
pothos	ポトス|オウゴンカズラ
lascar	an East Indian sailor|a volcano in the Andes in Chile
tattooist	入れ墨師
cylindric	シリンドリカル|円柱状
aureate	金色の|さん然と輝く|華麗な
vespertine	夕方の|晩の|夕方に起こる|夕方に活動する
rhizopus	any of various rot causing fungi of the genus Rhizopus
appal	=appall
basophilic	staining readily with basic dyes
menadione	メナジオン
nightbird	宵っぱり
leanness	乏しさ
antiphonal	bound collection of antiphons|containing or using responses; alternating; "responsive reading"; "antiphonal laughter"|containing or using responses|alternating|relating to or resembling an antiphon or antiphony
prepuce	(陰茎の)包皮
hartebeest	シカレイヨウ(南アフリカ産の大カモシカ)
undreamed	not imagined even in a dream
pointblank	(射撃など)至近距離からの|直射の|至近距離の|あけすけな|至近距離から|直射で|あけすけに
equable	一様な|均等な|(気分・気性などが)穏やかな|平静な
oppressively	高圧的
evildoer	悪事を行う人|悪人|悪者
poxvirus	ポックスウイルス|DNAウイルスの一種|ポックスウイルス科のウイルスによる疾患として天然痘が有名
liquidambar	楓属
handcart	手押し車
boodle	賄賂(わいろ)|買収金|腐敗看守　腐敗警官　盗品|ぶんどり品
kaopectate	trade name for a fixed-combination antidiarrheal drug that use kaolin as the adsorbent and pectin as the emollient
praesidium	=presidium
elderflower	西洋ニワトコの花
microbalance	微量天秤
vibramycin	ドキシサイクリン
anaerobe	嫌(けん)気性生物(空気・遊離酸素を必要としない細菌類)
unthinkingly	in a thoughtless manner; "he stared thoughtlessly at the picture"|in a thoughtless manner
hemoglobinuria	血色素尿
shortsightedness	近眼|近視|肉眼
moonscape	月面の眺め;月面写真
indulgently	甘く|気ままにさせる|優しく|寛大に
patronise	贔負|顧客となる|ひいき|後援|擁護|ひいき
proximo	来月の
wangfujing	王府井は北京中心部の繁華街|巨大デパートや飲食店が立ち並び一帯は歩行者天国になっている
midafternoon	the middle part of the afternoon
whimsey	whimsy
tatou	about three feet long exclusive of tail
tolu	aromatic yellowish brown balsam from the tolu balsam tree used especially in cough syrups
zalcitabine	直接ディジタル制御
foraminifer	有孔虫
caudata	salamanders; newts; congo snakes|salamanders|newts|congo snakes
saponification	鹸化
snowfield	雪原
superfluity	〈U〉〈C〉(〜が)多すぎること|余分|過剰《+of+名》|〈C〉《おもに複数形で》余分なもの|必要以上のもの;ぜいたく品
cremate	〈死体〉'を'火葬にする
immunohistochemically	免疫組織化学的に
podophyllum	ポドフィルム
periosteum	骨膜
tricorn	三角帽子
tweeze	〜をピンセットで抜く
birchbark	a canoe made with the bark of a birch tree
anabolism	(生物の)同化作用
tetroxide	an oxide containing four atoms of oxygen in the molecule
gracile	slender and graceful
typicality	代表
generalissimo	大元帥
coquettish	(女が)男にこびを売る|なまめかしい|あだっぽい
flavourful	full of flavor
toxicodendron	in some classifications: comprising those members of the genus Rhus having foliage that is poisonous to the touch; of North America and northern South America|in some classifications: comprising those members of the genus Rhus having foliage that is poisonous to the touch|of North America and northern South America
worriedly	心配そうに
unenclosed	not closed in our surrounded or included; "an unenclosed porch"; "unenclosed common land"|not closed in our surrounded or included
anorgasmia	absence of an orgasm in sexual relations
cognize	存知|存ずる|存じる|分かる|知る
anticyclonic	of or relating to or characteristic of the atmosphere around a high pressure center
uneventfully	in an uneventful manner; "the space shuttle landed uneventfully"|in an uneventful manner
seasonably	時機を得て|つごうよく
outcaste	(インドで人が)社会的地位のない
downrange	(ロケット・ミサイルなどが)射程に沿って
deportee	国外追放者|被追放者|流刑者
commiseration	哀れみ|同情
entrain	〜‘を'列車に乗せる|列車に乗る
mechanistically	機構的に
potbellied	たいこ腹の
counterpoise	〈C〉=counterbalance|〈U〉釣合い|安定|=counterbalance{動}1
inquiringly	不審そうに|尋ねたそうに
bowfin	primitive long-bodied carnivorous freshwater fish with a very long dorsal fin; found in sluggish waters of North America|primitive long-bodied carnivorous freshwater fish with a very long dorsal fin|found in sluggish waters of North America
mutineer	19
pietism	敬虔主義
greensand	an olive-green sandstone containing glauconite
zoic	pertaining to animals or animal life or action
sailmaker	a maker of sails
overqualified	(ある仕事に泌要以上に)教育(経験)がある
commendably	りっぱに|感心にも
fertilise	肥やす|肥す
maladjustment	適合(調和)しないこと;(環境への)不適応
insecurely	物騒|物騒
tinamou	heavy-bodied small-winged South American game bird resembling a gallinaceous bird but related to the ratite birds
perdix	a genus of Perdicinae
cremains	the remains of a dead body after cremation
perceptively	in a perceptive manner
sardonyx	サードニックス
unmeasurable	impossible to measure; "unmeasurable reaches of outer space"|impossible to measure
peludo	Argentine armadillo with six movable bands and hairy underparts
cronyn	クローニン
polyploid	倍数体
steelworker	製鋼所工員|製鋼所職工|鉄鋼労働者
leitmotif	主な動機|中心思想･テーマ
unfeigned	偽らない|真実の(genuine)
impalpable	手で触れない|触知(感知)できない|(差異などが)なかなか理解できない|微妙な
murmuring	うなり声
scattergood	浪費家
sideburn	片鬢
didactical	instructive (especially excessively)
cottonmouth	=water moccasin
conjointly	併せて|あわせて|合わせて|いっしょに|一緒に|合せて|一所に
anseriformes	ducks; geese; swans; screamers|ducks|geese|swans|screamers
theosophist	神知学者|接神論者
milker	乳牛|乳用種|乳用牛
extrachromosomal	染色体外の
comeliness	愛らしさ|魅力|色香|美しさ|可愛気
liquify	液化|溶解|液化|溶解
gelly	a type of dynamite in which the nitroglycerin is absorbed in a base of wood pulp and sodium or potassium nitrate
symbolization	表徴|シンボル|象徴|表象|象徴化|記号化
unsubtle	大掴|露骨|大雑把|おおざっぱ|粗掴み|粗掴|大掴み
salmagundi	寄せ集め
cowshed	牛小屋|牛舎
grossness	卑陋|低劣|平凡|俚俗|俗気|粗野|下品|不意気|卑俗|俗
scrapheap	ごみの山|くず鉄の山;《the~》ごみため|ごみ捨て場
ectodomain	細胞外ドメイン
grinner	a person who grins
particularism	a focus on something particular
carefulness	注意深いこと
symptomatically	by symptoms
semiology	記号論
astatine	アスタチン(放射性元素の一つ;化学記号は『At』)
cittern	シターン
hemoglobinopathy	異常血色素症
escapology	脱出術(袋・鎖から抜け出る奇術)
vaporous	蒸気が充満した|蒸気を出す|霧のかかった|はかない|空想的な|妄想的な|誇大な|実質のない
eucaryotic	真核|真核生物
touchwood	火口
prevarication	言いのがれ|ごまかし|うそ
sourness	酸味|酸っぱさ|酸性|酸味|酸っぱ味|酸っぱみ|酸っぱさ|不機嫌|酸味
tartlet	タートレット
acidemia	酸性血
toilsome	苦しい|難しい|きつい|ヘビー|辛い|ハード|しんどい|つらい|ヘビイ|困難
cordgrass	any of several perennial grasses of the genus Spartina; some important as coastal soil binders|any of several perennial grasses of the genus Spartina|some important as coastal soil binders
listlessness	惰気|無気力|倦怠
somnolent	眠い
antipyretic	熱さましの|解熱の|解熱剤
stenotic	狭窄
sibilant	シューシュー音がする|歯擦音
agastache	giant hyssop; Mexican hyssop|giant hyssop|Mexican hyssop
mortify	くやしがらせる|恥をかかせる|抑制する|(肉欲･感情などを)抑える
signaller	someone who communicates by signals
unstudied	(行為などが)自然な|わざとらしくない
unrequested	not requested; "the merchandise was unrequested"|not requested
scathingly	遠慮会釈なく|遠慮会釈無く|手厳しく|痛烈に
unhallowed	聖別(祝別)されない|あがめられない|《文》悪に染まった|邪悪な
popover	軽焼きマフィン・(軽い焼き菓子の一種)
overfly	(編隊飛行で)〜‘の'上空を飛行する
injudicious	無分別な|無思慮な
beriberi	脚気(かっけ)
hawkweed	any of various plants of the genus Pilosella|any of numerous often hairy plants of the genus Hieracium having yellow or orange flowers that resemble the dandelion
uninterruptedly	without interruption; "this pleasant state of affairs had continued peacefully and uninterruptedly for many years"|without interruption
resurvey	再測量
hagfish	メクラウナギ
unmanly	男らしくない|ひきょうな|めめしい|柔弱な
cookhouse	炊事場・(特に)船の調理室|(キャンプ・工事現場などの)仮設炊事場
anhedonia	性快感消失症
foreboding	胸騒ぎ|胸騒|胸さわぎ|虫の知らせ
phosphatic	リン酸塩の|リン酸塩を含む
armamentarium	the collection of equipment and methods used in the practice of medicine
fickleness	虚偽|気まぐれ|不誠実
trifoliata	カラタチ
satinwood	サテンの木(東インド産のマホガニーの一種)
penicillinase	ペニシリナーゼ
unsheathe	〈刀など〉‘を'さやから抜く
anthologize	私撰
senselessly	野暮|野暮
unethically	in an unethical manner; "he behaved unethically"|in an unethical manner
digoxigenin	ジゴキシゲニン|ジギタリス属の植物Digitalis orientalis等の花や葉に存在するステロイド|生化学における研究ツールとして用いられる
jewfish	large important food fish of Australia; almost indistinguishable from the maigre|large important food fish of Australia|almost indistinguishable from the maigre|large dark grouper with a thick head and rough scales
confiscatory	没収の|押収の|(税などが)過重な
unobjectionable	(of behavior or especially language) free from objectionable elements; fit for all observers; "good clean fun"; "a clean joke"|(of behavior or especially language) free from objectionable elements|fit for all observers|not causing disapproval; "it was an innocuous remark"; "confined himself to innocuous generalities"; "unobjectionable behavior"|not causing disapproval|not objectionable; "the ends are unobjectionable; it's the means that one can't accept"|not objectionable
lychgate	a roofed gate to a churchyard, formerly used as a temporary shelter for the bier during funerals
aiai	会々
bambusa	tall tender clumping bamboos
colocasia	small genus of perennial tuberous herbs of tropical Asia: taro
climatically	気候上;風土的に
cryogen	寒剤
amnio	羊水穿刺
sarcomere	筋節|サルコメア(骨格筋線維の収縮単位)
condylar	顆状
steepen	〜‘を'険しくする|急勾配(こうばい)にする|険しくなる|急勾配になる
scentless	かおりのない
motorization	モータリゼーション
impulsion	〈C〉衝動|推進力|刺激|〈U〉推進
pinprick	(ピンなどで刺した)小さい穴|いやがらせ|意地悪
overactivity	excessive activity; "overactivity of the sebaceous glands causes the skin to become oily"|excessive activity
vicinal	belonging to or limited to a vicinity
sparge	the act of sprinkling or splashing water; "baptized with a sprinkling of holy water"; "a sparge of warm water over the malt"|the act of sprinkling or splashing water|agitate by introducing air or compressed gas; "sparge the water"|agitate by introducing air or compressed gas|scatter with liquid; wet lightly; "Sprinkle the lawn"|scatter with liquid|wet lightly
railyard	an area having a network of railway tracks and sidings for storage and maintenance of cars and engines
cranesbill	ハクサンフウロ
incongruously	in an incongruous manner; "his shirttails stuck out from his tuxedo pants somewhat incongruously"|in an incongruous manner
malvasia	used to make malmsey wine
microsome	ミクロソーム|細胞をホモジナイズ(すりつぶす)して遠心分離すると|最初に核が|次にミトコンドリアが沈殿し|最後に上澄みから得られる小胞体などを含む部分|タンパク質合成活性などがある
sarcoid	of or relating to or resembling flesh
nebulosity	〈C〉星雲状の物|〈U〉ぼんやりした状態|あいまいさ
agreeableness	快適さ|愛想
stickball	a form of baseball played in the streets with a rubber ball and broomstick handle
factious	派閥的な|党派心の強い
middlebrow	ある程度教養がある人|知識や教養が中位の人|知識が中くらいの
microfossil	微化石
allergology	アレルギー学
provincialism	地方気質|地方色|偏狭|田舎根性|いなか風|田舎くささ|訛り|方言
shabbily	みすぼらしく;卑しく
undersell	を控えめに売り込む|値引いて売る|より安く売る|不当に低く印象づける
pinguicula	butterworts: a large genus of almost stemless carnivorous bog plants; Europe and America to Antarctica|butterworts: a large genus of almost stemless carnivorous bog plants|Europe and America to Antarctica
hydrometric	of or relating to hydrometry
aesthetical	美的|審美的|美学的
palaeoclimatology	the study of the climate of past ages
exotoxin	a toxin that is secreted by microorganisms into the surrounding medium
turgor	膨圧
pelmet	(カーテン上部の金具をかくす)上飾り(《米》valance)
pinfold	a pen where stray animals are confined
shyster	いんちき弁護士
bluepoint	oysters originally from Long Island Sound but now from anywhere along the northeastern seacoast; usually eaten raw|oysters originally from Long Island Sound but now from anywhere along the northeastern seacoast|usually eaten raw|small edible oyster typically from the southern shore of Long Island
detractor	中傷者|けなす人
cefadroxil	セファドロキシル
tessin	テシーン
superinfection	重複感染
chelonian	カメ
unlovable	incapable of inspiring love or affection; "she was in some mysterious way...unlovable"-Joseph Conrad|incapable of inspiring love or affection
pompon	ポンポン|ポンポン
bromoform	ブロモホルム
hellacious	すばらしい|びっくりするような|ひどい|つらい(hell of a に近いことば)
armlet	腕輪|腕飾り(手首でなく腕上膊(じょうはく)部にはめる)|小さな入り江
counterargument	反論
dockland	ドック地域|波止場地域|ドック地区
penumbral	of or pertaining to the region of partial shadow around an umbra
gastrula	原腸胚
oversexed	性的興味(性欲)が強過ぎる
imperfective	aspect without regard to the beginning or completion of the action of the verb
feedstuff	飼料|えさ
hatemonger	one who arouses hatred for others
homewards	=homeward
ambrosian	of or by or relating to Saint Ambrose; "Ambrosian chants"|of or by or relating to Saint Ambrose|extremely pleasing to the taste; sweet and fragrant; "a nectarous drink"; "ambrosial food"|extremely pleasing to the taste|sweet and fragrant|worthy of the gods
finitude	有限
frugally	つましく|質素に
shako	(前に金層装飾|上に羽飾りのついた)筒形軍帽
bestride	〜‘に'またがる;〜'を'またいで越す
bovril	an extract of beef (given to people who are ill)
pilaster	ピラスター|柱形|付け柱|片蓋柱
savarin	サバラン
rapine	略奪|強奪
varanus	type and sole extant genus of the Varanidae
palaeogeography	古地理学
cypriniformes	コイ目
milliard	10億(billion)
wittingly	承知で|わざと
tellurian	地球人
fiddlestick	バイオリンの弓(bow)
tumblebug	any of various dung beetles
noncombatant	非戦闘員(軍医・従軍牧師など)|戦時の一般市民
abnegation	権利(欲望など)の放棄;禁欲
vouge	a kind of pike used by foot soldiers in the 14th century
synergize	相乗作用を与える
sporangium	(コケ植物の)胞子嚢(のう)
crucifer	any of various plants of the family Cruciferae
malefic	有害な|災いを呼ぶ
jawan	(India) a private soldier or male constable|a private soldier or male constable
oversensitive	神経過敏
rale	ラ音
scatterbrain	気持ちが散漫な人|軽率な人
betake	(〜に)〈自分〉'を'行かせる《+one『self to』+『名』》
quaestor	クァエストル
forestation	植林|造林;営林
fauve	フォーブ
dejeuner	昼食会|お昼|昼御飯|昼飯|昼餐|午餐|昼げ|昼餉|ランチ|昼めし
amobarbital	アモバルビタール
outspread	fully extended in width; "outspread wings"; "with arms spread wide"|fully extended in width
chrysoberyl	金緑石
perca	type genus of the Percidae
lyophilization	リュフィリゼーション
mindfully	in a careful deliberate manner
elecampane	オオグルマ
quietus	《文》(債務などの)清算|解除|死|とどめ
stael	スタール
bedcover	キルトケット|ベッドカバー
wharfage	波止場(埠頭)使用料
enplane	飛行機に乗る(《英》emplane)
alarum	警報|アラーム
infrequency	まれなこと
frogfish	fish having a frog-like mouth with a lure on the snout
vinous	ぶどう酒の[ような];ぶどう酒に酔った|ワインレッド色の
cornstalk	とうもろこしの茎
greasewood	low hardy much-branched spiny shrub common in alkaline soils of western America
footbath	足洗い用たらい|足を洗うこと
saurian	トカゲ類の動物|トカゲ類の|トカゲ類動物特有の
pungency	(味・香りなどの)刺激|(皮肉・機知の)鋭さ|しんらつ
furfural	フルフラール
photoconductive	光伝導性
outport	外港
mudflat	干潟(ひがた)
avuncular	叔父の|おじ(伯父･叔父)の(ような)
shivery	ぞくぞくする|寒い
tramline	市街電車系統|《話》(テニスの)コートの側線
hypophysectomy	下垂体切除
exarch	a bishop in one of several Eastern Orthodox Churches in North America|a bishop in eastern Christendom who holds a place below a patriarch but above a metropolitan|a viceroy who governed a large province in the Roman Empire
curdle	(牛乳など)凝結させる|凝固する
noncontroversial	not likely to arouse controversy
redcoat	(米国独立戦争当時の)英兵
anergy	アネルギー
chigger	ツツガムシ(ダニの一種)|スナノミ(南米・アフリカ産のノミ)
fasciola	a genus of Fasciolidae
disproportional	不相応|不均衡|不釣合
bushbaby	ガラゴ科
setscrew	止めねじ|押しねじ
unmerciful	無慈悲な|残酷な
parimutuel	パリミューチュエル方式
tideway	潮路・潮流
adaxial	向軸性
deadness	死の状態|生気のないこと|(色などの)さえないこと;(酒などの)気の抜けていること
reprobation	非難|叱責(しっせき)|神に見放されること
esox	type and only genus of the family Esocidae
burgomaster	(オランダ・フランドル地方・ドイツ・オーストリアの)市長
filarial	糸状虫の|フィラリアの
opalescence	オパールのような光|乳白光
patchiness	unevenness in quality or performance
roundish	丸みのある|やや丸い
interpenetration	the action of penetrating between or among|mutual penetration; diffusion of each through the other|mutual penetration|diffusion of each through the other
pottle	a pot that holds 2 quarts
plimsoll	《複数形で》《英》ゴム底ズック靴|運動靴《米》sneaker)
untwist	よりがもどる|ほどける|〈糸〉‘の'よりをもどす|〈もつれ〉‘を'ほどく
fibroadenoma	線維腺腫
milquetoast	気の弱い人|いくじなし
absentmindedly	ぽかんと|ぼんやり|うかうか|あっけらかん
necromantic	relating to or associated with necromancy; "mysterious necromantic rites"|relating to or associated with necromancy|given to or produced by or used in the art of conjuring up the dead; "a necromantic sorcerer"; "necromantic delusions"; "necromantic powders and other weird objects"|given to or produced by or used in the art of conjuring up the dead
fugard	フガード
epiglottis	喉頭蓋|のどぶた
nasally	in a nasal manner; "inhaled nasally"|in a nasal manner
raffinose	ラフィノース
compatibly	with compatibility
vacantly	ぼんやりと|ぽかんとして
cablegram	=cable{名}3
superorder	(biology) a taxonomic group ranking above an order and below a class or subclass|a taxonomic group ranking above an order and below a class or subclass
hatbox	a round piece of luggage for carrying hats
thiotepa	チオテパ
parenterally	非経口的
amphioxus	ナメクジウオ
acclimatize	順応させる
pirogue	丸木舟|刳舟|刳船|丸木船|独木舟|空舟|空ろ舟|丸太舟|独木船|刳り船
obsessional	(人・考えが)強迫観念(妄想)にとりつかれた|(病気が)強迫観念(妄想)の症状を表して|強迫観念(妄想)を持っていめ人
injuriously	in an injurious manner
flophouse	安宿|簡易宿泊所
debarkation	陸揚げ|上陸
crinoid	ウミユリ(ウミユリ綱の棘皮(きょくひ)動物)
counterproposal	代案|対案
miscue	誤り|しくじり(をする)|(スポーツの)エラー|間違った合図をする
unrepeatable	not able or fit to be repeated or quoted; "what he said was funny but unquotable"|not able or fit to be repeated or quoted|unique; "dogs and mice and flies are as unrepeatable as men are"- Theodosius Dobzhansky|unique
croupier	胴元
nastily	不快に|意地悪く|みだらに
tachymeter	タキメーター
edematous	swollen with an excessive accumulation of fluid
consanguineous	血族の|血縁の|血を分けた
camporee	キャンポリー(ボーイスカウトの地方集会)
malarky	閑文字
inculcation	繰り返し教え込むこと|心にたたき込むこと
downstage	舞台の前方で(へ)|舞台前方の|舞台前半分
mynah	tropical Asian starlings
sandgrouse	pigeon-like bird of arid regions of the Old World having long pointed wings and tail and precocial downy young
enteropathy	腸疾患
wardroom	(軍艦の)上級士官室
personalty	=personal property
caliche	crust or layer of hard subsoil encrusted with calcium-carbonate occurring in arid or semiarid regions|nitrate-bearing rock or gravel of the sodium nitrate deposits of Chile and Peru
splutter	(混乱して)早口でしゃべる|〈物が〉パチパチ(ジュー)と音を立てる|(混乱して)〜‘を'早口で言う《+『out』+『名』|+『名』+『out』》|パチパチ(ジュー)という音
enlistee	新兵
mignonette	モクセイソウ(かおりのいい緑色がかった小さい花房をつける庭木)
orography	the science of mountains
unromantic	neither expressive of nor exciting sexual love or romance
sophistical	ことば巧み
laurelwood	tropical American tree; valued for its hard durable wood|tropical American tree|valued for its hard durable wood
provability	capability of being demonstrated or logically proved
crosscheck	〈計算〉'を'別のやり方で検算する|〈データなど〉'を'種々の情報(方法)で確かめる
nobleness	崇高|高遠さ|高貴さ|高尚さ|高潔さ|高貴|高邁さ|尊さ|貴さ|偉大さ
eggbeater	卵泡立て器
appurtenance	付属物|従物(法律上財産に付属している権利)
sealskin	オットセイ(アザラシ)の皮(毛皮)
supernormal	beyond the range of the normal or scientifically explainable; "supernormal intimations"|beyond the range of the normal or scientifically explainable|exceeding the normal or average; "years of supernormal employment during the war"; "a phase of supernormal excitability"|exceeding the normal or average
emaciation	解離|窶れ|痩せぎす
oubliette	(城などの)地下牢(ろう)(天井に出入口がある)
forewarn	(〜について)〈人〉‘に'前もって知らせる《+『名』〈人〉+『of』+『名』》;〈人〉‘に'(〜であることを)前もって警告する《+『名』〈人〉+『that節』》
coregonus	type genus of the Coregonidae: whitefishes
motorman	(電車・電気機関車の)運転手
nativist	a philosopher who subscribes to nativism|advocating the perpetuation of native societies; "the old nativist prejudice against the foreign businessman"; "the nativistic faith preaches the old values"- C.K.Kluckhohn|advocating the perpetuation of native societies|of or relating to or advocating nativism; "nativist theories"; "the traditional controversy between the nativistic and empiristic theories"|of or relating to or advocating nativism
bingle	単打|シングルヒット
monetarism	通貨主義
mahuang	マオウ
ophthalmoscopy	examination of the interior of an eye using an ophthalmoscope
bewilder	まごつかせる|当惑させる|驚き呆れさせる
communicational	コミュニケーションの|連絡の|伝達の
myotonia	筋緊張症
alveolitis	肺胞炎|肺胞炎
adaptative	having a capacity for adaptation; "the adaptive coloring of a chameleon"|having a capacity for adaptation
promethium	プロメチウス(希土類元素;化学記号はPm)
flatcar	長物車(木材・鋼材などを運ぶ屋根・側面のない貨車)
polyuria	多尿
consulship	領事の職(地位|任期)
armourer	a worker skilled in making armor or arms; "a sword made by a famous English armorer"|a worker skilled in making armor or arms|an enlisted man responsible for the upkeep of small arms and machine guns etc.|a manufacturer of firearms
proteasomal	プロテアソーム(proteasome|タンパク質の分解を行う巨大な酵素複合体)の
menfolk	男たち|男性|男連中|複数扱い
immunostained	免疫染色
hyson	a Chinese green tea with twisted leaves
vasarely	バザレリー
nostalgically	昔を懐しんで|郷愁で
scission	the act of dividing by cutting or splitting
menstruate	生理がある
horsebox	馬運搬用貨車(トレイラー)
honker	鼻|カナダ雁
polydactyly	多指症
crystallise	釈明|解きあかす|解明かす|解明|解明す|結晶
prayerbook	祈祷書
monopolise	独占|モノポライズ|独占|丸取り|独占化|丸どり|一人占|まる取り|独り占め|壟断|丸取|一人占め
frazzle	ぼろぼろになる|へとへとに疲れる|〜ぼろぼろにする|へとへとに疲れさせる|ぼろぼろの状態|くたくたの状態
unclouded	澄み切った|かげりのない
tubocurarine	ツボクラリン|d-ツボクラリン|クラーレ
affability	愛想の良さ|感じの良さ
affright	《古》〜'を'こわがらせる
linalool	リナロール
recantation	(主張･陳述などの)撤回|取消し|否認
cephalothin	セファロチン
anouilh	French dramatist noted for his reinterpretations of Greek myths (1910-1987)
flannelette	綿ネル(フランネルのように表面がけば立っている)
pelota	ハイアライ
visigoth	西ゴート
outplay	〜‘より'じょうずである;(競技などで)〜‘に'勝つ(defeat)
southwestward	南西へ(に)|南西の;南西への|南西|南西部
impracticality	〈U〉実行不可能|非実用性|〈C〉実行不可能なこと|実用的でないこと
gigantism	巨大症|巨人症|巨人症
hyaena	=hyena
gunsight	照尺
crudeness	荒|粗略さ|草昧|荒れ|荒荒しさ|荒っぽさ|粗|荒々しさ|荒くれ|暴|粗野|ラフさ|粗っぽさ|荒荒しさ|荒っぽさ|武骨|荒々しさ|荒くれ|粗さ|粗野|粗暴さ
abrade	〈皮膚〉'を'擦傷する;〈毛・岩など〉'を'すり減らす
upholster	〈いす・ソファー〉‘に'詰め物をする|クッション(おおい)を取り付ける|〈部屋〉‘に'じゅうたん(家具)を取り付ける
aldermanic	of or relating to or like an alderman
expostulation	いさめること|訓戒;説伏
debunker	正体をあばく人|仮面をはぐ人
grampus	ハナゴンドウ(暖かい海にいるイルカ科の動物)
concentricity	同心
hexapod	六脚類|昆虫
graupel	雪状のあられ
hindgut	後腸
gallimaufry	雑多な寄せ集め|ごたまぜ
besmirch	《文》〜'を'汚す
apatosaurus	雷竜
conventioneer	大会出席(参加)者
duckbill	カモノハシ
dilapidation	〈U〉荒廃|破損|《複数形で》(家具付き家などの)家具破損料
marginalise	relegate to a lower or outer edge, as of specific groups of people; "We must not marginalize the poor in our society"|relegate to a lower or outer edge, as of specific groups of people
tabun	タブン|遺伝的アルゴリズム
unpronounceable	impossible or difficult to pronounce correctly|very difficult to pronounce correctly; "an unpronounceable foreign word"; "unutterable consonant clusters"|very difficult to pronounce correctly
ethnographical	of or relating to ethnography; "ethnographical data"|of or relating to ethnography
slaveholder	someone who holds slaves
stereograph	ステレオ写真、立体図
millionairess	百万長者
flacon	(栓付きの)小びん
dorsiflexion	背屈
orbitofrontal	Orbitofrontal cortex眼窩(がんか)前頭皮質|ヒトの脳の一部で|意思決定などの認知処理に関わっている
spick	汚れのない|清浄
foreordain	(神などが)〈人の運命・破滅など〉‘を'あらかじめ定める
polygala	ヒメハギ|ヒメハギ科
protestation	抗議
retrench	(費用などを)削減する|削除する|省く
deanship	the position or office of a dean
radiosensitivity	放射線感受性|感光性
castellan	城主|城代|城守
diabatic	involving a transfer of heat; "a diabatic process"|involving a transfer of heat
aphakic	無水晶体|無水晶体
frack	(=fracking)|(シェールオイルの掘削の際)高圧水で岩を砕くこと(=hydraulic fracturing)
becalm	(風がないで)〈帆船〉'を'止める
specifiable	capable of being specified; "specifiable complaints"|capable of being specified
epistatic	上位性|エピスタシスとは|遺伝学において異なる遺伝子座間の相互作用が一つの形質に影響すること
undisputable	歴然たる
plyer	someone who plies a trade
crapshoot	不確実(予測不可能)なこと|賭け|さいころ博奕をする|危険を冒す
trandolapril	an ACE inhibiting drug (trade name Mavik) used in some patients after a heart attack or to treat hypertension
syncytium	合胞体|融合細胞|合胞体; 多核質; シンシチウム
straggler	落後者|stray(迷う)とdraggle(引きずる)の混成
skedaddle	あわてて逃げる|あわてて逃げること
gingery	having a taste like that of ginger|(used especially of hair or fur) having a bright orange-brown color; "a man with gingery hair and bright blue eyes"; "a ginger kitten"|(used especially of hair or fur) having a bright orange-brown color
greybeard	お爺さん|爺様|尊翁|お爺|爺さま|隠居|御爺様|お爺様|翁人|爺
disbandment	(組織・隊などの)解散|解隊
unskillful	下手|不器用
behaviourism	行動主義
cheekily	生意気に
ageratum	アゲラータム|アゲラータム
recurrently	反回性
actualisation	現実化|実現|具体化
persnickety	=pernickety
ineluctable	不可抗力の|不可避の|免れえない
reboxetine	an antidepressant drug that blocks the reuptake of norepinephrine
tokenism	(特に人種差別廃止における)名目主義
parasitemia	寄生虫血症
polychromatic	多染性|多染性
scrimp	倹約する|切詰める|切り詰める|節約する
urus	ウルス|最近絶滅した長く角のあるヨーロッパの大型の野生雄牛
mustachioed	having a moustache
cembalo	チェンバロ(harpsichord)
tinware	すず(ブリキ)製品
imide	イミド
cistus	small to medium-sized evergreen shrubs of southern Europe and North Africa
uria	murres
retrogressive	(元の状態に)後退する|逆行する|退化する;(〜に)後退する《+『to』+『名』》
amorality	超道徳性;道徳意識の欠如|不道徳
amateurism	アマチュア精神;しろうと芸
militarisation	動員|軍事化
hermaphroditic	両性具有の|雌雄同体の
outscore	アウトポイント
leprous	ハンセン病(らい病)にかかった;ハンセン病の|らい病の
universalistic	of or relating to or tending toward universalism
cecropia	large genus of tropical American trees that yield a bast fiber used for cordage and bark used in tanning; milky juice yields caoutchouc|large genus of tropical American trees that yield a bast fiber used for cordage and bark used in tanning|milky juice yields caoutchouc|North American silkworm moth; larvae feed on the leaves of forest trees|North American silkworm moth|larvae feed on the leaves of forest trees
penstock	(水力発電所・水車などの)導水路;水門
lambent	(特に炎が)ちらちらゆらめく|軽妙な|柔らかく輝く
leatherjacket	カワハギ
monosomy	chromosomal abnormality consisting of the absence of one chromosome from the normal diploid number
bimanual	requiring two hands or designed for two people; "a two-handed sledgehammer"; "a two-handed crosscut saw"; "a machine designed for bimanual operation"|requiring two hands or designed for two people
asocial	非社交的な|思いやりのない|利己的な
sacristan	(教会・修道院の)聖具室係
ephesian	a resident of the ancient Greek city of Ephesus|of or relating to ancient Ephesus or its people or language or culture
cimex	type genus of the Cimicidae: bedbugs
tragicomedy	(悲劇と喜劇の両面をもつ)悲喜劇
surmontil	トリミプラミン
ironbound	鉄で巻かれた|岩の多い|ごつごつした|堅い|曲げられない
coexistent	共存の
niggardly	けちな|もの惜しみして
warrantor	保証人
stimulative	capable of arousing or accelerating physiological or psychological activity or response by a chemical agent
pentode	a thermionic tube having five electrodes
tilefish	important marine food fishes|yellow-spotted violet food fish of warm deep waters
lebensraum	生存圏|生活圏
untended	世話されていない|世話する者がいない|ほったらかしの
prepacked	prepared and wrapped beforehand and ready for sale; "prepackaged foods"|prepared and wrapped beforehand and ready for sale
cerivastatin	an oral drug (trade name Baycol) to reduce blood cholesterol levels
blancmange	ブラマンジエ(牛乳とコーンスターチで作った甘いブディング)
enchiridion	入門|必携|マニュアル|便覧|ハンドブック
experimentalism	an empirical doctrine that advocates experimental principles
operably	実施(使用)可能に;手術可能に
libidinous	好色な|肉欲的な|扇情的な
bleriot	French aviator who in 1909 made the first flight across the English Channel (1872-1936)
eversion	外転|倒置|倒しま|倒錯
paraboloid	a surface having parabolic sections parallel to a single coordinate axis and elliptic sections perpendicular to that axis
pressurise	加圧|加圧|加圧
appetiser	前菜|アペタイザー
unforgettably	忘れられないで|いつまでも記憶に残って
postdate	〈手紙・事件など〉‘の'日付けを実際よりも遅らせる
overcrossing	横断歩道橋|歩道橋
liriodendron	tulip trees
fauteuil	an upholstered armchair
copyedit	〈原稿〉'を'校正する
pockmark	あばた
orate	演説する
ergocalciferol	カルシフェロール|コレカルシフェロール|エルゴカルシフェロール
paratyphoid	パラチフス
hakea	Australian shrubs and small trees with evergreen usually spiny leaves and dense clusters of showy flowers
greenshank	アオアシシギ
buckboard	(米西部やいなかで用いる車体を木で作った)軽四輪荷馬車
khalifah	カリフ
commentariat	評論家
micropaleontology	the paleontology of microfossils
noisome	有害な|悪臭のする|不快な
diabolically	as a devil; in an evil manner; "his writing could be diabolically satiric"|as a devil|in an evil manner
paralichthys	a genus of Bothidae
atypically	非定型的
unrelentingly	びしびし|用捨なく|容赦なく
bechamel	ベシャメルソース|ホワイトソース
pocketable	ポケッタブル
curatorship	the position of curator
hidebound	偏狭な|頑固な
galbanum	楓子香
intoxicate	酔わせる|夢中にさせる
exasperate	怒らせる|悪化させる
esthetically	審美的
curtsey	お辞儀|お辞儀
fatalist	運命論者|宿命論者
dribbler	a basketball player who is dribbling the ball to advance it|a person who dribbles; "that baby is a dribbler; he needs a bib"|a person who dribbles
trinitrotoluene	トリニトロトルエン|高性能爆薬(《略》TNT|T.N.T.)
onrushing	突進する
pilose	covered with hairs especially fine soft ones
slanguage	language characterized by excessive use of slang or cant
departmentally	dependent on a department
crispen	make brown and crisp by heating; "toast bread"; "crisp potatoes"|make brown and crisp by heating
babyhood	赤ん坊時代|幼年(期)
bluestocking	《軽べつして》文学かぶれの女性|学才を誇る女
hypoglycaemic	血糖降下
puffery	a flattering commendation (especially when used for promotional purposes)
tensity	緊張;張り
hypothesise	見なす|決込む|はかり知る|臆度|推し計る|思為す|推測|見做す|忖度|決め込む
disrespectfully	無礼
nephrotoxic	腎毒性
mesmeric	催眠術の
balky	(馬が)急に止まる癖のある|(人など)がんこな|強情な
apprehensively	ひやひや|おどおど|やきもき|冷冷|不安|冷や冷や|心配そうに
gradational	taking place by degrees
grenadian	a native or inhabitant of Grenada|of or relating to or characteristic of Grenada or its inhabitants; "the Grenadian capital"|of or relating to or characteristic of Grenada or its inhabitants
leadless	無鉛
roofless	(建物が)屋根のない|(人が)宿なしの
monistic	of or relating to the philosophical doctrine of monism; "the monistic school would regard national law and international law as an integrated whole"- J.S.Roucek|of or relating to the philosophical doctrine of monism
despoil	(〜を)〈人・場所〉‘から'奪う《+『名』+『of』+『名』》
pappus	冠毛
fogy	時勢遅れの人|がんこで旧弊な人
auricula	心耳
barrelhouse	安酒場|ホンキートンク|安キャバレー
arbitrable	appropriate for or subject to settlement by arbitration; "an arbitrable wage and health benefits policy"; "an arbitrable dispute"|appropriate for or subject to settlement by arbitration
inroad	侵入|侵略|襲撃
cavalierly	in a proud and domineering manner; "he treated his staff cavalierly"|in a proud and domineering manner
wireman	a worker who installs and repairs electric wiring
kilocalorie	カロリー|kcal|Cal|キロカロリー
mantic	占いの|予言者的な|予言者の
dirndl	ダーンドル(チロル農民ふうの婦人服で|ぴったりした胴着とゆったりしたスカートから成る)|ダーンドルふうのスカート
humectant	any substance that is added to another substance to keep it moist
whicker	嘶き
theca	花粉のうや蘚類の胞子のうのケースやさや|昆虫のサナギの外側のさや(outer sheath of the pupa of certain insects)
filiation	種根|素姓|氏素姓|門|系統|血統|家世|種姓|家筋|血脈|素姓|筋目|系列|系統|血統|種姓|家筋|起源|血筋|由来
gangrenous	壊疽(えそ)の|壊疽にかかった
vainglorious	うぬぼれの強い|虚栄心の強い
fearfulness	怖じけ|虞|もの恐ろしさ|怖さ|怖気|恐さ|おじ気|脅威|怖|恐れ
bouffe	オペラブッファ|喜歌劇|オペアコミーク|オペラコミック|コミックオペラ|コミック
bailment	the delivery of personal property in trust by the bailor to the bailee
embezzle	着服する|使い込む|横領する
disenchant	の魔法を解く
waterpower	水力
positivistic	実証主義者
cyberwar	an assault on electronic communication networks
benevolently	in a benevolent manner; "she looked on benevolently"|in a benevolent manner
archbishopric	archbishopの職(地位|任期|教区|管轄権)
mayoress	《米》女性市長|《英》市長夫人
dysgraphia	impaired ability to learn to write
smacker	尤物
hatchway	=hatch
debilitation	去勢|疲労困憊|衰弱
samphire	アッケシソウ
pinnace	艦載艇|(船への人の乗降・荷の運搬に用いる)小舟|小ボート
plummy	好ましい|上等な|素晴らしい|スモモの|プラムのたくさん入った|干しブドウ入りの|丸くぽちゃぽちゃした|声量の豊かな
refractoriness	the trait of being unmanageable
nonsynonymous	非同義
greisen	a granitic rock composed of quartz and mica
allocution	(rhetoric) a formal or authoritative address that advises or exhorts|a formal or authoritative address that advises or exhorts
quizmaster	《おもに米》クイズ番組の司会者(《英》question master)
extirpate	〈悪習・集団など〉‘を'根絶する|撲滅する|〈植物〉‘を'根こそぎにする
quizzer	試験官|検査官
destress	reduce the emphasis
imposer	押しつける人|(課題・重荷などを)課する人
handpick	〜‘を'注意して選ぶ
avoirdupois	=avoirdupois weight(《略》『avdp』)
convulse	身もだえさせる|震動させる
crystallite	微結晶|晶子
imperiously	傲然と|横柄に|専制的に
conversationally	俗に
misappropriate	悪用する|使い込む
indigofera	genus of tropical herbs and shrubs having odd-pinnate leaves and spurred flowers in long racemes or spikes
tuberosity	結節
corgard	ナドロール
neuroblast	神経芽細胞
kibosh	戯言|くだらないこと|ばかげたこと|ナンセンス|にとどめを刺す|をたたきつぶす|だいなしにする
unconcern	無関心|むとんじゃく|(心配事に)平気|平然
francium	フランシウム(放射性元素;化学記号は『Fr』
dearness	高価|親愛
gonfalon	(横木につるす)流旗|吹き流し
spadefoot	a burrowing toad of the northern hemisphere with a horny spade-like projection on each hind foot
edibility	食用に適すること
stationmaster	駅長
natriuresis	the presence of abnormally large amounts of sodium in the urine
blankness	the state of being blank; void; emptiness|the state of being blank|void|emptiness
unclutter	収去|除去|取除く
squidgy	のり状の|どろりとした
cryobiology	the branch of biology that studies the effects of low temperatures on living tissues or organs or organisms
consomme	コンソメ
hunting	狩をする|狩猟|狩り
rockslide	地滑り
wastrel	浪費家;怠け者
religiousness	piety by virtue of being devout
postern	裏口|裏門|通用門
philosophize	哲学的に思索する
neediness	極貧|窮乏|貧困|欠乏状態|困窮|赤貧|貧しさ
undischarged	(船の積み荷が)荷揚げされていない|(銃が)未発射の|(勘定・借金が)未払いの|(法的に)返済不履行の
cacophonous	不協和音の
irremediable	(病気・悪習・欠点などが)直せない;(失敗・損失などが)取り返しのつかない
unperceived	not perceived or commented on
altocumulus	高積雲
logistician	a person skilled at symbolic logic
tropically	in a tropical manner; "it was tropically hot in the greenhouse"|in a tropical manner
styptic	血止めの|(みょうばんなどの)止血剤
cimmerian	intensely dark and gloomy as with perpetual darkness; "the Cimmerian gloom...a darkness that could be felt"-Norman Douglas|intensely dark and gloomy as with perpetual darkness
hyperaldosteronism	高アルドステロン症|アルドステロン症
leonine	ライオンの(のような)
redhorse	North American sucker with reddish fins
humulus	hops: hardy perennial vines of Europe, North America and central and eastern Asia producing a latex sap; in some classifications included in the family Urticaceae|hops: hardy perennial vines of Europe, North America and central and eastern Asia producing a latex sap|in some classifications included in the family Urticaceae
abscission	切除|切断;分離|離脱
nonviable	生育不能
wonderingly	不思議そうに|怪しそうに|驚いて
obtention	入手
haversack	《まれ》(兵士の食料・衣類を入れる)雑のう
spiritless	元気のない
hypnotise	induce hypnosis in
signally	著しく
caterwaul	(発情期の猫のように)ギャーギャー言う|いがみ合う|ギャーギャー鳴く声
expansiveness	広範囲|大規模|広大さ|きさくさ
unburden	〜‘の'荷物を降ろす|(打ち明けて)〈心〉‘の'重荷を降ろす|‘を'軽くする|〈悩みなど〉‘を'打ち明ける
batfish	bottom-dweller of warm western Atlantic coastal waters having a flattened scaleless body that crawls about on fleshy pectoral and pelvic fins
tetanic	＜tetanus|破傷風の
osteopetrosis	大理石骨病
paleography	古文書学
methenamine	antibacterial agent (trade names Mandelamine and Urex) that is contained in many products that are used to treat urinary infections
congrat	(口語)おめでとう! congratulationsの略
outmost	=outermost
noblewoman	貴族の婦人|高貴の生まれの女性
fossiliferous	bearing or containing fossils; "fossiliferous strata"|bearing or containing fossils
vicuna	ビキューナ|ビキューナ
balagan	a word for chaos or fiasco borrowed from modern Hebrew (where it is a loan word from Russian); "it was utter and complete balagan!"|a word for chaos or fiasco borrowed from modern Hebrew (where it is a loan word from Russian)
catcall	(集会などでの)やじの声|口笛|やじる
dishwater	食器を洗った後の汚れ水
anticlimax	漸降法|滑稽な格調低下|大きな期待のあとの失望|竜頭蛇尾|尻すぼみ
gushy	噴出する|感傷的な
footwall	下盤
lefthander	左ききの人|左腕投手
guestimate	目分量
creese	a Malayan dagger with a wavy blade
piggybank	(特に子供が用いる)豚の形をした硬貨用小型貯金箱
everlastingly	永永|幾久しく|尽未来際|永々|何時迄も|いつ迄も|いつまでも|何時までも|永久に|千代に八千代に
maguey	Mexican plant used especially for making pulque which is the source of the colorless Mexican liquor, mescal|Philippine plant yielding a hard fibre used in making coarse twine
pushpin	画鋲
unshackle	〜‘を'かせをはずす;〜‘を'解放する
homiletic	説教の
paleogeography	古地理学
arthrography	roentgenographic examination of a joint after injection of radiopaque contrast medium; produces an arthrogram|roentgenographic examination of a joint after injection of radiopaque contrast medium|produces an arthrogram
promisor	a person who makes a promise
preclusive	防止的
dicloxacillin	ジクロキサシリン
shunter	転轍手(器)　入れ替え用機関車
untranslatable	not capable of being put into another form or style or language; "an untranslatable idiom"; "untranslatable art"|not capable of being put into another form or style or language
schmaltzy	ひどく感傷的な
kowhai	shrub or small tree of New Zealand and Chile having pendulous racemes of tubular golden-yellow flowers; yields a hard strong wood|shrub or small tree of New Zealand and Chile having pendulous racemes of tubular golden-yellow flowers|yields a hard strong wood
unmatchable	無類|比類のない|無敵|唯一無二
resuscitator	a breathing apparatus used for resuscitation by forcing oxygen into the lungs of a person who has undergone asphyxia or arrest of respiration
froward	つむじ曲がりの|ひねくれた|強情な
oceangoing	=seagoing
antilope	blackbucks
hyperlipoproteinemia	高リポ蛋白血症
dropline	a headline with the top line flush left and succeeding lines indented to the right
uncomprehending	無理解
farrago	寄せ集め|ごたまぜ
audaciously	in an audacious manner; "an idea so daring and yet so audaciously tempting that a shiver of excitement quivered through him"|in an audacious manner
harrumph	(わざとらしく|または異議を表明して)咳払いする|ぶっきらぼうに示す
hydantoin	ヒダントイン
whitethroat	ノドジロムシクイ(ヨーロッパ産ののどの白い鳴き鳥)
institutionalise	送る|送込む|入れる
indelicate	粗野な|ぶしつけな|下品な
venation	脈相(植物の葉脈・昆虫の翅脈などの分布状態)
cineraria	シネラリア
kutuzov	クトゥーゾフ
babinski	ババンスキー
rangy	歩き回る
exhaustible	capable of being used up|capable of being used up; capable of being exhausted; "our exhaustible reserves of fossil fuel"|capable of being exhausted
ceremonious	=ceremonial1
trollop	だらしのない女|自堕落な女|身持ちの悪い女
pixilated	少し頭が変な|酔っぱらった
slaveholding	the practice of owning slaves|allowing slavery; "the slaveholding South"|allowing slavery
ottar	アタール
freyja	フライヤ
genista	chiefly deciduous shrubs or small trees of Mediterranean area and western Asia: broom
electrologist	someone skilled in the use of electricity to remove moles or warts or hair roots
pyrrhotite	a brownish iron sulfide mineral (FeS) having weak magnetic properties
unworldly	世間離れのした
ideality	the quality of being ideal
epiglottitis	喉頭蓋炎
halocarbon	one of various compounds of carbon and any of the halogens
blintze	ブリンツ
colloquialism	口語体の語句|話しことば
necromania	an irresistible sexual attraction to dead bodies
synapsis	対合
maraca	マラカス(リズム楽器)
nark	=narc
laurentius	ラウレンチウス|セントローレンス島
guardhouse	衛兵所|留置所
ralegh	ウォルター・ローリー
democratise	民主化|民主化
ictal	発作性
lunation	太陰月|朔望月
imprecisely	不正確
guardedly	in a conservative manner; "we estimated the number of demonstrators conservatively at 200,000."|in a conservative manner
tranquilly	安けく
shopworn	(商品など)店ざらしの|(文句･考え)古臭い|陳腐な
pudendal	外陰
delectation	《気どって》喜び|楽しみ
flowerbed	花壇
pyrethrin	ピレトリン(除虫菊から抽出した殺虫剤)
loxapine	a tranquilizer (trade name Loxitane) used to treat schizophrenia
fenestra	a small opening covered with membrane (especially one in the bone between the middle and inner ear)
bodge	駄目にする
lacewood	variably colored and sometimes variegated hard tough elastic wood of a sycamore tree
couldst	=couldの二人称単数形
laugher	楽勝
flavoursome	full of flavor
cryonic	Cryonic Preservation(人体冷凍保存技術)
decriminalisation	legislation that makes something legal that was formerly illegal
indeterminable	解決できない|決定できない
nothofagus	beeches of temperate southern hemisphere except Africa: southern beech
masterstroke	すばらしいできばえ|みごとな腕前(手腕)
doorknocker	=knocker
integrality	全体性
invagination	嵌入|陥入
kegler	ボウリング競技者|ボウラー(bowler)
unsuppressed	given vent to; "unsuppressed rage"; "unsuppressed feelings"|given vent to
prate	《『prate』 『about』+『名』》(〜を)ぺちゃくちゃしゃべる|くどくどと話をする
submissively	in a servile manner; "he always acts so deferentially around his supervisor"|in a servile manner
whithersoever	[〜するところへは]どこへでも
rhythmicity	周期性|リズミカル
cocksure	自信満々の|うぬぼれの強い;(〜に)うぬぼれた《+『of』(『about』)+『名』(do『ing』)》|(〜だと)うぬぼれている《+『that節』》|(〜すると)確信しきっている《+『to』 do》
gonne	Irish patriot and a founder of the Sinn Fein (1865-1953)
foundress	a woman founder
knish	クニシュ(肉・じゃがいもなどの詰め物を入れて油であげたユダヤ料理)
crammer	詰め込み勉強(一夜づけ)をする人|《話》詰め込み勉強をさせる教師(学校|書物など)
decoratively	in a decorative manner; "used decoratively at Christmas"|in a decorative manner
unaccented	強勢(アクセント)のない
moldboard	(うねの土をはね返す)すき板;(ブルドーザーの)ブレード
prokaryote	原核生物|核膜が無い(区別出来る核を持たない)細胞(原核細胞)からなる生物|細菌類や藍藻類が相当する
permeabilization	透過化
carabao	水牛|フィリピン産の水牛
methaqualone	メタカロン
dalesman	a person who lives in the dales of northern England
bughouse	精神病院
misdirect	あて先を誤る|誤った指導をする
drey	the nest of a squirrel
quadraphonic	(録音再生が)4チャンネルの
laelia	レリア
acculturate	文化変容を起こす|文化変容する
undervaluation	過小評価
putout	(野球で打者・走者を)アウト[にすること]
cusk	カスク
goatherd	ヤギ飼い
doubloon	(スペインなどで昔用いた)ダブロン金貨
despairingly	with desperation; "`Why can't you understand?,' she asked despairingly"|with desperation
planetoid	小惑星・= asteroid
bronchopneumonia	気管支肺炎
verbalization	the words that are spoken in the activity of verbalization|the activity of expressing something in words