porringer	深皿(特に小児のためのスープ・ポリッジ用)
munificence	気前のよさ|物惜しみをしないこと
cottier	鼻栓
incorruption	characterized by integrity or probity
wideness	極大|著大|絶大さ|巨大|茫漠さ|夥しさ|巨大さ|おびただしさ|マクロ|無量
minicab	ミニキャブ
habitude	habitual mode of behavior
latticework	〈U〉格子作り(細工|模様)|〈C〉格子
impetuously	in an impulsive or impetuous way; without taking cautions; "he often acts impulsively and later regrets it"|in an impulsive or impetuous way|without taking cautions
filiform	糸状
cautiousness	慎重さ|用心深さ
imbibition	吸い上げ|飲むこと
providentially	念入り
accounting	会計学|会計|計算
dysphasia	an impairment of language (especially speech production) that is usually due to brain damage
luxemburger	a native or inhabitant of Luxembourg|of or relating to the capital city of Luxemburg; "Luxemburger streets"|of or relating to the capital city of Luxemburg|of or relating to or characteristic of the grand duchy of Luxemburg or its people
buret	ビュレット
flysheet	(雨天の時テントの上にかぶせる)補助シート
brandmark	mark with a brand or trademark; "when this product is not branded it sells for a lower price"|mark with a brand or trademark
beigel	ベーグル
baykal	バイカル湖
pentad	五つ|５|伍つ|拳固|五|伍
dehumidify	〜‘の'湿気を除去する|'を'除湿する
cockade	花形帽章(階級などを表してつけられたが|現在は装飾用)
polyfoam	ウレタンフォーム
asarum	wild ginger
akko	アッコ
inconstancy	変わりやすさ;移り気|浮気
inducibility	誘導能|誘導性
bondable	capable of being fastened or secured with a rope or bond|capable of holding together or cohering; as particles in a mass|capable of holding together or cohering|as particles in a mass
sweeping	おおざっぱな|全面的な|さっと動く|掃除|広範な|ごみくず|十把一絡げ
teaberry	ウィンターグリーン|ウィンターグリーン
folium	a thin layer or stratum of (especially metamorphic) rock
chromogen	色原体
stalactite	(鍾乳洞で上からつらら状にできる)鍾乳石
groggily	ふらふらして|千鳥足で
benison	《古》祝福
suasion	勧告|説得
impenitent	悔い改めない|改心しない;がん迷な
gayety	=gaiety
overstretch	肉離れさせる|攣る
parturient	of or relating to or giving birth; "parturient pangs"; "the parturient uterus"|of or relating to or giving birth|giving birth; "a parturient heifer"|giving birth
arriver	到着者
moneybox	お金を入れる箱
pentaerythritol	ペンタエリトリトール
coordinately	協調
secale	cereal grass widely cultivated for its grain: rye
jocularity	〈U〉こっけいさ|ひょうきん|《複数形で》こっけいな(ひょうきんな)言葉(行動)
greaseproof	(紙が)防油脂性の
fantasist	ファンタジー作家|妄想癖
amorphophallus	any plant of the genus Amorphophallus
protactinium	プロトアクチニウム(放射性金属元素;化学記号は『Pa』)
remunerate	(苦労などに対し)〈人〉‘に'報いる《+『名』+『for』+『名』(do『ing』)》|(サービスに対し)〈人〉‘に'報酬を与える《+『名』+『for』+『名』)doing)》
ormolu	brass that looks like gold; used to decorate furniture|brass that looks like gold|used to decorate furniture
dueler	決闘者
waveband	(ラジオ・テレビなどの)周波帯
glossina	ツェツェ蠅
cryptographer	暗号使用者
icefall	凍った滝
sadistically	加虐的に
lxxxv	being five more than eighty
centralist	advocating centralization
onymous	bearing a name; "articles in magazines are usually onymous"|bearing a name
sternness	厳しさ|厳格さ
illegitimately	違法
brail	a small net used to draw fish into a boat|a small rope (one of several) used to draw a sail in|take in a sail with a brail|haul fish aboard with brails
wisecrack	気のきいた言葉|皮肉|いやみ|皮肉をいう
ruminator	a reflective thinker characterized by quiet contemplation
subdominant	下属音
prandial	of or relating to a meal
engross	夢中にさせる
zymogen	any of a group of compounds that are inactive precursors of enzymes and require some change (such as the hydrolysis of a fragment that masks an active enzyme) to become active
misplacement	置き違い
convolute	《まれ》=convoluted
backslide	(悪い方へ)後戻りする
insufflation	ガス注入|ガス注入
hermaphroditism	両性素質
gracefulness	beautiful carriage
elide	省く|取り除く|削除する|無視する
mumpsimus	a traditional notion that is obstinately held although it is unreasonable; "he still holds to the old mumpsimus that a woman's place is in the kitchen"|a traditional notion that is obstinately held although it is unreasonable
solarize	日
upchuck	吐く|もどす|〜‘を'吐く|もどす
hemiplegic	半身不随
insurgence	暴動
nearside	《名詞の前にのみ用いて》《おもに英》(馬や馬車の)左側の
buckyball	バックミンスターフラーレン
maliciousness	賊心|犯意|遺恨|害意|意地悪|物恨|悪念|怨念|意趣遺恨|意地悪さ
busman	バスの運転手(車掌)
witticism	名言|機知に富んだ言葉
tympanum	中耳|鼓膜
spherule	a small sphere
trophozoite	栄養体
neurasthenia	神経衰弱
letch	狒狒|出歯亀|戯男|助け平|色狂|色きちがい|助平|助兵衛|狒々|エロ爺
paleface	白人
ingoing	はいって来る
bitchiness	意地悪|醜悪|悪意
sinistral	of or on the left; "a sinistral gastropod shell with the apex upward has its opening on the left when facing the observer"; "a sinistral flatfish lies with the left eye uppermost"|of or on the left|preferring to use left foot or hand or eye; "sinistral individuals exhibit dominance of the left hand and eye"|preferring to use left foot or hand or eye
plasterwork	漆喰
rediffusion	リディフュージョン
solenopsis	fire ants
catnap	うたたね|仮寝|うたたねをする
cockfight	闘鶏(試合)
sureness	確実;確信;安全
meteoritic	of or relating to or caused by meteorites
brachyura	短尾類
deconstructionist	of or concerned with the philosophical theory of literature known as deconstructionism; "deconstructionist criticism"|of or concerned with the philosophical theory of literature known as deconstructionism
propertied	財産(資産)のある
amygdaloid	切れ長
ruiner	駆逐艦|破壊者
tyrannosaur	ティラノザウル(北米の後期白亜紀の地層から発掘された肉食恐竜)
flamboyantly	けばけば
coracle	ヤナギの枝を編み獣皮を張った小船;アイルランドやウェールズの川・湖で用いる
slickness	ごまかし|詐欺|ペテン|つるつる滑ること|つるつるしていること
baptisia	genus of North American plants with showy flowers and an inflated pod
scrubland	an uncultivated region covered with scrub vegetation
gadabout	(刺激・楽しみを求めて)ほっつき歩く人
disproof	反証[すること]|反ばく;〈C〉反証物件
tootle	くだらないことをしゃべる|だらだらした話|笛などを吹く(こと･音)
airily	軽やかに;快活に|浮き浮きして
unseasoned	not aged or processed; "unseasoned timber"|not aged or processed|without salt or seasoning|not tried or tested by experience; "unseasoned artillery volunteers"; "still untested in battle"; "an illustrator untried in mural painting"; "a young hand at plowing"|not tried or tested by experience
primogeniture	長子であること|(またright of primogeniture)長子相続|長子相続権
congruity	〈U〉一致|適合[性]|調和;〈C〉《通例複数形で》一致点|〈U〉(数学で|図形の)合同
reline	〈コートなど〉‘に'裏を付け直す
hypermethylation	高メチル化
kinsfolk	宗族|一門|一族|家筋|眷族|眷属|家門|血族|氏族|家系
comportment	《文》ふるまい|態度
sphericity	球状
asthenosphere	アセノスフェア
satirize	風刺で攻撃する|皮肉る
unambitious	having little desire for success or achievement
essayer	企図者
thiothixene	チオチキセン
stonechat	野鶲
foulard	フーラード(柔らかく光沢のある布地)
reface	〜‘に'新しい表面をつける|〜‘の'表面を新しくする
getting	受け
khalif	=caliph
geebung	any of numerous shrubs and small trees having hard narrow leaves and long-lasting yellow or white flowers followed by small edible but insipid fruits
warmhearted	思いやりのある|心の温かい|親切な
cockiness	生意気|うぬぼれ|気どり
nonentity	非実在|取るに足りないこと(状態)
blandishment	ごきげん取り;甘言
gerbert	ゲルベルト
streetwalker	売春婦|街娼婦|町の女
remonstrate	(人に〜について)忠告する|抗議する《+『with』+『名』〈人〉+『against』(『about|over』)+『名』(do『ing』)》
actomyosin	アクトミオシン(筋収縮を起こす複合体蛋白質)
steatite	石鹸石
perspicuous	(言葉・議論などが)理解しやすい|明快な
nonuniformity	不均一性
getup	(物の)作り|体裁|身なり;(特に)いっぷう変わった服装
improvident	(経済的に)将来への備えを怠る
polygynous	一夫多妻の|(植物が)多雌ずいの
recco	reconnaissance (by shortening)
metrically	with regard to meter; "metrically, these poems are matched"|with regard to meter
tenuously	希薄に|貧弱に
webworm	several gregarious moth larvae that spin webs over foliage on which they feed
okeh	an endorsement; "they gave us the O.K. to go ahead"|an endorsement
nomogram	ノモグラム|ノモグラフ
luncheonette	軽食堂
carrycot	(乳児用の)携帯ベッド
rehear	(裁判で)〜‘を'再審理する
crookneck	首が長くねじれたカボチャ
prescript	規定|指令
muscularity	筋肉|腕力|力強さ|エネルギッシュさ|雄勁
benzoquinone	キノン
bonhomie	(仏語)気さく|人のよさ|温容|温厚|快活
overdress	〜‘に'はでな服装をさせる|はでな服装をする
industrialize	産業化する|工業(産業)化する
toughie	あばれん坊|不良|暴れん坊|不良少年|ちんぴら|チンピラ|苦手
inertness	不活溌
cleome	クレオメ|クレオメ
cowry	子安貝|タカラガイ
uncivilised	野蛮|蛮野
productiveness	多産性|生産力のあること
rickover	リコーバー
connate	類同
coelenterate	腔腸(こうちょう)動物
disestablish	〈既成の制度など〉‘を'廃止する|〈教会〉‘の'国教制を廃止する
atonic	characterized by a lack of tonus|used of syllables; "an atonic syllable carries no stress"|used of syllables
alcedo	type genus of the Alcedinidae
overact	大げさに演じる|演技し過ぎる|過剰な反応をする|やり過ぎる|演技過剰に陥る|必要以上のことをする
variorum	校異版(本);集注版(本)諸家の注を収めた|集注の　原典の異本を収めたラテン語「異なった(編者)の」の意
hallel	(Judaism) a chant of praise (Psalms 113 through 118) used at Passover and Shabuoth and Sukkoth and Hanukkah and Rosh Hodesh|a chant of praise (Psalms 113 through 118) used at Passover and Shabuoth and Sukkoth and Hanukkah and Rosh Hodesh
deliciousness	美味しさ
cherubic	＜cherub|ケラブ(智天使|9天使中の第 2 位で|知識を司る翼のある愛らしい天使)の|無邪気な
plasticize	become plastic, as by having a plasticizer added|make plastic, as by the addition of a plasticizer; "plasticized PVC"|make plastic, as by the addition of a plasticizer
yawp	吠える|喚く|吼える
cordate	(of a leaf) shaped like a heart
dephosphorylated	脱リン酸化
weldment	an assembly of parts welded together
pyracantha	トキワサンザシ属|ピラカンサ
brasier	large metal container in which coal or charcoal is burned; warms people who must stay outside for long times|large metal container in which coal or charcoal is burned|warms people who must stay outside for long times
anxiousness	気遣しさ|気づかわしさ|物思|気苦労|憂虞|鬼胎|気扱い|懸念|気懸かり|憂い|不安
spiderwort	ツユクサ|ツユクサ科
noninterference	不介入|無干渉|不干渉|内政不干渉|不関渉
birdbrain	《俗》うすのろ|まぬけ
relativize	consider or treat as relative
centrefold	センターフォールド
secobarbital	セコバルビタール
undoable	及びない|及び難い|及び無い|及びがたい|無理
bialy	ビアリ
rotatory	（形容詞）回転する(させる)　交代する　循環する　輪番の
glossolalia	repetitive nonmeaningful speech (especially that associated with a trance state or religious fervor)
psychosurgery	精神外科
erythroblastosis	赤芽球症
cnidarian	腔腸動物
versification	作詩;作詩法|格調|韻律の形式
egotistic	自己中心の|自分本位の|うぬぼれの強い
ephah	an ancient Hebrew unit of dry measure equal to about a bushel
incurably	不治で|矯正しようもなく
incontestably	疑いなく|明白に
sucrase	スクラーゼ
semiformal	セミフォーマル
unfaltering	とまらない|とどまることを知らない|ちゅうちょしない
defendable	capable of being defended
whippy	(茎・枝・棒などが)しなやかな|弾力性のある
lathi	club consisting of a heavy stick (often bamboo) bound with iron; used by police in India|club consisting of a heavy stick (often bamboo) bound with iron|used by police in India
loftiness	非常に高いこと|高尚|高潔|高慢|尊大
althaea	アオイ|タチアオイ|葵|木槿|槿|ビロードアオイ属|ムクゲ
predicable	断言(断定)できる
straightforwardness	the quality of being direct and straightforward; "what some people take for rudeness is really straightforwardness"|the quality of being direct and straightforward|without hypocrisy; "the singleness of his motives could not be questioned"|without hypocrisy
endosymbiont	細胞内共生
sculler	スカル(競走用の軽いボート)|スカルでこぐ人
appetitive	of or relating to appetite; "appetitive needs"|of or relating to appetite
megalomaniacal	suffering from megalomania
containerization	コンテナによる貨物輸送
hardtack	堅パン|乾パン
turreted	小塔のある|砲塔(銃座)のある|(巻貝など)塔状の渦巻のある
connotative	含蓄のある|(論理学で)内包的な
acrophobia	高所恐怖症
uxor	(legal terminology) the Latin word for wife|the Latin word for wife
morganite	a kind of pink beryl used as a gemstone
clownish	おどけ者めいた|こっけいな
overdraw	〈預金・割怒額など〉‘を'超過して借りる;〈小切手〉‘を'過振りする|〜‘を'誇張して描写する
childlessness	the condition of being without offspring
sterilise	殺菌|滅菌|無菌化|不妊化|去勢|断種
bagpiper	someone who plays the bagpipe
espousal	(支持|主義･説などの)支持|擁護|結婚|婚約
imperviousness	不可入性
pseudoobscura	ウスグロショウジョウバエ(ハエの一種)
animatedly	生き生き
djinni	魔神
madagascan	a native or inhabitant of Madagascar|of or relating to Madagascar or its people; "Madagascan pepper"|of or relating to Madagascar or its people
prehension	the act of gripping something firmly with the hands (or the tentacles)
aardwolf	striped hyena of southeast Africa that feeds chiefly on insects
factorize	resolve (a polynomial) into factors
heparinized	ヘパリン(抗凝結成分)化された cf|heparin
elaeagnus	oleaster
redound	(信用・利益などを)高める|増す《+『to』+『名』》
moodily	不機嫌に
solipsist	唯我論主義者|自己中心主義者
candyfloss	綿菓子
supination	回外運動
purgation	清めること|浄化;浄罪|便通[をつけること]
gastronome	食い道楽|グールメ|グルメ|エピキュリアン|美食家
snick	(はさみなどで)〜‘を'ぱちんと切り取る|〜‘に'刻み目をつける|(クリケットで)〈球〉‘を'切って打つ|ぱちっと切ること;刻み目|(クリケットで)球を切って打つこと
deathblow	致命的打撃|(〜を)終結させるもの《+『to』+『名』》
pollywog	=polliwog
annon	釈迦頭
hollo	=hallo
parapsychological	beyond normal physical explanation
haik	an outer garment consisting of a large piece of white cloth; worn by men and women in northern Africa|an outer garment consisting of a large piece of white cloth|worn by men and women in northern Africa
quarterstaff	六尺棒(昔の英国の武器;両端に鉄の金具がついている)
biodegrade	break down naturally through the action of biological agents; "Plastic bottles do not biodegrade"|break down naturally through the action of biological agents
transmittable	伝播性|伝染性
curette	a surgical instrument shaped like a scoop to remove tissue from a bodily cavity
redcap	《米》(駅の)赤帽(porter)|《英》憲兵
winepress	(ワインを作るための)ぶどうしぼり器(おけ)
closedown	(工場・商店などの)閉鎖|操業中止|《英》放送終了
forepart	(ある物の)前部;(ある期間の)初めの部分《+『of』+『名』》
amendable	修正可能な
hardheaded	がんこな|実際的な
ileitis	回腸炎
neurosyphilis	神経梅毒
crocodilian	extant archosaurian reptile
tidily	きちんと|整然と
seadog	《おどけて》年とった水夫|老練な水夫
scry	divine by gazing into crystals
pseudepigrapha	52 texts written between 200 BC and AD 200 but ascribed to various prophets and kings in the Hebrew scriptures; many are apocalyptic in nature|52 texts written between 200 BC and AD 200 but ascribed to various prophets and kings in the Hebrew scriptures|many are apocalyptic in nature
baroreceptor	圧受容器
odalisque	オダリスク|昔のイスラエル国の女奴隷
conferee	会議出席者|受領者|授与される人|相談相手|評議員
snappish	(犬など)かみつく癖のある|がみがみ言う|おこりっぽい
superannuate	〈人〉‘を'老齢(病弱)のため退職させる
berlage	ベルラーヘ
gangplank	道板(みちいた)(船から桟橋へ渡して客の乗降に使う移動式の橋)
parquetry	寄せ木細工|(床の)寄せ木張り
tiredly	疲れて;飽きて
stalking	ストーキング|つけ回すこと(他人の意思を構わぬ異常な行為)
sniffy	鼻であしらう|高慢な|軽べつした|《英》悪臭を放つ|臭い
accusingly	非難するように|なじるように|非難がましく
mesospheric	中間圏の
auklet	any of several small auks of the northern Pacific coasts
amiability	感じのよさ;気だての優しさ;温和;温厚
unaccepted	not conforming to standard usage; "the following use of `access' was judged unacceptable by a panel of linguists; `You can access your cash at any of 300 automatic tellers'"|not conforming to standard usage
shortening	ショートニング(舌ざわりをよくするためのバターやラードなど)
incapability	できないこと|不能|無能|不適格
psalmody	〈U〉聖歌吟唱[法]|〈C〉(符面つきの)聖歌集|賛美歌集
qadi	an Islamic judge
restrictiveness	不寛容
casualness	偶然|むとんじゃくさ;さりげなさ
cushiony	softened by the addition of cushions or padding
brinjal	茄子|ナス|茄
wickerwork	枝編み細工|柳細工
bindable	capable of being fastened or secured with a rope or bond
sloganeer	someone who coins and uses slogans to promote a cause|coin new slogans
kynurenine	キヌレニン|トリプトファンからナイアシンを生合成する際の中間体のひとつで|アミノ酸のひとつ
gussy	〈物・自分〉‘を'飾りたてる《+『up』+『名』|+『名』+『up』》
ballclub	球団
catholicos	the ecclesiastical title of the leaders of the Nestorian and Armenian churches
flavorless	薄い|味気無い|大味|味気ない
mispronounce	発音を誤る
maturational	relating to or involved in maturation; "maturational process"|relating to or involved in maturation
cabotage	the exclusive right of a country to control the air traffic within its borders|navigation in coastal waters
enduringly	in an enduring manner; "Roman culture was enduringly fertilized"|in an enduring manner
unwearied	飽かぬ
lechwe	tawny-colored African antelope inhabiting wet grassy plains; a threatened species|tawny-colored African antelope inhabiting wet grassy plains|a threatened species
standoffish	冷淡な|よそよそしい(aloof)
punctilious	作法にやかましい|形式ばった|きちょうめんな
attending	傾注|注目|注意|念|出仕|参列|臨場|臨席|参会|出席|来場|来臨|来会|御出座
egotist	自己中心癖の人|自尊家|利己主義者
baldhead	薬罐
metic	an alien who paid a fee to reside in an ancient Greek city
papaw	small tree native to the eastern United States having oblong leaves and fleshy fruit|fruit with yellow flesh; related to custard apples|fruit with yellow flesh|related to custard apples
bufferin	aspirin coated with a substance capable of neutralizing acid (trade name Bufferin)
reductant	還元剤
peregrination	旅行|遍歴
nuttiness	木の実が多いこと|木の実のような風味
subjectivist	主観論者|主観主義者
shanny	European scaleless blenny
electronegative	陰電気を帯びた|陰電性の
curbstone	(歩道の)縁石(《英》kerbstone)
squeezable	圧縮性
pyrope	a deep red garnet used as a gemstone
importunity	しつこさ;《複数形で》しつこい要求(嘆願)
androgyne	二形|双成り|雌雄モザイク|半陰陽
distractedly	散漫
heterochromatic	異色の
moil	あくせく働く
waxwork	ろう細工;ろう人形|《複数形で》《単数扱い》(特に有名人の)ろう人形博物館
untarnished	新鮮
mycostatin	ナイスタチン
ailanthus	ニワウルシ(羽状の葉と緑色の小さな花を咲かせる)
anomy	アノミー|アノミー
mealworm	ミールワーム
megakaryocyte	巨核球
bioclimatic	of or concerned with the relations of climate and living organisms
bewitch	に魔法をかける
commentate	make a commentary on|serve as a commentator, as in sportscasting
rottenness	貪汚|腐敗|黄白|汚職|悪徳|贈収賄|贈賄|収賄|汚濁
diplodocus	ディプロドクス
sentimentalism	感傷(感情)主義;涙もろさ
deglaze	dissolve cooking juices or solid food in (a pan) by adding liquid and stirring
multipotent	多分化能
ichor	イコル(ギリシア神話で神の体中を流れているとされる霊液)
saponaria	サポナリア
borderer	an inhabitant of a border area (especially the border between Scotland and England)
almandine	アルマンディン;鉄礬柘榴石(てつばんざくろいし)
eaglet	ワシの子
tinsmith	ブリキ屋|錫(すず)細工師
privily	ひそかに|内密に
noctilucent	shining or glowing by night; "the noctilucent eyes of a cat"|shining or glowing by night
ungenerous	物惜しみをする|けちけちする|不当な|不正な
dunnock	スズメ
monotreme	単孔動物
antimycin	アンチマイシン
medlar	西洋カリン(野生のリンゴのような実をつける小木;その実)|臭い人
particularistic	relating to particularism (exclusive interest in one group or class or sect etc.); "a particularistic-seeming statement"|relating to particularism (exclusive interest in one group or class or sect etc.)
desideratum	必要な物|なくては困る物
spectrophotometrically	分光光度法で
roquette	ルッコラ
sandhi	連音
unicyclist	a person who rides a unicycle
outbred	異系交配の
excursus	(本の巻末につけた)詳説|補説
gumma	a small rubbery granuloma that is characteristic of an advanced stage of syphilis
thermidor	テルミドール|フランス革命時|革命歴の11番目の月(7月と8月)を指す|熱月と呼称
exilic	of or relating to a period of exile (especially the exile of the Jews known as the Babylonian Captivity)
firethorn	トキワサンザシ属|ピラカンサ
endotoxemia	エンドトキシン中毒症|内毒素血症|エンドトキシン血症
ignominiously	恥曝し
indefeasible	not liable to being annulled or voided or undone; "an indefeasible right to freedom"; "an indefeasible claim to the title"|not liable to being annulled or voided or undone
staleness	unoriginality as a result of being dull and hackneyed|having lost purity and freshness as a consequence of aging
uncropped	not used for growing crops; "uncropped soil"|not used for growing crops
enviously	羨ましい
pipefitting	マフ
flashgun	閃光(せんこう)装置(カメラのシャッターを切ると同時にflash bulbを発火させる装置)
multilane	(of roads and highways) having two or more lanes for traffic
vermis	虫部
preadolescent	of or relating to or designed for children between the ages of 9 and 12; "a preteen party"; "preteen clothing"|of or relating to or designed for children between the ages of 9 and 12
brummell	ジョージ・ブライアン・ブランメル
cubital	of or relating to the elbow
bearwood	shrubby tree of the Pacific coast of the United States; yields cascara sagrada|shrubby tree of the Pacific coast of the United States|yields cascara sagrada
castanet	カスタネット
cockatrice	コカトリス(伝説上の怪物;頭・足・翼は鶏|胴と尾は蛇)
eccentrically	風変わりに|偏心(離心)的に
petaled	(of flowers) having petals
lipotropic	親油性
rearmost	最後尾の
spiritedness	活気
gimmickry	a collection of gimmicks
adenopathy	a glandular disease or enlargement of glandular tissue (especially of the lymph glands)
coffeecake	コーヒーケーキ(ナッツと干しぶどうを入れたケーキパン)
cabalistic	秘密
spendable	(used of funds) remaining after taxes; "spendable income"|(used of funds) remaining after taxes
viscountess	子爵夫人;女子爵
nonpersonal	lacking personality; "nonpersonal forces"|lacking personality
alocasia	アロカシア|アローカシア
conventionality	〈U〉型にはまっていること|月並み|〈C〉《しばしばthe conventionalitiesで》しきたり|風習|慣例
babka	a coffee cake flavored with orange rind and raisins and almonds
quicklime	生石灰|酸化カルシウム|化学式CaOで表される化合物
korzybski	コージブスキー
plethodon	type genus of the Plethodontidae
lychnis	ムシトリナデシコ|ハエジゴク
forthrightness	単刀直入|直情|真率|虚心担懐|直|赤裸|剥き出し
eery	不気味
saltation	一足飛|一足飛び|飛躍|一躍|ダンス|踊り|踊|舞踏|舞踊|舞蹈|舞|勢み|バウンド|弾み
nonradioactive	非放射性
firebase	砲兵隊基地|発射基地
uncommunicative	打ち解けない|話したがらない|無口な
borstal	感化院|少年院
sopranino	higher in range than soprano; "a sopranino recorder"|higher in range than soprano
kwashiorkor	severe malnutrition in children resulting from a diet excessively high in carbohydrates and low in protein
celestite	天青石
twelvemonth	1年(a year)
sarazen	サラゼン
undimmed	not made dim or less bright; "undimmed headlights"; "surprisingly the curtain started to rise while the houselights were still undimmed"|not made dim or less bright
broadminded	(心が)寛大な|偏見のない|心の広い(liberal)
faithlessness	虚偽|気まぐれ|不誠実
effectuation	実行|実施|施行
caecum	=cecum
contextualism	any doctrine emphasizing the importance of the context in solving problems or establishing the meaning of terms
myoma	筋腫
unchartered	not chartered
actinidia	マタタビ属
semitransparent	半透明
caesalpinia	small spiny tropical trees or shrubs; includes the small genus or subgenus Poinciana|small spiny tropical trees or shrubs|includes the small genus or subgenus Poinciana
elusiveness	雲霞
blurriness	不明瞭
latke	made of grated potato and egg with a little flour
wistfulness	あこがれの|ものほしそうな|物悲しいこと
pablum	a soft form of cereal for infants|worthless or oversimplified ideas
catlike	猫のような|ゆだんのない;足音を忍ばせた
sceloporus	spiny lizards
unappreciative	not feeling or expressing gratitude; "unappreciative of nature's bounty"|not feeling or expressing gratitude
munificent	非常に気前のよい|物惜しみをしない
phut	ポン|パン(なにかが破裂するようなにぶい音)
suppertime	夕食時
dovish	ハトのような|ハト派的な|穏健派の|hawkish
cesspit	汚物だめ|(一般に)汚い場所
reacquaint	もう一度慣れる|再びなじむ
eglantine	イバラ
bursal	relating to or affecting a bursa
digitalisation	デジタル化
greenroom	出演者控室|楽屋
arietta	アリエッタ
uncrowned	[まだ]王冠を戴かない（いただかない）|王位につかずに実権を持つ
faddish	一時的に熱中する(流行する)|気まぐれな
alosa	shad
futuristics	未来学
thinning	the act of diluting something; "the cutting of whiskey with water"; "the thinning of paint with turpentine"|the act of diluting something
upregulate	上方制御する
threnody	哀歌|悲歌|挽歌
thrombocytosis	increase in the number of platelets in the blood which tends to cause clots to form; associated with many neoplasms and chronic infections and other diseases|increase in the number of platelets in the blood which tends to cause clots to form|associated with many neoplasms and chronic infections and other diseases
malefactor	悪人|犯人
dotage	もうろく|老いぼれ
palliate	〈罪・過失など〉‘を'軽く見せかける|弁解する|(一時的に)〈病気など〉‘を'和らげる
euphonious	響きのいい|耳に快い|口調のよい
oxyacetylene	酸素アセチレン
approximative	アバウト|大雑把|おおざっぱ|大まか|おおまか|粗大|粗い|粗放
enterobacteria	腸内細菌
teenybopper	ティーニーボッパー(ロックやファッションに熱狂する少女)
internationality	国際主義|国際色
hydrophobia	恐水病;狂犬病(rabies)
starwort	繁縷|ノミノフスマ
neurolinguistics	神経言語学
prodromal	symptomatic of the onset of an attack or a disease
lusciously	旨く
orthoclase	正長石
radiolysis	放射線分解
predetermination	宿命|運命づけられていること
unmethylated	非メチル化
vocative	呼格(の)|呼びかけの
venturesome	冒険的な|大胆な|冒険好きな
miniaturise	design or construct on a smaller scale
plodder	とぼとぼ歩く人|こつこつ働く(勉強する)人
redactor	編輯人|編集する
muskmelon	マスクメロン(表面に網の目模様があり甘い果物)
dormy	in match play a side that stands as many holes ahead as there are holes remaining to be played; "he was dormie three and still lost the match"|in match play a side that stands as many holes ahead as there are holes remaining to be played
agrobiological	of or pertaining to agrobiology
suppuration	うみ|化膿
forcefulness	力強さ
unfermented	甘い
arioso	(music) a short recitative that is melodic but is not an aria|a short recitative that is melodic but is not an aria
amenability	the trait of being cooperative
radiopaque	not transparent to X-rays or other forms of radiation; "barium sulfate is radiopaque"|not transparent to X-rays or other forms of radiation
paternally	父として|父親のように
incomprehensibly	不可解にも
fusillade	一斉射撃|一斉攻撃
raveling	a bit of fiber that has become separated from woven fabric
shininess	輝かしさ|すばらしいこと
impassively	in an impassive manner; "he submitted impassively to his arrest"|in an impassive manner
ropeway	(工場・鉱山などの重量物運搬用)ロープウエイ
accouterment	アクセ|アクセサリ|装身具|佩物|アクセサリー|佩び物|装具
hogback	けわしい尾根|(地質用語で)丘
underclothes	下着|肌着(underwear)
solferino	紅粉|紅粉
banding	筋|縞模様|縞|縞模様|縞|ストライプ
axenic	(of experimental animals) raised under sterile conditions; "axenic conditions"; "germfree animals"|(of experimental animals) raised under sterile conditions|(used of cultures of microorganisms) completely free from other organisms; "an axenic culture"|(used of cultures of microorganisms) completely free from other organisms
parve	(ユダヤ教で)精進料理の(原料に獣肉や乳を用いない)
transliterate	〜‘を'字訳(音訳)する
neuropil	the complex network of unmyelinated axones, dendrites, and glial branches that form the bulk of the central nervous system's grey matter and in which nerve cell bodies are embedded
jabot	a ruffle on the front of a woman's blouse or a man's shirt
apresoline	ヒドララジン
hickock	frontier marshal whose adventures have become legendary (1837-1876)
unacceptability	unsatisfactoriness by virtue of not conforming to approved standards
bareheaded	帽子をかぶらない|無帽の|(敬意を表して)脱帽して|帽子をかぶらないで
hemstitch	ヘムステッチ(横糸または縦糸を数本抜きその部分をかがって|ハンカチ|テーブル掛けのへりを飾るかがり方)|〈布など〉‘に'ヘムステッチをする
moneylender	金貸し|金融業者|高利貸し|質屋
phenacetin	フェナセチン(鎮痛・解熱剤)
sego	セゴユリ(米西部産のユリの一種|球根は食用;Utah州の州花)
baffler	挫折(ざせつ)させる人(もの);困らせる人(もの)
lightshow	ライトショー(エレキバンドの伴奏によるライトを使った光のショー)
kopje	a small hill rising up from the African veld
goral	ゴーラル
dayflower	ツユクサ(小さい青色の花をつける1日咲きの植物)
cowpox	牛痘
fieldworker	a researcher who works in the field
atheroma	アテローム
psychrometer	乾湿球湿度計|乾湿計
anglerfish	チョウチンアンコウ|ロッテ|鮟鱇
peignoir	(婦人用)化粧着|部屋着;(水泳後・湯上りに着る)ガウン
astringency	収れん性(皮膚をひきしめる性質)|きびしさ|厳格
malnourishment	栄養不良|営養失調|栄養失調
glacially	by a glacier; "glacially deposited material"|by a glacier
chlortetracycline	クロルテトラサイクリン|オーレオマイシン
gunge	=gunk
bicyclic	having molecules consisting of two fused rings
dorsoventral	extending from the back to the belly
reship	積み替え
haemolysis	溶血
detraction	a petty disparagement|the act of discrediting or detracting from someone's reputation (especially by slander); "let it be no detraction from his merits to say he is plainspoken"|the act of discrediting or detracting from someone's reputation (especially by slander)
doubling	倍増|影武者
seaworthiness	凌波性
wastefulness	無駄遣い|乱費|無駄使い|無駄遣|不経済|徒費|むだ遣い|むだの多いこと|空費|徒銷|冗費|無駄遣い|乱費|無駄使い|無駄遣|不経済|無駄|徒費|徒遣い|徒爾
manihot	genus of economically important tropical plants: cassava
insufferably	たまらなく|我慢できなてほどに
copulatory	of or relating to coitus or copulation
harmfulness	有害|有害
aviatrix	女流飛行家
carbonado	an inferior dark diamond used in industry for drilling and polishing|a piece of meat (or fish) that has been scored and broiled
salaah	the second pillar of Islam is prayer; a prescribed liturgy performed five times a day (preferably in a mosque) and oriented toward Mecca|the second pillar of Islam is prayer|a prescribed liturgy performed five times a day (preferably in a mosque) and oriented toward Mecca
preposterously	ばかばかしいほどに|ばかばかしいほど|ばかみたいに|ばかげて
kinin	サイトカイニン
ironweed	any of various plants of the genus Vernonia of tropical and warm regions of especially North America that take their name from their loose heads of purple to rose flowers that quickly take on a rusty hue
antlion	the larva of any of several insects|winged insect resembling a dragonfly; the larvae (doodlebugs) dig conical pits where they wait to catch e.g. ants|winged insect resembling a dragonfly|the larvae (doodlebugs) dig conical pits where they wait to catch e.g. ants
draftee	調整された者|応召兵
coreid	a true bug
safecracker	金庫破り(《英》safebreaker)
viscum	type genus of the Viscaceae: Old World evergreen shrubs parasitic on many trees including oaks but especially apple trees, poplars, aspens and cottonwoods
unrepaired	unserviceable because necessary repairs have not been made
magneton	レアコイル
selaginella	type and sole genus of the Selaginellaceae; evergreen moss-like plants: spike moss and little club moss|type and sole genus of the Selaginellaceae|evergreen moss-like plants: spike moss and little club moss
heaver	てこ棒
asepsis	無菌状態
subserve	be helpful or useful
mucor	ケカビ
parlous	(国際関係など)危険をはらんだ|不安定な
pallbearer	(葬式で)棺のそばに付き添う人;《米》棺をかつぐ人
foreleg	(動物の)前脚
lenity	慈悲|寛容
acclimatise	get used to a certain climate; "They never acclimatized in Egypt"|get used to a certain climate
predestinate	=predestine
inkpot	インクつぼ|インクびん
lymphangioma	リンパ管腫
amenorrhoea	無月経
bowleg	内反脚
insolently	横柄に|のさのさ
muscleman	筋肉人間(特別な訓練により筋肉を発達させた人)|《米》暴力団員
uprightly	立派に|名誉に恥じないように
ineptly	不器用に|下手に|不適切に
imper	imperative
novobiocin	ノボビオシン
haematocrit	ヘマトクリット|ヘマトクリット
rewatch	再見する
nitrazepam	ニトラゼパム
neighborliness	隣人愛
cuspid	(人間の)犬歯
devilfish	コククジラ|オニイトマキエイ|イトマキエイ
chasuble	上祭服(ミサで司祭が着る袖のないゆったりした祭服)
angularity	〈U〉かどのあること|〈U〉やせて骨ばっていること|〈U〉ぎこちなさ;がんこさ|《複数形で》かど|ぎざぎざ
nephroblastoma	malignant renal tumor of young children characterized by hypertension and blood in the urine and the presence of a palpable mass
foeniculum	very small genus of aromatic European herbs with pinnately compound leaves and yellow flowers
shillelagh	(オーク製などの)こん棒
outvote	〜‘に'投票で勝つ
littleness	小ささ|ちっちゃさ|小|小ぶり|小形|小ささ
hypersecretion	excessive secretion
kabbalist	an expert who is highly skilled in obscure or difficult or esoteric matters|a student of the Jewish Kabbalah
undrinkable	unsuitable for drinking
regally	in a regal manner; "a regally appropriate representative"|in a regal manner
vituperative	ののしりの|痛烈な|毒舌を振るう
hepatotoxic	肝毒性
unsubstantial	がんじょうでない|もろい|弱い|実質(実体)のない;非現実的な|空想的な
thornless	lacking thorns
inwardness	霊性|精神性|真意
proselyte	改宗者;転向者|=proselytize
woodcreeper	キバシリ
lxxii	being two more than seventy
gazania	ガザニア
authoress	女流作家
illogically	不条理
starflower	common Old World herb having grasslike leaves and clusters of star-shaped white flowers with green stripes; naturalized in the eastern United States|common Old World herb having grasslike leaves and clusters of star-shaped white flowers with green stripes|naturalized in the eastern United States
decertify	cause to be no longer approved or accepted; "Carter derecognized Taiwan in 1979 after the U.S. recognized the People's Republic of China"|cause to be no longer approved or accepted
etiolate	(光をあてずに)〈植物〉‘を'白く生長させる
outmatch	(試合などで)〜‘を'負かす|〜‘より'まさる
cefoperazone	セフォペラゾン
pleasantry	冗談|おどけた言葉|礼儀上の言葉
squareness	方形|四角;直角であること|公正|正直;きちょうめん
orad	toward the mouth or oral region
bearnaise	a sauce like hollandaise but made with white wine and tarragon and shallots instead of lemon juice
chequebook	小切手帳|チェックブック
syllogistic	三段論法の;演繹(えんえき)的な
somberly	in a somber manner; "`That's sure bad news,' said Dowd, somberly"|in a somber manner
symptomless	無症候性
grounding	基礎
phlomis	any of various plants of the genus Phlomis; grown primarily for their dense whorls of lipped flowers and attractive foliage|any of various plants of the genus Phlomis|grown primarily for their dense whorls of lipped flowers and attractive foliage
denominate	に命名する
prizefight	懸賞のつきのプロボクシング試合
supremacism	the belief that some particular group or race is superior to all others; "white supremacism"|the belief that some particular group or race is superior to all others
ultraconservative	極端に保守的な(人)|超保守的な(人)
pubescence	思春期
dhoti	ドーティ(インドの男子が着用する腰布)
considerately	思いやりをもって|察しよく
temporalis	側頭筋
mintmark	a mark on a coin that identifies the mint where it was produced
captivation	魅惑
faultlessly	without a fault; in a faultless manner; "he solved all the problems faultlessly"|without a fault|in a faultless manner
redbreast	胸の毛が赤い鳥;(特に)コマドリ(robin)
longwinded	息の長く続く|(話・文章などが)長たらしい|冗漫な
archaebacterium	古細菌
kepi	ケピー帽(上が平らで筒型のフランスの陸軍帽)
pestilent	死をもたらす|致命的な|悪影響のある|《話》やっかいな|うるさい
dragee	silvery candy beads used for decorating cakes|sugar-coated nut or fruit piece|pill that is a sugar-coated medicated candy
companionway	(船の)甲板昇降口の階段
bafflement	挫折(ざせつ)|失敗
countrified	(人が)いなかじみた|やぼな|(けしきなどが)ひなびた
bountifully	in a bountiful manner
thebe	テーベ
pyelogram	an X ray of the kidneys and ureters
boringly	in a tedious manner; "boringly slow work"; "he plodded tediously forward"|in a tedious manner
appreciator	見巧者
myxedema	粘液水腫
airscrew	プロペラ
rhizophora	type genus of the Rhizophoraceae; a small genus of tropical trees and shrubs|type genus of the Rhizophoraceae|a small genus of tropical trees and shrubs
jollity	愉快|陽気
nugatory	無価値の|取るに足らない|効力のない
liking	好き|好み|お好|御好み|お好み|御好
transformant	形質転換体(外部からDNAを取り込んだりすることにより形質が変化した個体や細胞)
meteoritical	of or relating to or caused by meteorites
kalends	=calends
wastefully	無駄に|有り余るほどに
porkpie	《主に英》豚肉パイ
venography	静脈造影法
unmemorable	not worth remembering
atrociously	堪らなく|はなはだ|酷く|転た|ひどく
nitrify	〜‘を'硝化する|亜硝酸に変える|〜‘に'窒素[化合物]をしみこませる
amanuensis	筆記者|筆耕|写字生
dreariness	わびしいこと|退屈させること
crawdaddy	ザリガニ
downhearted	落胆した|元気のない
senselessness	無駄|無意味さ|真空
akhenaton	アメンホテプ4世
velum	軟口蓋;(動物の)菌膜;(クラゲの)縁膜
chessman	チェスのこま
masseter	咀嚼筋
trireme	(古代の)三段オールのガリー船
exotically	異国ふうに
ostracoda	seed shrimps
phenyltoloxamine	antihistamine included in some preparations used to treat coughing and nasal congestion
stalagmite	(鍾乳洞の床から上に成長していく)石筍
fearsomely	in a fearsome manner; "a sabre slammed fearsomely through the thicket in all directions"|in a fearsome manner
penetrable	貫ける;浸透できる;見抜ける;(〜を)貫く|(〜に)しみ込む《+『to』+『名』》
profiterole	a small hollow pastry that is typically filled with cream and covered with chocolate
notarize	authenticate as a notary; "We had to have the signature notarized"|authenticate as a notary
outguess	〜‘を'出し扱く|‘の'裏をかく
taproom	=barroom
gelsemium	ゲルセミウム
downbound	heading in any direction that is conventionally down; "a downbound channel"; "the downbound train"|heading in any direction that is conventionally down
gorget	襟章
mischance	不運|不幸|災難|不運な(不幸な)でき事
semisynthetic	人工的|人為的
meclofenamate	a nonsteroidal anti-inflammatory (trade name Meclomen) used to treat arthritis
infrasonic	可聴閾下
hospitably	あいそよく|手厚く
hymie	(ethnic slur) offensive term for a Jew|offensive term for a Jew
metaphysician	形而上学者
vulgarly	俗悪
bailor	the person who delivers personal property (goods or money) in trust to the bailee in a bailment
ascariasis	回虫症
muumuu	ムームー(特にハワイの婦人が着るゆったりした服)
inula	any plant of the genus Inula
insouciance	(仏語)むとんじゃく|平気|気楽な|心配のない|無関心
lasciviousness	欲情|好色
pompously	大げさに|尊大に
chasten	懲らしめる|鍛える|抑制する
promisee	a person to whom a promise is made
aldomet	メチルドパ
prosthodontist	a dentist who is expert in prosthodontics
discourtesy	〈U〉失礼|無礼|無作法|〈C〉無礼な行為|失礼な言動
infectiously	in a contagious manner; "she was contagiously bubbly"|in a contagious manner
pantaloon	《複数形で》19世紀に男性が着たぴったりしたズボン;《話》だぶだぶのズボン(baggy trousers)|《P-》(パントマイムで|道化役(clown)にからかわれる)老いぼれ役
velocipede	(足で地面をけって進む)昔の自転車;《古》《時にふざけて》自転車|《米》子供用三輪車
handwrite	〜‘を'手書きする
adsorptive	吸着性
palpitate	〈心臓が〉動悸(どうき)を打つ|どきどきする|《文》(〜で)〈人・体が〉震える《+『with』+『名』》
vagary	気まぐれ
foppish	(男･衣服など)おしゃれな|にやけた
ultrasonically	超音波的
palooka	a second-rate prize fighter
yardman	worker in a railway yard|a laborer hired to do outdoor work (such as mowing lawns)
extravascular	血管外の
reanimate	〜‘を'再び元気づける(勇気づける)|‘に'生気を与え直す
sunlamp	(医療などに用いる)太陽灯
scoffer	嘲笑する人
bioclean	有害な細菌が[ほとんど]ない
insanitary	非衛生的な|健康によくない(unhealthy)
ennoble	高尚にする
unsought	望まれない
silybum	small genus of east African herbs
grabby	欲深|貪欲|欲深い
arrivederci	さようなら
egomania	an intense and irresistible love for yourself and concern for your own needs
panegyric	〈C〉(人・物に対する)賛辞《+『on(upon)』+『名』》|〈U〉高い賞賛|(時に)法外な賞賛
bacchanalia	豪遊|乱痴気騒ぎ|オージー|飲めや歌えの酒宴|底抜け騒ぎ|どんちゃん騒ぎ
profanation	〈U〉神聖を汚すこと|冒瀆(ぼうとく)|〈C〉冒瀆行為
messuage	(法律用語で|付属の建物や庭園・土地を含む)家屋敷
intellection	思惟作用|大脳作用|思索|考えること|考慮|了簡|思慮|知的活動|思量|念慮
uvea	ブドウ膜
jinn	(イスラム教)精霊|幽鬼
boxershorts	ショーツ|猿股|下穿|パンツ|下穿き
mistranslate	〜‘を'誤訳する|誤訳する
cleavable	capable of being cleaved
landgrave	方伯
intermarry	(異なる人種･階級の人と)結婚する|近親結婚する
cantharis	=Spanish fly
synset	a set of one or more synonyms
scrod	flesh of young Atlantic cod weighing up to 2 pounds; also young haddock and pollock; often broiled|flesh of young Atlantic cod weighing up to 2 pounds|also young haddock and pollock|often broiled|young Atlantic cod or haddock especially one split and boned for cooking
quarterlight	car window consisting of a small pivoted glass vent in the door of a car
cuboidal	shaped like a cube
behaviourist	a psychologist who subscribes to behaviorism|of or relating to behaviorism; "behavioristic psychology"|of or relating to behaviorism
imprecation	祈ること|呪い
virtuously	高潔|高潔|純潔
inconceivably	真逆
disunite	〜‘を'分離させる|分裂させる|分離する|分裂する
aglet	metal or plastic sheath over the end of a shoelace or ribbon|ornamental tagged cord or braid on the shoulder of a uniform
highboy	脚付きの高い洋だんす
parky	(空気などが)ひんやりとした|冷たい
corncrake	ウズラクイナ(ヨーロッパ産のクイナ科の小鳥)
assiduity	一心不乱さ|一心さ
glossopharyngeal	舌咽
obscurantism	反啓蒙主義|教化(開化)反対|故意にあいまいにすること
carnality	欲情|好色
nonsexual	not having or involving sex; "an asexual spore"; "asexual reproduction"|not having or involving sex
tutorship	師門
astrodynamics	天体力学
lilliputian	リリパット島(Swift原作のGulliver's Travelsの中の小人の国)の|小人国の住民|小人|リリパット人|狭量な人|つまらない人
cive	アサツキ|チャイブ
murderess	(女の)殺人者
echovirus	エコーウイルス
emulsify	〜‘を'乳状(乳剤)にする
gallinule	ガリヌール(ガンの類の水鳥の一種;脚が長い)
whop	《話》〜‘を'強く打つ|《俗》(競技などで)〜‘を'完全に負かす|《米》ドシンと倒れる|強打|一撃
currawong	bluish black fruit-eating bird with a bell-like call
radicle	幼根|胚根
lymphogranuloma	リンパ肉芽腫
carminative	胃腸内のガスを排出する|駆風剤
deftness	手際がいいこと|熟練していること|熟練さ|ファシリティ|容易に行うこと|機敏さ|腕前|ファシリテイ|ファシリティー
anginal	of or related to the pain of angina pectoris
downscale	ダウンスケール
lengthways	=lengthwise
theatergoer	芝居好き
xcl	being ten more than one hundred eighty
atavism	隔世遺伝|先祖返り
counteraction	反作用|(計画などの)阻止|(薬の)中和作用
abominably	反発的|堪らなく|はなはだ|酷く|転た|ひどく
carcharodon	man-eating sharks
stupendously	to a stupendous degree; "stupendously ignorant people"|to a stupendous degree
lactogen	ラクトゲン
ectoparasite	外部寄生虫
ammoniacal	pertaining to or containing or similar to ammonia
cryolite	氷晶石
fruitfly	ショウジョウバエ
dronabinol	psychoactive substance present in marijuana; used therapeutically to control nausea associated with cancer therapy|psychoactive substance present in marijuana|used therapeutically to control nausea associated with cancer therapy
spuriously	in a false and spurious manner; "the lawyer argued spuriously that his client knew nothing of the burglary"|in a false and spurious manner
gouger	山師|詐欺師|ぺてん師|不徳漢
einsteinium	アインスタイニウム(放射性元素;化学記号は『Es』)
prepack	=prepackage
masdevallia	any of numerous orchids of the genus Masdevallia; tufted evergreen often diminutive plants whose flowers in a remarkable range of colors usually resemble a tricorn with sepals fused at the base to form a tube|any of numerous orchids of the genus Masdevallia|tufted evergreen often diminutive plants whose flowers in a remarkable range of colors usually resemble a tricorn with sepals fused at the base to form a tube
fornix	脳弓
oread	(Greek mythology) one of the mountain nymphs|one of the mountain nymphs
whinny	馬の鳴き声|ヒヒーン
astuteness	海千山千|世才|聡穎|海千山千|深み
conflux	合流
breadline	a queue of people waiting for free food
canonic	正準|正準|標準的|正準
fortuneteller	占い師
kneepad	ひざ当て
unbridgeable	not bridgeable; "a wide unbridgeable river"; "unbridgeable generation gap"|not bridgeable
darkish	薄黒い|黒ずんだ|黒味がかった
papilledema	swelling of the optic disc (where the optic nerve enters the eyeball); usually associated with an increase in intraocular pressure|swelling of the optic disc (where the optic nerve enters the eyeball)|usually associated with an increase in intraocular pressure
madia	genus of sticky herbs with yellow flowers open in morning or evening but closed in bright light
bungler	へまをする人|不器用な人
morula	桑実胚
gynoecium	雌器
autosome	常染色体
changeability	the quality of being changeable; having a marked tendency to change; "the changeableness of the weather"|the quality of being changeable|having a marked tendency to change
elkwood	small deciduous tree of eastern North America having creamy white flowers and large leaves in formations like umbrellas at the ends of branches
moistness	水気|湿気
petrify	〈有機物など〉‘を'石化する|化石にする|(恐怖・驚きなどが)〈人〉‘の'体を石のようにする|すくませる|〈有機物などが〉石化する|〈人が〉身をすくませる
riata	ラリアット|投げ縄
tetrazzini	テトラッツィーニ
pedagogics	教授法|教法|教育法
giddily	めまいがして|目が回って|軽薄に|うわついて
futurology	未来学
plastination	プラスティネーション
blastoderm	胚盤葉
industriousness	勤勉さ
mudder	a racehorse that runs well on a muddy racetrack
chiloe	the largest Chilean island and the only one to be settled; located off south-central Chile|the largest Chilean island and the only one to be settled|located off south-central Chile
humanization	ヒューマニゼーション
antbird	any of various dull-colored South American birds that feeding on ants some following army ant swarms
allopatric	異所的な|異所的種分化(ギリシャ語allos=other|patris=fatherland)|同じ生物学的集団に発生する隔離的な種分化
glaucomatous	緑内障の
myxomatosis	a viral disease (usually fatal) of rabbits
tumbledown	(建物など)今にも倒れそうな|荒廃した
dumpsite	捨て場|掃き溜め|あくた場|ゴミ捨て場|芥場|塵溜め|捨場
dustbowl	(砂あらしの吹く)黄塵(じん)地帯
overlayer	protective covering consisting, for example, of a layer of boards applied to the studs and joists of a building to strengthen it and serve as a foundation for a weatherproof exterior
charivari	a noisy mock serenade (made by banging pans and kettles) to a newly married couple
hauberk	(中世の戦士の)鎖かたびら
costimulation	同時刺激|共刺激の意
unspotted	《古》道徳的に潔白な|非の打ち所のない|はん点のない|まだらでない
rankle	苦しめる
unseal	〜‘の'封を切る|‘を'開封する;〜‘を'開く(open)
pratfall	尻もちをつく(こと)|ヘマ
dacite	デイサイト
sweetish	やや甘い
intuitionism	直観主義|数学的直観主義
unreformed	unaffected by the Reformation
undeservedly	in an unmerited manner; "the team chalked up another victory, the last one quite undeservedly, in my opinion"|in an unmerited manner
iamb	=iambus
antinomian	道徳律超越(廃棄)論者(キリスト教徒は福音書の中の神の恩寵によって道徳律に束縛されないと主張する人)
obscurantist	a person who is deliberately vague
airt	向け直す
splitsville	separation or breakup or divorce; "after 15 years together they are headed for splitsville"|separation or breakup or divorce
fiver	5ドル(ポンド)紙幣
prostyle	marked by columniation having free columns in a portico only across the opening to the structure
misinform	に誤りを伝える|誤解させる
promisingly	前途有望に
rebury	改葬
homarus	type genus of the family Homaridae: common edible lobsters
aggravator	an unpleasant person who is annoying or exasperating
victualler	an innkeeper (especially British)|a supplier of victuals or supplies to an army
bounden	義務的な|必修の
horrifyingly	ゾッとするほど|恐るべきほど|ゾッとさせるように
preciseness	明確さ|精密さ|適確|精度|精確|精密度|適確さ|正確さ|精緻|的確
harakiri	腹切り|切腹|腹切|割腹
unexampled	前例のない|空前の
interpenetrate	〜‘に'十分浸透(貫通)する|十分に(相互に)浸透(貫通)する
unarticulated	not consisting of segments that are held together by joints|uttered without the use of normal words or syllables
serape	セラーベ(ラテンアメリカで用いるはでな色彩肩掛けまたはひざ掛け)
stylization	慣習化|様式化|因襲化
cockspur	鴨茅
leniently	in a permissively lenient manner; "he felt incensed that Tarrant should have been treated so leniently given his crime"|in a permissively lenient manner
marocain	a dress crepe; similar to Canton crepe|a dress crepe|similar to Canton crepe
tearless	涙を流さない|泣けない|目にしみない
basely	卑劣
compart	句切る
absoluteness	絶対
fesse	(heraldry) an ordinary consisting of a broad horizontal band across a shield|an ordinary consisting of a broad horizontal band across a shield
chunnel	ユーロトンネル
accessary	=accessory
icily	氷のように冷たく|冷淡に
spatiality	空間性|空間的性質|空間特性|空間的特性
parallelepiped	平行六面体
dreg	a small amount of residue
acus	(acūs)|針(needle)|千枚通し
archimandrite	〈C〉修道院長|〈U〉独身のすぐれた聖職者に贈られる称号
unmodifiable	incapable of being modified in form or character or strength (especially by making less extreme); "these variations from custom are illogical, incomprehensible, and unmodifiable"|incapable of being modified in form or character or strength (especially by making less extreme)
macropus	type genus of the family Macropodidae: typical kangaroos and wallabies
vermiform	(形が)虫状の
preternaturally	超自然
paleobotany	古植物学
tackiness	ねばっこさ
provenience	発祥地|メッカ|揺籃
dishpan	洗いおけ
triggerman	a professional killer who uses a gun
symmetrize	make symmetric; "symmetrized waves"|make symmetric
bookstall	[古]本の露店|《英》(駅の)新聞[雑誌]売店(《米》newsstand)
hipbone	座骨|無名骨《腸骨・坐骨・恥骨からなる》
negress	a Black woman or girl
psychopathological	suffering from an undiagnosed mental disorder
adulterate	(粗悪なものを)〜‘に'混ぜて品質をおとす《+『名』+『with』+『名』》
tearsheet	(新聞･雑誌などの)はぎ取りページ
quaintness	the quality of being quaint and old-fashioned; "she liked the old cottage; its quaintness was appealing"|the quality of being quaint and old-fashioned|strangeness as a consequence of being old fashioned; "some words in her dialect had a charming quaintness"|strangeness as a consequence of being old fashioned
vamoose	急いで立ち去る
kleptomaniac	盗癖のある人
stoical	ストア派哲学の|禁欲の
tegument	おおい|外被(integument)
aptness	(〜の)適性|才能《+『for』+『名』》|(〜する)傾向|性向《+『to』 do》
salvor	someone who salvages
encopresis	involuntary defecation not attributable to physical defects or illness
sorcerous	魔法的
bacterially	by bacteria; "spreads bacterially"|by bacteria
malediction	《文》のろい|のろいの言葉(curse)
discreditable	不名誉な
zamia	any of various cycads of the genus Zamia; among the smallest and most verdant cycads|any of various cycads of the genus Zamia|among the smallest and most verdant cycads
unseeing	目で見ていない|気づいていない
bootee	婦人(子供)用の毛糸編みの靴
unwire	undo the wiring of
jellyroll	ゼリーロール(ゼリーを塗った渦巻き形のケーキ)
flyswatter	はえたたき
derisory	嘲笑すべき;取るに足りない|つまらない
ragi	シコクビエ
mutualist	相互主義者
portraitist	肖像画家|人物写真家
clonus	(病)クローヌス|間代(かんたい)性けいれん(ある種の神経病のため筋肉の収縮と弛緩が急激に交互に起る症状)
weedless	free from weeds; "a weedless garden"|free from weeds
rootlet	細根|小根
everglade	沼沢地
palaeontologist	古生物学者
fainthearted	気の弱い|臆病な
obsequy	葬式|埋葬式
perverseness	つむじ曲がり|つむじ曲がり
fireboat	消防艇
zarontin	エトサクシミド
trapshooting	クレー射撃|トラップ射撃
fishwife	魚売り女|がみがみ女
disconcertingly	面くらわせるほど|まごつかせるように
antipope	対立教皇(教会法に基づいて選挙された教皇に対立して教皇であると主張する人)
paparazzo	a freelance photographer who pursues celebrities trying to take candid photographs of them to sell to newspapers or magazines
pleadingly	折り入って|押して
jaywalker	(交通ルールを無視した)不注意な(乱暴な)横断者
gaud	安ピカ物
reassertion	再確認
steenbok	small plains antelope of southeastern Africa
oversell	売りすぎる|から売りする
groaner	a person who groans
bastardization	低下|堕落
upstroke	(特に)上へ向けた筆使い|(運筆の)はね
capturer	a person who captures and holds people or animals
paraphilia	性的倒錯
implausibility	信じがたいこと|本当らしくないこと
peristyle	(建物･庭などを取り囲む)柱列|柱列に囲まれた空間
witchdoctor	(原始社会の)まじない師|祈とう師
twirler	(バトンなどを)くるくる回す人
photosensitize	make (an organism or substance) sensitive to the influence of radiant energy and especially light
idolater	偶像崇拝者|(一般に)崇拝者|心酔者
publishing	出版する|出版業
porphyritic	斑岩(はんがん)の|斑岩のような
soldierly	軍人らしい|勇ましい|きりっとした
ictus	急病
navarino	a decisive naval battle in the War of Greek Independence (1827); the Turkish and Egyptian fleet was defeated by an allied fleet of British and French and Russian warships|a decisive naval battle in the War of Greek Independence (1827)|the Turkish and Egyptian fleet was defeated by an allied fleet of British and French and Russian warships
haematite	赤鉄鉱
prototypic	representing or constituting an original type after which other similar things are patterned; "archetypal patterns"; "she was the prototypal student activist"|representing or constituting an original type after which other similar things are patterned
handclap	拍手|手拍子
pongee	絹紬(けんちゅう)(生糸を使った薄茶色のややあらい絹織物)
methanogen	メタン菌
intercalary	間に入りこんだ|間に挿入された|(日・月・年が)うるう(閏)の
hammerlock	(レスリングで)腕固め(相手の片腕を背中にねじ上げる技)
biotinylation	(生化学)ビオチン標識|ビオチン化
undependable	覚束無い|不慥か|心許ない|頼り無い|頼りない|おぼつかない|覚束ない|心もとない|不確か
racialism	民族優越観|人種差別|人種差別主義 cf|racism
perquisite	《話》臨時収入;(合法的な)役得
concretion	〈U〉凝固;〈C〉凝固物|〈C〉腎臓結石
ontogenesis	成長|生育|成熟|化生|発達|個体発生|生長|発育|増殖|成育
refurnish	furnish with new or different furniture; "We refurnished the living room"|furnish with new or different furniture
danseuse	女子のバレエダンサー
partitive	部分を表す|〈C〉(文法で)部分語(any|few|someなど)
aftereffect	後遺症|残効
nafcillin	a penicillinase-resistant form of penicillin (trade name Nafcil) used (usually in the form of its sodium salt) to treat infections caused by penicillin-resistant strains of staphylococci
rapturously	in an ecstatic manner; "he reacted ecstatically to my plan to travel to Africa"|in an ecstatic manner
forelock	前髪
rhinorrhea	鼻漏
gormless	愚かな|間抜けな
cadetship	the position of cadet
anosmia	嗅覚消失
dadaism	a nihilistic art movement (especially in painting) that flourished in Europe early in the 20th century; based on irrationality and negation of the accepted laws of beauty|a nihilistic art movement (especially in painting) that flourished in Europe early in the 20th century|based on irrationality and negation of the accepted laws of beauty
zingerman	ジンジャーマン(ショウガ入りの焼きクッキー)
polygonatum	sometimes placed in subfamily Convallariaceae
polemonium	any plant of the genus Polemonium; most are low-growing often foul-smelling plants of temperate to Arctic regions|any plant of the genus Polemonium|most are low-growing often foul-smelling plants of temperate to Arctic regions
jauntily	のんきそうに|陽気に;元気に;気どって|いきに
declivity	下り勾配(こうばい)
nursemaid	子守女
reburial	改葬
gyroplane	オートジャイロ
demister	=defroster
moppet	人形|おちびさん|お嬢ちゃん|女々しい男
quirt	編み皮の乗馬むち