deputy	代理人|副～|代理|副|代理の
supplement	補足|追加|補遺|補角|を補う
probability	ありそうな事柄|ありそうなこと|蓋然性|見込み|公算|確率|可能性
petition	嘆願|請願(書)|申し立て(書)|を請求する|を願う
expense	支出
eligibility	適任|適格(性)|有資格
hub	(車輪の)ハブ|中心|集線装置
bread	パン
alien	在留外国人|異邦人|異星人
excel	しのぐ|優る
chase	を追う|を追跡する|を追い払う|追撃|狩り
subsequent	それに続く|その後の|次の|後に来る
viewer	見る人|見物人|検査官|テレビ視聴者|聴視者|観覧者
radiation	放射線|放射|輻射|放熱
shade	陰|光(熱)をさえぎるもの|陰影|わずかな違い|を陰にする|サングラス
grain	穀物|種子|粒|少量|1粒|グレイン|粒にする|木目
moral	道徳の|道徳的な|精神的な|教訓|品行
pride	プライド|誇る|自尊心|高慢|うぬぼれ|横柄|尊大|自慢の種|全盛
arrow	矢
hacker	ハッカー|他人のシステムへの不法侵入者
adequate	適した|適当な|適切な|十分な
trigger	誘発する|引き金|制動機|ばね止め|誘因|きっかけ
receptor	レセプター(受容体)
powder	パウダー|粉
hence	それゆえに|今から先|故に|今後
tap	こつこつ叩く|開発する|引き出す|栓を抜く|靴の音|飲み口|栓|蛇口|盗聴|電話盗聴(傍受)装置|盗聴する
entirely	全く
throat	のど|咽喉|喉|気管|食道
rider	ライダー
cure	を治療する|(悪い習慣など)を直す|治療法
ion	イオン
syndrome	シンドローム|症候群(病的諸傾向)|一連の事物(事件)|ある状況下での行動様式|病的現象
harbor	(考え･計画など)を心にいだく|をかくまう|港|避難所
closely	きっちりと|近く|親密に
seriously	真面目に|本気に|深刻に|重く|まじめに|まじめな話だが|ひどく
tail	尾|尻尾|尾状のもの|後部|下っ端|に随行する|見張り|尾行|尾行者|見張りの者
soap	せっけん|石鹸|を石鹸で洗う
pollution	公害|汚すこと|汚染|汚れ
leaf	葉
licence	許可する|に免許を許す|免許(証)|気まま|破格
pointer	助言|アドバイス|指し示す人|指摘者|むち|猟犬
remind	を思い出させる
hazard	危険にさらす|危険|冒険|偶然|運|災害|障害|要因となるもの
personality	個性|人物|人格|名士|人間であること|独特な雰囲気|テレビによくでる有名人
worship	礼拝する|崇拝する|礼拝|賛美|を崇拝する
elsewhere	他の場所に|他のところで|他のどこかで
insider	会員|インサイダー|企業部内者またはその内情を知っている人|内部者
effectiveness	有効
abroad	外国で|外国へ
urge	強く迫る|説得する
ebony	(ほめて)漆黒の|真っ黒の|黒檀(こくたん)(の)
cord	コード|紐
lifetime	生涯(の)|一生(の)
overseas	海外|海外の
hybrid	混成語|雑種|合いの子|ハイブリッド|混成物
relate	関係がある|を関係づける|を述べる|話す
vista	展望|眺望|ながめ|見通し|予想
tribe	部族|種族|一族
spare	スペア|貯え|手放す(to treat mercifully)|勘弁する|容赦する|出し惜しむ|を取っておく|を使わない
partial	一部分の|不完全な|一部(分)の|不公平な|とても好きな
beverage	飲料|飲み物
yoga	ヨガ|ヨガの行(瞑想的修行法)
whereas	･･であるのに
copper	(軽蔑的に)警官|銅|銅板|銅器|銅製品|銅貨
everybody	誰でも
succeed	成功する|あとを継ぐ|続く|継承する
treasure	大切にする|(思い出など)を取っておく|宝|財産|富|重要な物
sublime	気高い|崇高な|雄大な|卓越した|高尚にする|浄化される|(化学)昇華する
defend	防衛する|守る
counseling	カウンセリング
ordinary	普通の|ありふれた|直轄の
acceptable	容認できる
glad	うれしい
reception	receiveの名詞形|歓迎会|披露宴|聴取|応接|入会
nobody	誰も(一人も)～ない|(特に地位や財産のない)とるに足りない人
shareware	シェアウェア
plaza	(スペイン語)(都市の)広場|プラザ|市場
nova	ラテン語で新星の意味
romantic	ロマンテックな人|伝奇物語的な|ロマンチックな|実際的でない|非現実的な
wise	賢い|博識な|賢そうな|えらそうな|知らせる|教える
margin	利ざや|限界|余白|縁|余裕
stability	安定(性)
southwest	南西(部)|南西の|南西へ
cherry	サクランボ|桜
axis	中心線|軸
fragrance	芳香
grass	芝生|草|牧草|牧草の種をまく|(俗)マリファナ|大麻
institutional	組織的な
thermal	熱の|温度の|熱による|温泉の|暖かい
metabolism	代謝|新陳代謝|物質交代
independence	独立心|独立|自立|自活
warrant	正当な理由となる|を保証する|に請け合う|令状|証明書
harvest	収穫する|刈取る|報い|収穫|収穫高|収穫期|結果|取り入れる
cloudy	雲の|曇った
stupid	愚かな|ばかな
surround	を取り囲む|サラウンド
personally	個人的に|自分自身で|直接に|自分としては
acrobat	曲芸師
vital	きわめて重大な|致命的な|生命の|生命維持に必要な|活気のある
plenty	たくさん|豊富|多数|多量|豊富さ|十分に|たっぷり
excellence	優秀|卓越|長所|美徳
cheat	をだます|ごまかす|浮気する|詐取|カンニング|だますこと|ごまかし|詐欺師|不正行為
departure	新機軸|出発|発車|逸脱|背反|出航|門出|離脱
somewhere	どこかに|ある時|何時か|およそ
lucky	幸運な
wealth	豊富|富|裕福|財産
allocation	割り当て
survival	生存(者)|生き残ること
sole	唯一の|独占的な|独身の|足の裏|蹄鉄|シタビラメ|シタガレイ
acquire	を習得する|を獲得する
binary	二進法の
warrior	勇士|武人|武士|軍人
celebration	祝賀|式典
attendance	出席
diagram	図解
offset	分かれ|分派|オフセット(印刷)|埋め合わせ|相殺|相殺する
whenever	ときはいつも|いつであろうと|時はいつでも|いつ～しようとも|いったいいつ
resolve	疑問を解決する|に決心させる|決定させる|を決心する|を分解する|を解析する|を変化させる|決意|決断
duke	公爵
booty	盗品|戦利品|略奪品
necklace	ネックレス|首飾り
clerk	事務員
integer	(ínṭɪdʒɚ)完全なもの|完全体|(数学)整数|整数値
lovely	うっとりするほど|美しい|かわいらしい|楽しい|美しい女|美しいもの
founder	倒れさせる|浸水する|失敗する
monkey	サル|いたずら小僧|遊び回る|いじくる
casual	さりげない|くだけた|偶然の|不用意の|のんきな|臨時の|略式の|即座の
methodology	方法論
rebate	手数料|リベート
nest	に巣をつくってやる|巣|巣を造る|隠れ場所|悪事の温床
fairly	相当に|公平に|正しく|かなり|完全に|全く
coastal	海岸の
intelligent	知的な
rick	積みわら
regardless	かまわない|無頓着な|不注意な
aluminum	アルミニウム(金属元素)
approve	を承認する|賛成する|を気に入る
deserve	を受けるに足る|に値する
latter	後者|後の方の|近ごろの
transformation	変換|変形|変化|変容|変質|変態|変圧
advise	に忠告する|に助言する|通知する
triple	3倍の|3重の|三重の|三種類の|三塁打
intermediate	中間にある|中間の|媒介物|仲裁人|中間体
suspension	負債の返済不納|吊すこと|停止|宙吊り|未決定|停職
debug	除虫する|の欠陥を捜して直す|デバッグする|から盗聴器を取り除く
stamp	スタンプ|商標|切手|を踏みつける|をスタンプで押す
bookstore	書店
defence	弁護|守り
bra	ブラジャー
den	動物の住む穴|動物園の檻|住みか|書斎
announcement	発表|通知
observer	オブザーバー|観察者|観測者|遵守者|立会人
outcome	結果|成果
damn	強く非難する|呪う|呪い|ちぇっ|ちくしょう
passage	通過|通行|通路|旅行|一節|経過|通過帯域
cassette	カセット
jerry	肉体労働者|小型ピストル|安請負の|間に合わせの|貧弱な|室内便器|ハッと悟ること|よく分かっている
ah	ああ!
gulf	湾|裂け目|大きな隔たり|深い割目|深い穴|深淵
clay	粘土
shut	を閉める|を閉じる|閉まる|閉じた
cite	引用する|列挙する|を引き合いに出す|特記する
organ	オルガン|器官|機関|音声
regularly	規則正しく|きちんと|正規に|まったく|正式に
transcript	写し|複写|転写物|謄本
bat	コウモリ|強打
funeral	葬儀|葬式(の)|葬列|告別式
killer	殺し屋|殺す動物(器械)|殺人鬼
opt	選択する
shopper	買物客|(商店の)広告ビラ|広告専用雑誌
entrance	入口
bull	乱暴なことをする|がっしりした男|頑固な|強気筋|雄牛|雄|ブルドック
functionality	機能性
partly	部分的に|一部は|ある程度は|少しは|いくぶん
steal	を盗む|盗み取る
legacy	遺産|遺物|先祖伝来のもの|形見
construct	組み立てる|建築する|構築する
concentrate	集中する|集中させる
span	紡いだ(ぐ)|期間|長さ|(橋が)～にかかっている
grab	ひったくる|逮捕する|を横取りする|物をつかむ機械|わしづかみ|好意|猶予|気品
invitation	招待状|招き|招待|案内|案内状
ceramic	セラミック|製陶の|陶器の
tobacco	たばこ|刻みたばこ|喫煙
mint	ハッカ(入りの菓子)|造幣局|多額|源泉|鋳造する|ま新しい|未使用の
orientation	適応指導|方向(性)
stud	ちりばめる|びょう|埋め込みボルト|飾り釘|飾りボタン|プレーボーイ
pepper	唐辛子|コショウ(をかける)|ピリッとさせる|(文章などを)引き締める
marker	マーカー|マークする物|目印|採点者|記念碑
execute	芸術品を創作する|果たす|実行する|演奏する|契約を履行する|死刑にする
governance	統治(組織)|支配(権)|管理(方式)|被支配状態
loose	ゆるい|しまりのない|容器に入っていない|自由な|矢離れ|結末|成り行き|放つ
defeat	を打ち負かす|beat|敗北|失敗
chronic	慢性の|常習的な|長引く
bachelor	独身の男性|独身の男|学士 
trek	(長く苦しい)旅をする|小旅行|(特に難儀な)旅行
distribute	配送する|分配する|分布している
preliminary	予備の|準備的な|仮の|前置きの|発端の|序の|下ごしらえ|予備試験
glory	繁栄|栄光|誇り|壮観|荘厳
elite	エリート(層)|精鋭|精粋|選ばれた人びと|選良
bikini	ビキニ(水着)|ビキニ環礁(1946年から米国が核実験を行った)
geography	地理学|地形
optimize	最適化する|最も効果的にする
rose	バラ|淡赤色|美人|美貌|バラ色になる|riseの過去形
ourselves	我々自身で|の
wooden	木製の|木でできた|不器用な|無表情な|ぎこちない
analog	(=analogue主に英)|アナログ(の)|類似(の)|相似(の)|(肉･魚もどきの)合成食品
cigarette	巻きタバコ
adjust	(環境に)慣れる|を適合させる|調節してあわせる
gonna	(俗)するつもりの(going to)
bishop	ビショップ|司教|僧正
precision	精密な|正確|精密|細心|几帳面さ
silk	絹(の衣服)|絹の|やわらかな|ぜいたくな|絹糸|絹織物|(複数形で)絹の着物|(競馬の騎手の)制服
gospel	ゴスペル(宗教音楽)|福音|福音書|信条
afford	余裕がある|与える
capability	将来性|能力|可能性|手腕
reflection	反射|反映|熟考
herself	彼女自身
sad	悲しい
soundtrack	録音帯|サウンドトラック(音楽)|サントラ･ミュージック|サントラ録音|映画音楽|サントラ版
diesel	ディーゼル機関(船･車)
diverse	別種の|多様な|多様性をもつ
salon	サロン|(高級)店|客間|大広間
arc	弧(こ)
compile	を編集する|(資料など)を集める|(財産など)を作り上げる
nylon	ナイロン|ナイロンストッキング
remedy	を治療する|医療|治療|療法|医薬|救済策
discrimination	人種差別|識別
rehabilitation	社会復帰|名誉回復|復権|復興
atlas	『地図帳』|図解|表解
acoustic	電子機器を介さない|音響上の|聴覚の
railway	鉄道|軽便(路面)軌道
protest	異議の申し立て|に抗議する|抗議|異議|主張|言明|断言
oven	オーブン
ace	第一人者|切り札|最高位かそれに準じる者
noble	堂々とした|気高い|堂々たる|高貴の|貴族の|崇高な
assurance	保険|確かさ|確実さ|保証|請合い|言質|安定|安泰
shelter	避難場所|避難所|保護|を保護する|避難する
macro	マクロ
bundle	大金|包み|束|固まり|大量|小包
saver	貯める人|救助者
blvd	大通り|ブールバード
rev	エンジンを回転させる|回転
mood	気分|気持ち|憂うつ|雰囲気|法
engagement	約束|婚約
correctly	正しく
sauce	面白味|興趣を添えるもの|生意気(な言葉)|ソース|果物のシチュー煮|果物の砂糖煮|味を添えるもの
photograph	写真|を写真にとる
hood	ずきんをつける|ずきん|フード状のもの
marc	絞りかす|マール
theft	盗み|窃盗罪|窃盗(罪)|盗塁
pray	祈る
overnight	夜通し|一晩中|前夜の|一夜のうちに
drag	を引く|畑をならす|だらだら進む
integrity	正直|誠実|完全性|整合性
paradise	楽園|天国|地上の楽園|至福
buck	(俗)ドル|金|雄鹿|押す|がんこに抵抗する|木びき台|鋸(のこぎり)でひく
fence	柵|盗品買受け人|盗品買人|(野球)フェンス
detect	検出する|発見する|見破る|検波する
widely	広く|大きく
lookup	サーチ|検索
lat	緯度(latitude)|おもり|釣り合い
genuine	本物の|純種の|純粋の|心からの|真の|誠実な
cemetery	共同墓地
emotional	感情の|感動的な|感情的な|興奮した
isle	小島
pendant	ペンダント|つりランプ|シャンデリア|吊り輪|対の一方
bandwidth	帯域幅(通信用語)
versus	対|(訴訟･運動競技で)A対B|と対比して
lung	人工呼吸装置|肺
refuse	を断る|辞退する
coalition	(一時的な)連合|連立|一体化
geographic	地質学上の
migration	移住|移住者の群れ
negotiate	(条約締結など)交渉する|協定する|取り決める
promotional	昇進の
profession	専門的職業|職業(医師|弁護士など知的な専門職)
dawn	夜明け(daybreak)|黎明|夜が明ける|暁|明るくなる|発達しはじめる|分かり始める
blast	爆発(させる)|スリル|楽しい時間|突風|非難(する)|台なしにする|枯らす|explosion
disorder	無秩序|混乱|不調|乱雑|不規則|の秩序を乱す
machinery	(集合的に用いて)機械類|機械装置|機構
jimmy	(食用の)羊の頭|(強盗用の)金てこ|金てこでこじあける
dig	探求する|を探し出す|深く研究する|気にいる|掘る|土を掘る
authentication	立証|認証|特定情報へのアクセスの際|端末装置や個人を識別検証すること
dimension	容積|寸法|面積|次元
vulnerability	傷つきやすいこと|脆弱性
observe	観測する|述べる|守る
bicycle	自転車
correction	修正相場|訂正
slowly	ゆっくりと
reed	屋根のふきわら|ヨシ|アシ(の茂み)|リード楽器
rugby	ラグビー
gnome	(ギリシャ神話)ノーム(地の精)|しなびた老人|投機的銀行家
demonstration	デモ|実証|実演
admit	(いやなこと)を認める|に入ることを許す
propose	提案する|申し込む
trunk	トランク|主要な|(木の)幹･胴体|幹線|長距離電話|(象の)鼻
rip	激流|を詮索する|はぎ取る|引き裂く|切り取る|(話)やくざ馬(者)|がらくた|波浪の激しい水域
unlike	〜とは違った
technician	専門家|技術家
regime	政治制度|政権|制度|政体|体制
cooper	おけ屋
pi	(第16ｷﾞﾘｼｱ文字)パイ|π|Π 2|(数)円周率
praise	をほめる|ほめること|賞賛
quarterly	年4回の|季刊誌
convenience	便利なもの|都合|便利
enrollment	登録|入学
sunset	夕焼け空|日没|終局
continental	大陸の
proportion	比率|割合|釣り合い|調和|分け前|釣り合わせる
herald	告知する|予告する|報道者|先駆者|先触れ
directive	指令する
punk	パンクファッション(の人)|くだらぬもの|たわごと
tender	差し向ける|を提出する|を申し出る|入札する|支払う|気を使う|柔らかい|もろい|虚弱な|感じやすい|提供|(機関車の)炭水車
dialogue	(UK英語|US英語はdialog)対話
flexibility	柔軟性|屈折率
dive	飛び込む
steam	蒸気の|蒸気|水蒸気|スチーム|霧|もや|力
childhood	幼児期
prediction	予言|予想|予測|予報
lottery	めぐり合わせ|宝くじ|抽選|運
convenient	便利な
soup	スープ
bow	(発音 bάʊ) おじぎ|おじぎをする|屈伏する|服従させる|へさき|船首|犬の鳴き声(bow-wow)|(発音 bóʊ)弓
pal	仲良し|友人|友達|相棒|おい(呼びかけ)|仲良しになる|仲良く付き合う
wisdom	知恵|賢明|賢人|分別
kiss	軽く触れる|キス(する)|口づけ|軽い接触|砂糖菓子|(風が)軽く～に触れる
silent	沈黙した|静かな|無言の
gauge	標準寸法|規格|尺度|計器|レールの軌間(ゲージ)|判断基準|測る
literary	文学に通じた|文学の|文芸の
reset	リセットする
pill	丸薬|経口避妊薬|不愉快な人|弾丸|苦しいこと
knee	ひざ|膝|膝で押す(突く)
threshold	敷居|発端|始め|出発点|入り口
diameter	直径|倍率
meta	(ギリシア語)meta- 超等の意味の接頭語
payday	給料日|決算日
fake	ごまかし|いかさま|のふりをする|仮病を使う|ねつ造する|だます
injection	注射
starter	開始者|始動機|始める人(物)|スタート係|競争に出る人|セルモーター(和製英語)
donor	寄贈者|臓器提供者|開発援助供与国
juice	ジュース
xl	四十|４０
quit	をやめる|give up|stop
restoration	復旧|返却|復興|回復|返還
impression	気持ち|印象|感動|感銘|影響|結果|感じ
sur	シュール|超越した|現実離れした
broadway	ブロードウェイ
investigator	調査員
automation	オートメーション
harm	を害する|害|傷つける|損害|悪意
cooperative	協同組合の|協力の|共同～
bibliography	参考文献|文献目録
median	中央の|正中の|メジアン|中点
robin	コマドリ
confirmation	売買報告書|確認
suppose	仮定する|だと思う|だと想像する|もし～だとしたら
orchestra	オーケストラ|管弦楽団
intro	紹介(する)|イントロ|序|序奏
detector	発見者
zoo	動物園
corn	トウモロコシ|穀粒|穀草|魚の目
beaver	ビーバー
southeast	南東|南東部地方|南東に|南東から
opposite	反対側の|逆の|向かい合っている|〜の向こう側に
liver	肝臓|レバー|きも|茶褐色|の生活者
pending	差し迫った|懸案中の|未解決の|起ころうとしている|～まで
destruction	破壊|破滅
corp	法人|corporation
fool	ばか
collective	全体的な|共同の|集団の
sh	しー!
teenage	十代
constitute	構成する|制定する|の構成要素となる
inkjet	インクジェット
bubble	泡(立てる･立つ)|実態のないもの|みせかけ
decor	(仏語)装飾|舞台装置
unusual	異常な|一風変わった|珍しい|見かけない
spouse	配偶者
commodity	生活必需品|商品|必需品|日用品|有用品|物資
increasingly	ますます|more and more
subsidiary	子会社|補助的な|従属的な|付随する|支援する
basically	基本的に|根本的に
conventional	伝統的な|習慣的な|形式的な|きまりきった|協定上の
pierce	ピアスをする|を刺す|を貫く|に穴を開ける|突き進む
renew	を新しくする|を再び始める|を更新する|を再び満たす
deny	を否定する|を拒否する
fortune	社会的地位|富|財産|運|運勢|運命|幸運
canyon	峡谷
terror	(非常な)恐怖|恐ろしさ|恐怖の種|テロ
herein	この中に|ここに
occupational	職業の
programmer	プログラマー
judicial	裁判の
dump	ドシンと落とす|商品を投げ売りする|出力する|(恋人を)振る|ゴミ捨て場|dump truckダンプカー
opposition	反対|対立|抵抗
duck	アヒル(おしゃべり･あざむきの象徴)|かわいい人|ひょいと頭を引っ込める|かわす
arch	アーチ|弓形|主な|主要な|土踏まず
criticism	批判|非難|批評
toilet	化粧|便所|便器|洗浄|トイレ
shipment	積出し|発送(品)|船積み(荷)|積み荷
rough	手触りの荒いもの|でこぼこの|ざらざらした|毛深い|荒れた|未加工の|乱暴者|スケッチ|下書き
manufacture	を製造する|生産する|製造|生産|製品
artwork	イラスト|さし絵|図版|手工芸品など
basin	洗面台|たらい|洗面器
besides	〜の他にも
township	郡区|町区
collapse	失敗(する)|崩壊(する)|暴落(する)|衰弱(する)
quantum	量子
parish	教区(民)|郡|巡回区域|専門分野
grip	掴む|握力|握りかた|グリップ|支配(力)|理解力
observation	観察|所見|監視|観測|言葉|注目|発言
rabbit	ウサギ
cow	雌牛|乳牛|おびやかす|(intoを伴って)脅してさせる
doll	人形
disposal	支配権|配置|配列|処理|売却
thesis	論文|主張|議題|論題|題目|卒業論文|命題
entrepreneur	起業家|企業家|事業主|興行主|請負人|仲介者
documentary	ドキュメンタリー|文書の|ドキュメンタリー映画|事実を記録した|記録もの
knit	編んだ|組む|編む
proxy	代理(権, 人)|委任状|代用となるもの
verification	検証|査察
corps	軍団|部隊|兵団
aside	側に|別に
literacy	教育のあること|読み書き能力
pose	姿勢(ポーズ)をとる|気取る|のふりをする|(問題など)を提示する|姿勢|気取った態度|気構え
liable	責任を負うべき|義務である|法的責任のある|しがちな
assault	襲う(こと)|襲撃|突撃|暴行(未遂)|非難する(こと)
coal	石炭
pond	池|泉水|沼
quiz	に質問する|簡単な試験|質問する|クイズ|質問(する)
withdraw	取り消す|撤退する|回収する|を退場させる|閉じこもる
merge	合併する|合同する|同化吸収する|溶け込ませる|融合する
relay	新材料の供給|交替者|新手|換え馬|リレー
shine	光らせる|輝く|を磨く|光|cancel|blow off
odd	奇数の|余りの|～余り|残りの|時々の|片方の|半端な|妙な|変な
juvenile	少年少女(向き)の|若い|少年の|少女の
composer	作曲家
podcast	ポッドキャスト
texture	織り目|構成|生地
rainbow	虹
tin	スズ|ブリキ|すず製容器他
perception	知覚|認識
clone	クローンの|無性的に繁殖させる
stadium	スタジアム|競技場
aging	高齢化|時効|熟成|年(age)をとること|老化
fork	フォーク|分岐点
employ	を雇う|(方法･言葉など)を用いる|use
redeem	義務を果たす|を取り戻す|を買い戻す
fry	油で揚げる|電気椅子で処刑する|稚魚|(集合的)小さいもの(子ども･小動物)
attraction	魅力|引きつけるもの
bore	うんざりさせる|退屈なもの(人)|bear(産む)の過去形|掘る
carol	賛美歌|喜びの歌|キャロル
blame	を非難する|のせいにする|非難|責任
balloon	風船|ふくらむ
nose	鼻
involve	人を巻き込む|を含む|必要とする|意味する
chef	コック長
vast	広大な|巨大な|莫大な|巨額の
rapidly	急速に|速く|急いで
scout	スカウトする|捜す|斥候|スカウト
weird	超自然的な|奇妙な|風変わりな|変な|不思議な|運命の
disclose	暴露する
metropolitan	首都の|首都の住民|大都市の人
interact	互いに作用･影響しあう
condo	分譲マンション
cricket	コオロギ
intent	一心に向けた
jean	ジーンズ|ジーンズ用の布
exploit	開発する|搾取する
sigma	(第18ギリシア文字)シグマ|Σ|σ
showcase	模範|モデル|見本|陳列棚
exploration	探検|探求
combo	コンボ(小編成のジャズバンド)
phd	博士
tenant	借家人|借地人|居住者
benchmark	(価値判断などの)基準|水準点|基準テストにかける
mx	マクスウェル
textile	織物(の)|編み物(の)
membrane	薄膜|膜|皮膜|膜組織
ceremony	宗教儀式|儀式|式典|礼儀|作法
attractive	魅力的な
aggregate	集まった|骨材|集合|集める|統合する|総計～となる
electron	電子|宇宙を構成するレプトンに分類される素粒子|記号はe−で表される
recording	レコーディング|収録|録音|記録する|自動記録仕掛の
bee	ハチ|ミツバチ|働き者|(仕事, 娯楽の)会合|集まり
victim	犠牲|犠牲者|いけにえ|詐欺にかかった人|被災者
semiconductor	半導体
careful	注意深い
fleet	速い|艦隊|海軍|入江
commander	指揮者|海軍中佐
bite	刺激する|刺す|噛む|かみ切る
intention	ねらい|意図|意志|概念
spider	(動物)クモ|三脚台|フライパン
undertake	引き受ける|約束する|保証する|企てる
sword	武力|剣|刀|暴力|戦争
treaty	協定|条約(国家･政府間で締結される合意)|約束
burden	責任|負担|義務|荷|心配|重荷|積載力|荷物はこび|(重)荷を負わす
beef	牛肉|問題|不満
moreover	その上|なおその上に
amend	修正する|改める
minimal	最小の|最小
essay	随筆
polyphonic	(音楽で)対位法の|多声的な
suicide	自殺(する)|自殺者
adjustable	調整できる
conclude	と結論づける|を終わりにする|しめくくる
gym	屋内体操場|体育館|体操|体育
ranch	大牧場|農場|農園
fisher	漁師|フィッシャーテン(の毛皮)
pie	パイ(食べ物)|総額|楽なこと|カササギ
alphabetical	アルファベットの
camel	ラクダ|駱駝
rally	再び集める|元気づける|回復(する)|反騰(する)|大会|集会
bride	花嫁|新婦
tear	涙|引き裂く|tore(過去形), torn(過去分詞)
tracker	獲物を追う猟師|警察犬|追跡者|砲撃目標追跡装置|引き船|船引き人
complexity	複雑さ
fare	料金|運賃|旅をする|暮らす|ごちそう
midnight	真夜中|真夜中の
voluntary	自発的な|自由意志による|有志の|無償の
gel	ゲル|膠(こう)化体
greatly	大いに|偉大に
partition	区画|分割|分配|区分|分離|を分割する
potato	じゃがいも
compatibility	適合性|一致
commonly	一般に|通例|下品に|粗野に|通俗に|普通
pleasant	心地よい|楽しい|愉快な|好ましい|晴れて心地好い
syndicate	シンジケート|犯罪組織|通信社|をシンジケート組織にする|企業連合
exhaust	体力を使いつくす|仕事で疲れ切る|排出する|中身を空にする|水を排出する|排気|消耗
roommate	ルームメート|同室者
toner	インクトナー
highland	台地|高地|高原
grocery	食料雑貨類|食料雑貨店
largely	主として|大部分|大いに
rap	ノックする|こつんとたたく(こと)|(特に新聞の)非難|攻撃(する)|雑談|criticize|ラップ音楽(リズミカルに喋るように歌う方法)
cad	育ちの悪い男|ごろつき|不良|手伝いの人|地元の人|町の少年
snap	急な|即座の|パチン(と音をさせる)|ぽきんと折(れ)る|パクッ(とかみつく)|鋭い口調で言う|写真を撮る
lite	(=light)
inspector	工事監督者
dam	せき止める|ダム
oxygen	酸素|元素記号O
reputation	名声|世評|評判|好評
wedding	結婚式|結婚記念日|融合|結婚(式)
lawn	芝生
suddenly	突然に
scratch	スクラッチする|ひっかくこと|ひっかく|傷をつける|ひっかき傷
cookie	クッキー(焼き菓子)(俗)やつ|魅力的な女
merely	ただ|たかが～に過ぎない|ただ～だけの|単に
magnet	磁石|引付ける物
arrangement	準備|整理|配列|取り決め
cowboy	カウボーイ|牛飼い|(協定労働条件を破って働く)未組織労働者
bias	バイアス|傾向|偏向|心の傾向|先入主|偏見
swap	交換(する)
furthermore	その上|なおその上に
pit	くぼみ|穴|立坑|平土間(の観客)|囲い|に穴を作る
ranking	ランキング
puppy	子犬
tongue	演奏する|を舌で触る|なめる|舌|言葉|言語能力|言葉使い|国語
headquarters	本部員|本部|指令部|本拠|司令部(員)|本社
ruby	ルビー|ルビー色の|紅玉(7月の誕生石)|深紅色|赤ぶどう酒|真紅の|ルビ(振り仮名用の活字)
tumor	腫瘍|膨らみ|出っ張り
invoice	インボイス|送り状
roulette	(仏語)ルーレット
bench	ベンチ|法廷|裁判官
possess	を所有している
nomination	(特に官職の)任命|指名|指定|推薦
justify	正しいとする|正当化する
depend	依存する|次第で決まる|(文法)従属する
minimize	最小限にする|軽視する
medicare	高齢者向け医療保険制度
workforce	(作業)要員|総労働力|労働|労働人口
spotlight	スポットライト
payable	採算のとれる|支払うべき|支払うことのできる|支払満期の|もうかる
ferry	渡し場|フェリーボート|自力現地輸送する
opponent	反対者|対抗者|敵|反対する|敵対する
freeware	フリーウェア
delight	大喜びする|喜び|楽しみ|歓喜|楽しませる
horn	角製のもの|角|角で突く|触覚|警笛|ホーン
renewal	更改
salad	サラダ
floral	花の
fulfill	遂行する|fulfill(米語)|fulfil(英)
feeling	感覚|感じ|知覚|感情|情緒|思いやり|興奮
pig	ブタ(swineより家畜的な意味)|豚肉|ブタのようなやつ|あばずれ女|金属塊|子を生む
runner	密輸業者|競争者|走る人|集金人|運転者|羽根車|つる|(靴下の)伝線|客引き|カーペット
outer	外の|外側の|客観的な|圏外
shelf	棚|たな|棚の上のもの|棚状のもの
weigh	(重さを)量る|重荷になる|出航する|よく考える|重要である
parenting	子育て
legislature	立法府
commonwealth	国民|国家|共和国|民主国家
incredible	信用出来ない|うそのような|途方もない|驚くべき|信じられない
cabin	キャビン|小屋|船室
haven	(避難)港|停泊所|安息所|避難所
donation	寄付
tent	テント
hormone	ホルモン
slim	ほっそりした|わずかな|薄っぺらな|やせる|やせさせる
inclusion	包含
composite	混成の|合成の
accent	アクセント|口調|なまり
fellowship	友情|仲間
organizational	組織的な
canvas	研究調査する|遊説してまわる|選挙運動をする|カンバス|キャンバス|テント|麻布|帆布|ズック
amber	琥珀色|琥珀|琥珀色(こはく)色|黄色
trader	伝統的な|貿易業者
adverse	不利な|反対の
everywhere	どこでも
acute	鋭い|激しい|緊急の|急性の|ひどい|重大な
somebody	だれか|重要人物|大物|ひとかどの人物
jury	審査員団|陪審|陪審員団
digit	(おどけて)(人･動物の)指|アラビア数字|(数字の)桁
verse	詞|詩の一行|韻文|詩句|詩歌|詩を作る
envelope	包装材料|封筒|包むもの
chi	(第22ギリシア文字)カイ|Χ|χ
honest	素直な|ホントさ･ウソじゃないよ|正直な|正当な
hazardous	冒険的な|危険な|きわどい
tub	おけ|たらい|浴槽|入浴|～を桶に入れる
reload	再装填|再装填する|再びに荷を積む|再びに弾丸を込める|積み替える|補充する|リロードする
resistant	抵抗力のある
antibody	免疫体|抗体
locator	賃貸人|権利者|位置を示すもの
courtesy	礼儀正しさ|礼儀
lean	もたれる|曲げる|かがむ|(～に)傾く|頼る|収穫の少ない|やせた|やせている|乏しい|やせた部分|赤身の
fame	名声
attach	くっつける|付属させる
drain	排水|流れる|富を使い果たす|を飲み干す|を徐々に排出させる
symposium	シンポジウム
fusion	核融合|融解|融合|溶融|合併|連合|統合
tunnel	トンネル|地下道|坑道|穴|巣
anchor	錨|しんがり|定着させる|固定させる
companion	対の片方|仲間|相手|伴侶|話し相手|気の合った友
grave	刻みつける|重大な|厳粛な|くすんだ|墓穴|墓所
survivor	生き残った人|生存者|遺族|遺物|測量士|検査官|鑑定士
coin	鋳造する|貨幣|小銭
photoshop	フォトショップ
possession	所有|所持|占有|所有権|財産|領地
logical	道理にかなった|論理的な|当然な|論理学の
retrieve	検索する|引き出す|取り戻す|償う|回収する|回復する
phenomenon	現象|驚くべき物(事)|(複数形phenomena)
mathematical	数学的|数学(上)の|全く正確な|非常に正確な
authorization	権限の委任|承認
medal	メダル|勲章|記章|メダルを授与する
frequent	しばしば起こる|多い|頻繁な|たびたびの
diagnostic	診断の
offense	違反|罪･攻撃|侮辱|立腹|不快なもの
horizon	地平線|水平線|視野|展望
butterfly	蝶|チョウ|バタフライ(水泳)
confidential	信用のできる|機密の
statutory	法令の|法定の
align	並べる|一直線にする|提携させる|一列に並べる
northeast	北東部|北東へ|北東|北東の
filename	ファイル名|ファイルネーム
metric	メートルの|メートル法の|測定基準|距離関数|韻律学
painting	塗る|絵(を描くこと)|画法|ペンキを塗ること|塗装|水彩画|油絵
assign	を割り当てる|指定する|任命する|当てがう
cloth	ラシャ|布|織物|布地|幕|服地
smell	匂いがする|を匂う|香り|匂い
testimony	証言|証明|立証|証明書
deployment	展開
termination	終了|接尾辞
hawk	タカ|鷹|タカ派|強硬論者|他人を食い物にする人
neutral	えこひいきしない|中立の|はっきりしない|中立者|ニュートラル|灰色っぽい
protective	保護の|保護用の
slope	傾斜する|坂|傾斜(する)|に勾配をつける
tattoo	帰営らっぱ(太鼓)|ドンドン(コツコツ)たたき続ける音|入れ墨(をする)|彫り物
afraid	心配して|怖がって
royalty	王室の人々|王族|王の身分|王位|王権|荘厳|著作権使用料|管轄権|採掘権|印税
initially	初めに|はじめ(のうち)は
indicator	メーター|指示薬|ウィンカー|方向指示灯
queue	行列して待つ|待行列|列|おさげ髪
cave	陥没する|ほら穴|横穴を掘る
priest	聖職者|司祭|祭司|奉仕者
geek	(生きたヘビや鶏の首を食いちぎってみせる)奇態な見せ物師|(俗)変態|異常者|酔っぱらい
preference	好み|好物
civic	市民の|市の
heel	のすぐ後に続く|かかと|かかと状のもの
compression	圧縮
separation	分離|離脱|分類
railroad	鉄道
flu	インフルエンザ
coupon	クーポン|回数券|利札
reject	(提案など)を断る|拒絶する|turn down
activation	アクティベーション|活性化
astronomy	天文学
complain	苦情を言う|不満を言う
ribbon	インクリボン|リボン|飾りひも|ひも状のもの
litigation	訴訟|起訴
paste	をのりではる|ねり物|ペースト|のり|練り粉
scroll	スクロールする|巻き物|渦巻模様
spice	スパイス|香辛料|薬味|趣|に香辛料を加える
abortion	人工中絶|堕胎|流産|早産|(器官の)発育不全
seasonal	季節の
amplifier	増幅器
mixture	混合体|混合物|混合|交錯
burner	バーナー
poet	詩人|歌人
spectacular	見ものの|見せ物の|壮観な|あっといわせる|はなばなしい|豪華ショー
farmer	農場主
junction	連絡駅|連結|接合(部)|ジャンクション|はね橋|接合器|接点|多重ノード
constitutional	保健のための|構成上の|体格の|体質の|生まれつきの|憲法上の|合法的な
comp	植字工|伴奏(者)|無料招待客|植字工として働く|の伴奏をする|組む|無料招待にする
mobility	流動性|機動力|機動性|移動性
perfectly	完全に|申し分なく|まったく
borrow	を借りる
instantly	ただちに
gen	generalの省略形
prospective	見込みのあった|将来の|期待される
horizontal	地平線の|水平の
gem	宝石|逸品|珠玉|〜を飾る
unlock	の錠をあける|を開く|打ち明ける|鍵が開く
breath	息|呼吸
volt	ボルト(電圧の単位)
ordinance	法令|布告|儀式|しきたり|条例
galaxy	(銀河系外の)星雲|(貴人･美人などの)華やかな集まり
olive	(色)オリーブ|薄緑色|オリーブ色|薄緑
informational	情報の
ethical	倫理の
friendship	友情
organizer	組織者|創立委員|世話人|まとめ役|(興行などの)主催者|(労働組合などの)オルグ
coordination	(文法)同格関係
pickup	集めること|便乗者|かりそめの知り合い|好転|実況放送|間に合わせの
bunch	仲間|一団|群|(果物などの)房
freeze	凍る|凍らせる|氷結→凍ったようにピタッと動きを止める
ultimately	最後に|ついに|最終的に|究極に
predict	を予言する|を予報する
tackle	取組む|タックル(する)|道具|ろくろ
procurement	斡旋|獲得|入手|周旋|達成
equally	同等に
artificial	人工の|不自然な|模造の|人為的な|人造の|人工的な
intend	(～する)つもりだ|意図する
turner	とんぼ返りをする人|フライ返し
playlist	プレイリスト
herbal	ハーブの|(薬)草の|草本の|植物標本集
arrest	逮捕する|引き止める|阻止する|逮捕(=apprehend)
guilty	罪の意識がある|有罪の|罪を犯した|犯罪的な
passport	パスポート|旅券
scream	鋭い叫び声をあげる|叫び|悲鳴をあげる|金切り声をだす
naturally	生まれつきに|自然(天然)に|生来|もちろん
strand	座礁する(させる)|岸に上がる|立ち往生する|取り残す(される)|より糸|房
underwear	下着|はだ着
overcome	に打ち勝つ|を克服する|(受け身で)参っている
cod	タラ|鱈
hdtv	高精細度テレビジョン放送|高品位テレビ|高精細度テレビ|高精細度テレビ放送|ハイビジョン放送|ハイビジョン|HDTV
bracket	ひとまとめにする|括弧でくくる|腕木|腕金|張出し棚受け|電灯受け
joke	からかい|冗談
violent	乱暴な|強烈な|暴力的な|暴力による|こじつけの
potentially	潜在的に
mold	形作る|(に基づいて)作る|土|沃土|肥土|型|鋳型|流し型|骨組み|鋳物|性質|カビ
inclusive	包括的な
dimensional	次元の
considerable	少なくない|かなりの|相当の|重要な
compiler	コンパイラー|編集者|編者|編纂者
byte	情報量の単位|1バイトは2進数の8桁|即ち8ビット(bit)を意味する
latex	乳液|ラテックス
surgeon	外科医|(海軍の)軍医|船医
anymore	(否定･疑問･条件節で)もはや|これ以上
holding	続く|保有の
sender	送り手
bullet	弾丸
pantyhose	パンティストッキング
rebuild	再建する
bust	(女性の)胸部|破裂させる|破産させる|追っ払う|飲みすぎ|強打|失敗
quilt	掛け布団|キルト|キルトを編む
rocket	のろしを上げる|暴騰する|ロケット|ロケット弾|のろし|打ち上げ花火
honey	はちみつ
snowboard	スノーボード
cookbook	料理の本|詳しい解説書
therapeutic	治療の|療法の|心の健康に良い
airfare	航空運賃
mart	市場|商業中心地|競売室
velocity	速さ|速力|速度|迅速さ
sculpture	彫刻をする|彫刻する|彫刻|彫刻作品
addiction	熱中すること|夢中になること|-中毒
constantly	絶えず
nursery	子ども部屋|育児室|苗床|養成所|(悪の)温床|託児所
microwave	マイクロウェーブ|電子レンジ
presidential	大統領の
rocky	ふらふらの|グロッキーの|岩のような|頑固な
dock	ドックに入れる|ドッキングする|(植物)スカンポの類
authentic	信頼できる|信憑性のある|本物の
deer	シカ|鹿
butter	バター
thru	(米略式)through
vaccine	ワクチン(の)|痘苗(の)
loud	大声の|大声で
divide	割る|分割する
lobby	ロビーに出入りする|議員に働きかける|の通過運動をする|圧力団体|ロビー|大廊下
silence	沈黙|静けさ|黙祷|を沈黙させる|を静める
cv	履歴書
hospitality	親切なもてなし|歓待|心優しい
anybody	だれでも|全ての人|誰か
untitled	無題(の)
frog	カエル|フランス人
prerequisite	前提条件の|必須の|あらかじめ必要な|必須要件|前提条件
transexual	トランス系|トランス系
enforce	押しつける|実行する|執行する|を強制する|強化する
plaintiff	原告|起訴人|民事訴訟の原告
surveillance	(容疑者や敵の)監視|見張り|見渡す|調査する|監督
theoretical	理論的な
civilian	一般市民の|一般人|文民の
genealogy	系図(学)|家系|血筋|系統|系譜|血統|系統学
tray	盆|受け皿|料理をもった皿
exotic	異国(風)の|外国(産)の|外来の|異国情緒の|風変わりな|魅惑的な|外来の物|外人(ｲｸﾞザﾃｨｯｸ)
omega	(第24ギリシア文字)オメガ|Ω|ω|最後(のもの)
optimal	最良の|最適の
distinct	はっきりした|全く異なる
brilliant	きらきら輝く|すばらしい|才気のある|きらめく|みごとな|立派な
arrange	手はずを整える|手配する|を配列する|整理する
brick	れんがを敷く|れんが
enzyme	酵素
myth	作り事|神話|誤った社会通念|根拠のない説
knock	たたく(音)|酷評する|トントン叩く|強打する|(野球)ノック
hopefully	希望をもって
flip	はじく|軽く打つ|弾く|ポンと打つ|宙返り|(アザラシ等の)ひれ足
helmet	ヘルメット
raid	急襲(する)|引き抜き|襲撃(する)|侵略|奇襲|手入れ|かき乱す|attack
accommodate	便宜を計る|親切にする|に金を融通する|供給する|適応させる|和解させる
snake	陰険な人|くねる|ヘビ|くねって歩く|をくねらせる
correspondence	文通|通信|交通
turbo	turbochargerターボチャージャー|内燃機関の熱効率を高めるために利用される過給機の一方式
um	えーと|うーん|ほー|ふむ|いや|へー
dialog	(UK英)dialogue|対話|問答
punch	に穴をあける|を殴る|一撃|パンチ|穴開け器|穿孔機
thereof	その|それの
pillow	枕|まくら(をする)
rebel	謀反|反逆者|謀反を起こす|調和しない
consist	構成されている|存在する
intensity	緊張|強烈にする
dale	(広い)谷|盆地|人名
repository	貯蔵所|倉庫|納骨堂|埋葬所|(知識などの)宝庫
traveller	旅行者|(US英)traveler
comparative	匹敵する|比較の|(文法)比較級
reunion	再結合|再会|親睦(しんぼく)会
wanna	したい|(=want to 口語)
architectural	建築の|建築学の
bronze	青銅|ブロンズ
rim	リム|へり|枠|ふち
invention	発明品|発明|創案|考案
closure	締切り|閉店|閉鎖|締め切り
virtually	事実上|実質的には
maple	カエデ|楓
tale	物語|話|作り話
depot	バス停|空港|倉庫|貯蔵物|補給所
formerly	以前は
deviant	外れた|逸脱した|変質者
strictly	厳密に(言えば)|厳しく|きっちりと
psychological	心理的|心理学の|心理学的な|精神的な|心理的な
mason	石工|石で建てる|れんが職人
slice	ひと切れ|一枚|を薄く切る|薄切り1枚|部分|を薄く1枚切り取る
emphasize	を強調する
elegant	気品のある
connectivity	接続性
indie	インディー|音楽の一つのジャンル|独立プロダクション|自営の
microphone	マイク|マイクロフォン
correlation	関連|相関|相互関係
soldier	軍人|軍人になる|兵士|兵役につく
illustrate	を明らかにする|説明する|例証する|挿絵を入れる|図解する
depart	規則から逸脱する|立ち去る|出発する|軌道からそれる|この世を去る
allergy	アレルギー
similarly	同様に|類似して|同じく
ted	広げて干す
solely	ひとりだけ|ただ一人で|たんに
radical	過激な|急進的な|すぐれた|根本の|急進党員|過激論者
cab	タクシー
backpack	バックパック(を背負って自然に親しむ)(枠付きリュック)
reminder	思い出させる人･物|記念物|注意|助言|催促状
cargo	船荷
collaborative	共同の|共同作業の|合作の
chuck	軽くたたく|捨てる|放棄する
atomic	原子の
declare	を宣言する|を明言する|を申告する
cancellation	取り消し
mandate	の統治を委任する|命令|為政権|指図|委任統治
demographic	人口統計学の
cylinder	シリンダー|円筒
hammer	たたく|を槌で打つ|槌|金槌|ハンマー
rover	立ち見の人|漂流者|流浪者|海賊|歩き回る人
suggestion	提案|暗示
uncertainty	不確実さ|疑い|半信半疑|不確定|不安
intensive	強い|強調の|集約的な|(文法)強意の|強意語
spark	火花を出す|スパーク|火花(を散らす)
worm	虫|寄生虫|虫けら|苦悩|徐々に進む|寄生虫を取り除く
fragment	破片|断片|かけら|小部分|断章
sensitivity	思いやり|神経のこまやかさ|感度|感性
significance	意義|重要性
tri	3を意味する接頭語
syndication	シンジケーション
tutor	家庭教師|個人指導教授|に教える
identifier	識別子
cedar	ヒマラヤスギ|(cedarは日本のスギとは違い|ヒマラヤ杉などマツ科のもの
anxiety	心配
drawing	引く|製図|素描|鉛筆で描く絵
approx	約
duplicate	複写する|写し
blanket	一面に覆う(もの)|毛布(で覆う)|全体的な|包括的な
supervision	管理|監督|指揮|監視
foam	泡|あぶく|泡を出す|あわ消化剤
performer	行為者|役者|行う人|演奏者|俳優|曲芸師
noon	正午
sweep	さっと通過する|を一掃する|掃除する|(～を)掃く|を掃いて集める|圧勝する|大勝する
dividend	公債利息|(株の)配当金|配当(金)|分け前
elder	年長者|年上の 2|ニワトコ
sandy	砂(色)の|砂色の|砂のような|砂だらけの
imperial	荘厳なる|皇帝の|帝国の|皇室の|壮麗な|皇帝(皇后)(の)
disagree	意見を異にする|と一致しない|相違する|口論する
mandatory	強制的な|命令の|統治を委任された|委任の
rope	投げなわ|ロープ|なわ|一連
disable	身体的障害のある|injured
crucial	決定的な|きわめて重要な|ゆゆしい|致命的な|十字形の
cop	警官|ポリ公
adjacent	隣接した|付近の|近接した|直前の
indication	指示|暗示|兆候
tuition	授業料
lemon	レモン|(俗)欠陥品|不良品|きずもの
merit	長所|手柄|に値する
offensive	不快な|いやな|攻撃|攻勢|無礼な|攻撃的な
notion	心に思うこと|概念|観念|意向|意志|考え
salmon	サケ|鮭|鮭肉(の)|鮭肉色(の)
alt	アルト(の)|中高音(の)
surgical	外科手術の|外科医の
timer	タイマー
calm	落ち着いた|静める|冷静な|平穏な|静かな|無風の|穏やかな
dare	あえて～する|に立ち向かう|挑戦|あえてすること
glen	谷間|(G-)グレン(人名)
yo	やあ
swim	泳ぐ
lotus	ロータス|蓮|ハス(の実)|ロートス(伝説の木)
biotechnology	生命工学|生物工学|バイオテクノロジー|人間工学|ergonomics
brunette	(女)ブルネットの
daddy	お父さん
bless	を神聖にする|感謝する|祝福する|恩恵を与える|清める|恵む|賛美する|十字を切る|祈る
pledge	誓約|質入|乾杯|を誓う|人質|保証する
actress	女優
toxic	有毒な|中毒の
weapon	対抗手段|武器|兵器
boom	にわか景気|オイルフェンス|とどろく音|ドカーン|ブンブン
luggage	(UK英)(集合的)手荷物|旅行かばん
squad	班|隊|団|分隊|チーム
honour	honorの英国綴り
exempt	免れさせる|免れた|免除する|免疫の|免属の|免税者
stimulate	を刺激する|を元気づける
stylish	流行の|上品な
divine	神聖な|神の
customise	カスタマイズ|カスタマイズ
autumn	秋(=fall)
reel	リール|糸巻き|動揺する|よろめく|ふらつき歩く
miniature	模型|小模型|ミニチュア|細密画|小型の
victor	勝利者|征服者
offshore	沖合い|沖で|(風など)沖に向かう|海外の
bolt	稲妻|かんぬきで締まる|ふるいわける|ボルトで締める|かんぬきをかける|(B-)人名
occasionally	たまに|時折
jail	刑務所|投獄する
emission	排出|放出|排気|放射|発射
spec	思惑|投機|演芸|仕様明細書
fountain	泉
realty	不動産
apparent	明らかな(叙述用法:apparent to, apparent thatなど)|外見上の(限定用法:be apparent)
instructional	教育の
outreach	奉仕活動
traveling	移動
graduation	卒業
gig	ジャズ演奏の仕事|競漕用ボート
integral	完全な|欠くことのできない|総体
parade	行列|見せびらかし|を行進する|を見せびらかす
exterior	外側の|外の|外観|外部の
roller	(地ならし･印刷･圧延用)ローラー|大波|ヘアカーラー|ローラーカナリア
shed	(血や涙を)流す|を脱ぐ|(動・植物が)葉・角・皮・毛・羽などを(自然に)落とす|生えかえる|脱皮する|(体重)を落とす|倉庫|小屋|車庫
canal	運河
excuse	言い訳
fraction	破片|一部分|端数|比|割合|分数
sandwich	サンドイッチ
sunny	晴れわたった|陽気な|日当たりのいい
poison	毒|毒薬|毒物|弊害|に毒を盛る|を毒する
fancy	空想する|空想(力)|錯覚|気まぐれ|思いつき|好み|嗜好(しこう)
baseline	ベースライン(基線)
chrome	=chromium|クロムまたはクロム合金をめっきした材料|クロム染料など
collar	首飾り(colorとは発音異なる)|えり|首飾|首章
refresh	元気づける|さわやかな気分にする|を生き生きさせる|を新たにする|補給する
relocation	(米語)(第二次大戦中の日系人)強制収容|再配置|移転
settle	を置く|を落ち着かせる|を清算する|定住する|据える
leak	を漏らす|情報漏れ|漏電
timely	適時の|時期を得た|折りの良い|折りよく
explicit	率直な|明白な|あからさまな|(反義語)implicit
cuisine	料理|料理法|料理場|厨房
radius	飛行半径|半径|輻射線|区域|範囲
sept	7の意味(Septemberは9月に転じた)
exceptional	例外の|異常な|例外的な|異例の|特別に優れた
jar	かめ|びん|きしむ|がたがた揺れる
cube	3乗する|立方体
exemption	免税|課税控除
translator	翻訳者|通訳|翻訳機|翻訳家
bingo	当たり|ビンゴ
whilst	一方(=while)
spatial	空間的な|空間の
uv	紫外線
unto	の方へ(=toの古い用法)|〜まで|〜に
coral	珊瑚の
snapshot	スナップ写真
precious	気取った|貴重な|高価な|尊い|大事な|こりすぎた