hardware	ハードウェア|金物類|金属製品|機械設備
disposal	支配権|配置|配列|処理|売却
accountability	説明義務|会計責任
successor	後継者|後任者
transparent	透明な|明白な|透き通る|透けてみえる|薄い|率直な|わかりやすい
posture	状態|事態|状況|姿勢|体位|身構え|心構え|態度
costume	の衣装を用意する|衣装
controller	支配者|管理人|制御(操縦)装置
prospective	見込みのあった|将来の|期待される
flee	(人･場所)から逃げる|消える|を捨てる
vascular	脈管の|血管の|管の
deposition	罷免|証言録取書|宣誓供述書|堆積作用|堆積物
maturity	満期|成熟|十分な成長
flock	集まる|群がる|群れ|大勢|羊毛･綿などのふさ･くず
clip	切り取る|クリップ
nightmare	うなされること|悪夢(のような経験)|恐怖|夢魔
approximation	近付くこと|接近|近似|近似値
champion	支持する(stand up for)|のために戦う
deadly	命にかかわるような|致命的な|執念深い|死んだような
demographic	人口統計学の
analyst	分析家|解説者|解剖学者|分解者|精神分析(学)者|金融アナリスト|財務分析者
loyal	忠誠な|忠義な|忠実な|忠臣
mist	霧|ミスト|かすみ|霞|意味をぼんやりさせるもの|曇る
deputy	代理人|副～|代理|副|代理の
devotion	深い愛情|献身
rabbit	ウサギ
earthquake	地震
yeah	はい
repetition	繰り返し|くり返し|反復|再上演|再現
forgiveness	容赦|許し|免除|寛大さ
martial	好戦的な|軍の|戦争の|軍人らしい
lemon	レモン|(俗)欠陥品|不良品|きずもの
activate	放射能を与える|活性化する|活動的にする|活動させる
abundant	豊富な
qualify	に資格を与える･得る|適格とする|限定する|修飾する
resilience	弾力|反発|回復力|快活
cooling	冷却
sensible	(人行動など)分別のある|目的にかなった|賢明だ|顕著な|思慮のある|賢明な
supreme	最高の|主権を有する|究極の|絶頂|至高の|最後の
poorly	貧しく|不十分に|不完全に|まずく
maternal	母らしい|母の|母方の
thrive	成長する|を生き甲斐にする|栄える|繁栄する|繁盛する|(人･動植物が)力強く成長する
dot	点を打つ|小数点|点
casual	さりげない|くだけた|偶然の|不用意の|のんきな|臨時の|略式の|即座の
formally	正式に|本式に|公式に|儀式張って|堅苦しく|形式上|形式的に|外見的に|礼儀正しく
earnings	所得|利益|稼ぎ|生活力|儲け
competent	有能な|合法的な
abnormal	異常な
insufficient	不適当な
sexuality	性的要素|性別|性欲|性機能
appetite	食欲|性欲|欲求
nail	(人間の)爪タバコ|殴る|逮捕する
desperately	死にもの狂いに
variability	変動性
imaginary	想像上の|架空の|虚の|(an imaginary number虚数|imaginary|ある物事が想像としてのみ存在する|非現実的な|imaginative|想像力の豊かな)
dock	ドックに入れる|ドッキングする|(植物)スカンポの類
motive	動機|目的|主題|原動力となる
helpless	無力な|無力の|自分ではどうすることもできない
emission	排出|放出|排気|放射|発射
groan	うめく|唸る|うなるような音を立てる(grownと同発音)|ブーブー言う|きしむ|不満の声(をあげる)|うめき声
dilemma	ジレンマ|板ばさみ
territorial	領土の
toxicity	毒性
receiver	受取人|収入役|会計係|接待者|受話器|受信機|容器
globe	地球儀|球体|天球|球|地球
summarize	を要約する
ranch	大牧場|農場|農園
residential	住居の
sob	すすり泣き|ざわざわいう音|むせび泣きながら～を言う
coldly	冷たく
defensive	防御の
clarity	明瞭|明快|清澄さ|透明さ
validation	検証
tooth	歯|(複数形はteeth)|(食物の)好み
violate	に違反する|(法律･規則)を破る|を妨害する|犯す|違反する|乱す|強姦する|邪魔する
voyage	航海|船旅|飛行|航海記|航海する|(海を)渡る
regiment	連隊|組織化する|厳しく統制する
generator	発電機
preach	説教する|を伝道する|を説く
arena	競技場|土俵|闘争の場|闘技場|試合場
relational	リレーショナル|関係の
favorable	好意ある|好意的な|賛成の|都合のよい|有利な|望ましい(=favourable)
token	しるし|印|徴候|証拠|記念品|土産|表象|記念の品|(形容詞的に)形だけの
rent	(家･車など)を賃借りする|を賃貸しする|使用料|賃貸料
righteous	正義の|正しい|有徳の
intersection	交差|交差点
oath	神名濫用|のろい|悪罵|誓い|宣誓
surprisingly	驚くほど(に)|意外にも|驚くほどに|あきれるほど|驚いたことには
albeit	(ɔːlbíːɪt)にもかかわらず|=although
synthetic	合成した(fiberなど)|総合的な
grammar	文法学|文法
oneself	自分自身|自ら
depart	規則から逸脱する|立ち去る|出発する|軌道からそれる|この世を去る
generic	ノーブランドの|属の|一般的な|包括的な|(文法)総称的な
graft	(骨の折れる)仕事|挿し木|移植する
compression	圧縮
limitation	限度|限界
furious	すさまじい|狂った|激怒した|激しい|荒れ狂う
graphic	グラフィック|グラフの|図画の|グラフィックアートの|目のあたりに見るような|生きいきとした
passionate	熱烈な|熱情的な|短気な|好色な
pore	(本などを)じっくり見る|熟読する|熱中する|精査する|(on|upon|over)|毛穴|(岩石などの)細孔|(葉の)気孔|(人体内の)導管|毛穴
bastard	雑種の|不純な|偽の|偽物|粗悪品|私生児|庶子|野郎
raid	急襲(する)|引き抜き|襲撃(する)|侵略|奇襲|手入れ|かき乱す|attack
navigate	を航行する|(船･飛行機)を操縦する
hedge	保険つなぎ|ヘッジ取引|行動を妨げる|生け垣(を作る)|垣根|境界|防御物
outstanding	際だった|目立つ|未解決の|未払いの
closet	密談させる|戸棚|人に知られていない|隠れた
shy	後ずさりする|しりごみする|恥ずかしがりの|内気な|恥ずかしがり屋の
arc	弧(こ)
anticipate	予期する|予想する
dislike	きらう|嫌う
thorough	完全な|徹底的な|心からの|絶対的な|詳細な
flip	はじく|軽く打つ|弾く|ポンと打つ|宙返り|(アザラシ等の)ひれ足
sympathetic	思いやりのある|同情的な|同情する|共感する
pond	池|泉水|沼
fork	フォーク|分岐点
guardian	保護者|守護者|監視者|後見人
congregation	集会|集合|会衆
oxidation	酸化
tin	スズ|ブリキ|すず製容器他
warrior	勇士|武人|武士|軍人
officially	公式に|職務上
leverage	てこの作用|借入金で投資する|利用する|utilize
stern	厳格な|きびしい|いかめしい|苦しい|断固たる|船尾
vaccine	ワクチン(の)|痘苗(の)
abruptly	突然に
moisture	水分|湿気
popularity	人気|評判|大衆性
bloom	開花させる|栄える|花が咲く|若さ|美人|花盛り|開花|花
armor	よろいかぶと|よろい|防護具
seize	をつかむ|を理解する|つかむこと|差し押さえ|奪取
boast	自慢する
revision	改訂|改正|手直し|加筆|是正|校閲|改訂版|復習
liable	責任を負うべき|義務である|法的責任のある|しがちな
multitude	多数|群集|大衆|大勢
jealous	嫉妬深い|しっと深い|ねたんで
straw	わら製の|麦わら|ストロー
compact	ぎっしり詰まった|コンパクトな|小型車|小型|(二国間または多国間の)盟約|盟約を結ぶ
auditor	監査役
corpus	文章の収集|集成|死体
communist	共産主義者
applicant	志願者|応募者
controversial	議論好きの|議論の|論争上の
nonsense	たわごと|無意味
carcinoma	癌腫
spectacle	見世物|光景|壮観
publish	出版する|を発表する
differentiate	を他と別のものにする|を区別する|を変更する
strap	縛る|固定する|を革ひもで縛る|吊皮|革ひも|つり革|革紐で縛る|ストラップ
stalk	茎|軸|細長い支え|煙突|忍び寄る|大またに歩く
locally	局所的に|場所的に
defect	不足|欠点|短所|欠陥|亡命する|他国へ逃亡する
simplicity	単純|平易|質素|純真
discretion	行動の自由|思慮深さ|慎重さ|判断力|決定権
amplitude	振幅
calmly	静かに
buzz	がやがや言う|ざわめき|音|ブンブン|ハチの音|ブザーで呼ぶ
messenger	使者|使い走り
sexy	(性的に)魅力的な|セクシーな
coil	ぐるぐる巻く|コイル
prosperity	繁栄|繁盛|成功|幸運
taxi	タクシー|タクシーで行く|陸上をゆっくり進む
reservation	予約|保留
polite	礼儀正しい|行儀がよい|丁重な|上品な|洗練された|丁寧な
affirm	肯定する|断言する|確認する|確信する
articulate	はっきり言う|はっきり発音する|明瞭な|(関節で)繋ぐ|関連づける|(文法)分節する|文節する
whistle	笛|警笛|口笛を吹く|口笛|汽笛|ヒューと音をたてる|を口笛で吹く|笛で合図する
elementary	初歩の|初めの|初等の|基本の
lick	打つ|負かす|全速力で進む|(舌で)なめる|なめること|一なめ分|(a lick)少し|少量
closure	締切り|閉店|閉鎖|締め切り
hut	簡易住居|小屋
conceal	の中に身を隠す|隠す|を秘密にする|に潜伏する
intentionally	わざと
cortex	(解剖)皮質|外皮
dysfunction	機能障害
spill	こぼすこと|をこぼす|をばらまく|流す|溢れる|浪費する
ignorant	無知から起こる|無知の|無学の|教育のない
persist	固執する|やり通す|主張する|続く|残る
dramatically	劇的に
template	テンプレート|定形書式|鋳型
encouragement	励まし|促進
questionnaire	アンケート|質問|質問書
lately	近ごろ|最近
hesitation	ちゅうちょ|ためらい
mentally	心で|精神的に|知的に
max	マックス|最大の
subset	部分集合
fitness	適当|健康
toast	トースト|乾杯(する)
garlic	ニンニク
proximity	近接|近似
outlet	(チェーンの)店(｢販売代理店｣が原義)|販路|小売店|コンセント|出口|はけ口
beef	牛肉|問題|不満
terrorism	テロ行為|恐怖政治
vitro	in vitro 試験管内で(=生体外で)|in vivo (in the body) 生体内で
pencil	えんぴつ
insert	挿入する
supportive	協力的な|支持する
anticipation	予期
imagery	イメージ|像
atomic	原子の
outbreak	勃発|突発|発生|暴動
rebellion	謀反|暴動|反乱|むほん|反抗|造反|反逆
parental	親の|親にふさわしい
cum	「付き」の意|精液
spontaneous	自発的な|自然な|自然に起きる|自然に起こる
intact	そこなわれていなくて|そのままで|完全で
offensive	不快な|いやな|攻撃|攻勢|無礼な|攻撃的な
wavelength	波長
spinal	とげの|背骨の
gossip	うわさ話をする|うわさばなし|陰口|悪口|噂
timber	材木|木材|森林|樹木|材料
tire	を疲れさせる|を飽き飽きさせる|タイヤ
cancel	無効にする|取消し
endeavour	努力する
infer	を推論する|結論する|を察する|推察する
traditionally	伝統的に|古来
geography	地理学|地形
interrupt	話しを邪魔する|の邪魔をする|を妨害する|を中断する|口を挟む
wilderness	荒野|だだっ広いところ|ごたごたした集まり
whoever	だれでも|だれであっても|する人は誰でも|だれが～しようとも|いったいだれが
friction	摩擦|不和
diminish	小さくなる|減らす|減少する
retention	保持(率)|保有|滞留|うっ滞(性)
vacuum	真空地帯|真空の|掃除機で掃除する
conjunction	結合|連結|合同|(文法)接続詞
computational	計算の
restraint	妨げとなるもの|抑制|制止|拘束|監禁|遠慮|慎み|自制|制限
feminine	女の|女性の|(文法)女性(の)
conform	従って行動する|一致する|従わせる|従う
approve	を承認する|賛成する|を気に入る
alignment	照準|配列|アラインメント|一直線|配置|整列
submission	服従|従順|寄託|提案|提出|仲裁付託|(レスリング)押さえ込みに屈すること
stabilize	固定させる|安定させる(する)
supporter	サポーター|支持者|扶養者|支柱
textbook	教科書
goodbye	さようなら(=goodby)
nutrition	栄養物摂取|栄養物|滋養の|食物
discern	見分ける|認識する
diplomatic	外交の|外交上の
instability	不安定|不安定性(度)(率)
dependency	依存(の状態)|属国|保護領
vacation	休暇|休日|休み
cognition	認識(力)|知識
multiply	掛ける|増加させる|増やす|増える|増す
retrieval	取り返し|挽回|回復|修正|検索
forum	評議会|大広場|フォーラム|公開討論の場
legally	法律的に|合法的に
rack	棚|枠|苦しめる|ちぎれ雲
oppression	圧迫|憂鬱
manipulation	操作|巧みな操作|市場操作|ごまかし|触診
warfare	戦闘状態|戦争|交戦|闘争|争い
sermon	(教会での)説教|お説教|小言
govern	統治する|決定する|を抑制する|を管理する|を左右する
destructive	破壊的な
toe	足指|あし指|つま先|蹄鉄の前部|先端
patron	(仏語)パトロン|守護聖人|ひいき客|後援者
inspect	検査する|調べる
bucket	バケツ
opt	選択する
vocal	ボーカル|声の|口頭の|声楽の|有声音|母音|声楽
theorem	法則|定理(=axiom)|原則
mayor	市長
addiction	熱中すること|夢中になること|-中毒
deer	シカ|鹿
goddess	女神
swell	膨らむ|を膨らませる|隆起(する)|増大(する)|(口)すてきな
reactor	(陽性)反応を示す人|反応者|反応器|反応炉|原子炉
refusal	拒否|拒絶
reconcile	を和解させる|仲直りさせる|に甘んじる|満足させる|を調停する|諦めさせる|承諾させる
pledge	誓約|質入|乾杯|を誓う|人質|保証する
pardon	を許す|許し
hike	ハイキングをする|引き上げる|値上げする|increase|raise
tropical	熱帯の|熱帯性の|非常に暑い|猛暑の|回帰線の
mitigate	和らげる|緩める
sweep	さっと通過する|を一掃する|掃除する|(～を)掃く|を掃いて集める|圧勝する|大勝する
harbor	(考え･計画など)を心にいだく|をかくまう|港|避難所
nationalism	民族主義|愛国心|愛国主義
ounce	1オンスは28.3グラム
ink	インク|調印する|sign
gauge	標準寸法|規格|尺度|計器|レールの軌間(ゲージ)|判断基準|測る
rude	教養のない|無作法な|無礼な|野蛮な|粗野な
refuge	避難する|避難|保護|避難所|隠れ家
butt	(獣が)角で激しく突く|(俗)尻|けつ|つつく
rejoice	を楽しませる|うれしがる|喜ぶ|祝う|を喜ばせる|喜び
cohort	(古代ローマ)歩兵隊|軍隊|仲間|相棒
hostility	戦争行為|敵意|敵性|敵愾心|反抗|敵対行為|反対|対立
municipal	市の|内政の|局地的な|地方自治の|市営の
provincial	田舎風な|地方の|国の|県の|いなかの|地方人|偏狭な人
bull	乱暴なことをする|がっしりした男|頑固な|強気筋|雄牛|雄|ブルドック
splendid	輝かしい|華麗な|壮烈な|みごとな|豪華な|立派な|すてきな
broker	ブローカー|仲買人
receipt	受け取ること|レシート|受領|領収書|収益|受領書
diffuse	散らす|拡散させる
garage	ガレージ|車庫
thereof	その|それの
salad	サラダ
nationalist	国家主義者|国民党員|国家主義の
elephant	ゾウ|象|米共和党(Republican Party)の象徴
peptide	ペプチド|決まった順番で様々なアミノ酸がつながった分子
bitch	雌犬|(卑語)淫乱な女|意地悪で不愉快で身勝手な女|不平･不満を言う
vegetable	植物人間|野菜|植物|活気の無い人
amid	〜の真っ最中に
sect	教派|派閥|分派|学派
antigen	抗原
painter	画家|ペンキ屋|塗装工
honestly	いやはや|正直に|誠実に|正当に|正直に打ち明けて|まとも|実直|真面目
incomplete	不完全な
breakdown	突然の故障|機能停止|挫折|崩壊|内訳|分類
obedience	服従|従順
stool	丸椅子|腰掛け|足のせ台|2便器|大便(=excrement)
prosecution	起訴|告発|検察当局|遂行|実行|追求
disruption	分裂|崩壊|混乱
decisive	決定的な|断固とした
scholarly	学者らしい|学術的な|学問的な
exceptional	例外の|異常な|例外的な|異例の|特別に優れた
afterward	あとで|後に
mold	形作る|(に基づいて)作る|土|沃土|肥土|型|鋳型|流し型|骨組み|鋳物|性質|カビ
traumatic	衝撃的な
legislature	立法府
elder	年長者|年上の 2|ニワトコ
heavenly	すばらしい|天の
alloy	合金|合金に用いる安価な金属|まぜ物|品位|純度
median	中央の|正中の|メジアン|中点
distribute	配送する|分配する|分布している
urine	尿
societal	社会の|社会的な
quarrel	四角い鏃の付いた矢|紛争|口論|反目|不和|争う
ibid	同書に|同上
bless	を神聖にする|感謝する|祝福する|恩恵を与える|清める|恵む|賛美する|十字を切る|祈る
adhere	執着する|堅く守る|粘着する|支持する
reproduce	を生殖させる|を複製する|を模写する|を再生する
er	あー|あのー|えーと
consume	消費する
junction	連絡駅|連結|接合(部)|ジャンクション|はね橋|接合器|接点|多重ノード
reactive	(刺激に対して)敏感な|反応の早い|反作用的な
baseball	野球
courtesy	礼儀正しさ|礼儀
intuition	直観
idiot	まぬけ|ばか|あほう
induction	就任式|帰納法|誘発
calendar	カレンダー(calenderはミススペル)
cinema	映画館|映画
basement	地下室|基底部|地階
cooperate	協同する|協力する
tackle	取組む|タックル(する)|道具|ろくろ
organism	有機体|生物|人間|個々の小さな動･植物|有機的組織体(社会など)
batch	一揃い|(電算)バッチ(一度に処理するデータの束)|一群|(手紙の)一束|(パンなどの)一焼き(分)|一回分(のもの)|一団
math	数学|mathematics
trim	刈込む|整備(する)|削減する|を装飾する|(身体の)調子|気分|きちんとした
unclear	あいまいな
prescription	処方(箋|薬)|指示|規定|規範|法規|時効|おきて
surplus	黒字|剰余|余剰|余り|余った|過剰の|余剰の|黒字の
moreover	その上|なおその上に
suite	一続きの部屋|一式の家具|一組|スイート|スイートルーム(和製英語)
leisure	ひま|暇(な)|余暇|用事のない|有閑の|レジャー
harmful	害をおよぼす|有害な
tragic	悲劇の|悲劇的な|悲劇に関する|悲劇を演じる|悲惨な
slender	ほっそりした|不十分な|細長い|わずかな|薄弱な
conceive	考える|思い付く|想像する|妊娠する
specimen	見本の|標本|見本|試験片|試料
darling	いとしい人
flank	側面に立つ|横腹|脇腹|側面(に立つ)|側面を守る|わき腹
fossil	化石
reservoir	貯蔵所|宝庫
indirectly	間接に|二次的に|暗に|間接|それとなく|当て付ける|やんわりと
inhibition	抑制|禁止|禁制|防止|抑圧
instrumental	役に立つ|計測(計器)による|(文法)助格(の)
compliment	お世辞を言う|誉める|賛辞|お世辞|あいさつ
reinforcement	補強|強化
elastic	融通のきく|伸縮自在の|flexible|快活な
cargo	船荷
fury	憤慨|激怒|激しさ|憤激|怒る|激情
enhancement	強化
attendant	付添いの|係員|コンパニオン(和製英語)
convergence	一点に集まること|収束|輻輳
nonetheless	それにもかかわらず|やはり
inscription	刻むこと|銘刻|銘|碑文|the inscription on a gravestone墓碑銘
computation	計算(法)|評価
neighbourhood	近所の人々
knit	編んだ|組む|編む
aggression	攻撃|侵略
prone	の傾向がある|のくせがある|しがちな|うつぶせの
hum	ブンブン音をたてる|鼻唄をうたう|景気がよい|ぶんぶんいう音|buzz
sore	痛い
cylinder	シリンダー|円筒
reluctant	気乗りのしない|不承不承の|しぶしぶの|嫌がる
halfway	中途半端な|中途の|中間の|中間にある|中間で|途中で
discomfort	不快にする|不便
plantation	栽培場|大農場|大農園|植林地|植民地
civic	市民の|市の
amusement	楽しみ|娯楽
operative	働く|活動する|(法律が)効力のある|(薬が)ききめのある|有効な|職人|スパイ
architectural	建築の|建築学の
monkey	サル|いたずら小僧|遊び回る|いじくる
stride	大股で歩く|またぐ|一またぎ|進歩
proliferation	増殖|急増|拡散|(生物)分芽|分裂|増殖
thigh	もも|また|太腿(尻から膝まで)
selfish	わがままな|利己的な|自分勝手な
fare	料金|運賃|旅をする|暮らす|ごちそう
deed	行為|行い
dip	下落|落下|一汲み|をちょっと浸す|を汲み上げる|下降する|decline|decrease
enjoyment	楽しみ
limb	の手足(翼)を断つ|手足|大枝|縁|節
lawn	芝生
transparency	透明度|透明性
recommendation	推薦(状)
constraint	強制|圧迫|束縛
temporarily	仮りに|仮に|当座|一時的に
contempt	軽べつ|軽蔑|侮辱
producer	生産者|演出家|製作者|興行主|経営者
relieve	を救う|を和らげる
assay	含有量(率)を示す|試金(含有量の検査)する|評価する|検定する
gorgeous	華麗な|豪華な|見事な
rebuild	再建する
electoral	選挙の
awe	畏敬|畏怖
crude	天然のままの|粗野な|露骨な|粗い|加工していない|不遠慮な
fortunate	しあわせな|幸運の|運の良い
suspension	負債の返済不納|吊すこと|停止|宙吊り|未決定|停職
burial	葬式|埋葬|墓
deployment	展開
solidarity	団結|連帯|一致
tick	カチカチいう音|カチカチと音を立てる|時を刻む|ダニ|いやなやつ
satisfactory	満足な|十分な
fatty	脂肪質の|油っこい|脂肪性の|脂肪の|デブ
empathy	感情移入|共感
splash	ねる|をはねかける|バシャ|水のはねる音
brace	突っ張り|支柱|引き締める|支える|元気を出す|元気づける
pastor	牧師
extensively	広く|手広く|大々的
rider	ライダー
elicit	引き出す|導きだす
disk	円盤
ascertain	突止める|確かめる|突きとめる|確実にする
vegetation	(集合的に)植物|植生|植物の発育|無為の生活
realise	realizeの英式綴
bin	(ふた付の)大箱|(石炭, 穀物の)置き場
parish	教区(民)|郡|巡回区域|専門分野
abdominal	腹部|腹部の
dioxide	二酸化物
marker	マーカー|マークする物|目印|採点者|記念碑
liberation	解放
lively	active|生き生きした|泡立つ|新鮮な|陽気な|効果的な
statutory	法令の|法定の
murmur	つぶやき|不平の声|かすかな音|ささやく|ざわめく
stitch	を縫う|ステッチ|一針|綴じ|ひと針|縫い目|布地
downward	下向きに|下方へ
portal	入口|門脈|入り口|玄関|正門
announcement	発表|通知
nurture	滋養物|養育|養う|育てる
dominance	優越|支配|優勢
consultant	コンサルタント|顧問|相談役
missile	ミサイル|飛び道具
coherent	首尾一貫した|同位相の|密着した|筋の通った|一貫した
envy	うらやむ|うらやみ|羨望
reproductive	再生(再現)の|生殖の|多産の
dam	せき止める|ダム
wax	ろう|ろう状物質|ワックス|レコード|耳あか|激怒|大きくなる|かんしゃく|満ちる
junior	年少の|年少者
apology	弁解|言い訳|謝罪|(口)まにあわせのもの
conquest	占領地|征服
swift	迅速な|迅速に|敏速な|非常に速い
sediment	沈澱物|沈殿物|堆積物
conditional	条件付きの|条件的な|(文法)条件文|条件語句(節･文)
slap	非難(する)|平手打ち|をピシャリと打つ(こと)|ピシャ|ひっぱたく音
meantime	合い間|その間の時間
jam	混雑|ジャム|妨害する|詰め込む
canvas	研究調査する|遊説してまわる|選挙運動をする|カンバス|キャンバス|テント|麻布|帆布|ズック
blossom	(特に果実の)花が咲く|開花する|発展する
beneficiary	受取人|受給者|受益者|信託受益者
recognise	認識する
analyse	分析する
propaganda	宣伝|主義|主張|宣伝機関
lump	塊になっている|重そうに動く|たくさん|角砂糖|こぶ|塊
prophecy	予言的能力|予言|お告げ|天啓|預言
emotionally	感情的に
sincere	誠実な|偽りのない|正直な
bilateral	二国間の|両国間の|両側の|左右相称の|相互的な|双務的な|両側のある|双方の
confirmation	売買報告書|確認
incorrect	正しくない|間違った|無作法な
purity	清浄|混じり気のないこと|純粋|純度|清潔|純潔|清廉|正格
winner	勝利者|受賞者
distraction	精神錯乱|気晴らし
premium	割増価格|割増金|賞与金|賞|賞金|賞品|賞与|割り増し
ambitious	大望のある|野心的な|熱望して
tourist	観光客|旅行者
align	並べる|一直線にする|提携させる|一列に並べる
predominantly	優勢に|主に|大部分は|広く|支配的な
provoke	引き起こす|刺激する|を怒らせる|をじらす|挑発する
chap	男|あかぎれ|ひび(あかぎれ)を作る|(手などが)荒れる|(動物の)あご|ほお
affinity	類似性|親近感|魅力|attraction|婚姻(関係)
nephew	おい|甥
shrug	肩をすくめる(こと)
fundamentally	根本的に
unwilling	気が進まない|いやがる|不本意の|いやいやながらの|反抗的な
drought	日照り|かんばつ|旱魃|渇水
fibre	fiber(繊維)の英国式綴り
circumstance	ものものしさ|出来事|事情･環境|状況|境遇|身の上
rehabilitation	社会復帰|名誉回復|復権|復興
gel	ゲル|膠(こう)化体
spiral	らせん状に進む|らせん|螺旋状の|螺旋形のもの
countenance	に暗に賛成する|表情|外見
collision	衝突
motivate	に動機を与える|動機を与える|やる気にさせる
spoon	スプーン
landlord	家主|地主
fuzzy	ぼやけた|微毛のある|けばだった|縮れた|ファジー理論
scientist	科学者
immigrant	帰化植物|移住者|移住民|(外国からの)移民|外来動物
ml	ミリリットル(1cc)
fort	とりで|交易市場|要塞
warehouse	を倉庫に入れる|を保税倉庫に預ける|商品保管所|卸売り店|問屋|倉庫|大商店
restriction	制限(条件)|限定
periodic	定期的な|周期的な|断続的な
clash	衝突(する)|ガチャッ(音)|(色彩の点で)調和しない
atom	原子
righteousness	正義|正直|正しさ|実直
summit	首脳(陣)|山頂|頂点|首脳会談|首脳レベルの
transmit	伝える|convey|を送る|を伝達する|送信する|発信する
cute	かわいい
naval	海軍の
mum	黙る|無言の|黙っている|しっ!|奥様|おかあちゃん|強いビール|キク
costly	高価な|損失の大きい
sack	解雇(する)|袋(にいれる)|袋の中身|大袋
disagreement	不一致
accomplishment	達成|完成|才能
boot	長靴|解雇|クビ|(UK英)車のトランク
flush	ほおがぱっと赤らむ|(空が)ばら色になる|メモリをクリアする
irregular	でこぼこの|不揃いの|不同の|不規則な|変則的な|(文法)不規則変化の
worm	虫|寄生虫|虫けら|苦悩|徐々に進む|寄生虫を取り除く
evolve	展開する|発展させる|導きだす|発展する
outfit	したく|用具一式|一行|供給する
eagerly	熱心に
immunity	(税･責任･義務などの)免除|免疫性|免疫
longitudinal	経度の
sickness	病気
bud	つぼみ|芽
foam	泡|あぶく|泡を出す|あわ消化剤
negotiation	交渉|話し合い|(小切手など)譲渡|談判|流通
rub	こする|障害|摩擦
download	ダウンロード
laptop	ひざ置き型の|小型で携帯可能な|ラップトップの
compatible	両立できる|矛盾のない|(ソフトウェアなどで)互換性がある
feasible	実現可能な|可能な|適した|便利な
deformation	形をくずすこと
solemn	いかめしい|厳粛な|まじめな
viable	生存できる|実行可能な|生存能力のある
coincide	一致する|同時に起こる|性質が合う|同じくする
speculation	投機|思惑買い|思索|思弁|考察|空論|推測|やま
icon	聖像|像|肖像|イコン|偶像|アイコン
safeguard	予防手段|防護手段(対策)|緊急輸入制限
solitary	孤独の|ひとりの|一人だけの|孤独な|めったに人の訪れない
sculpture	彫刻をする|彫刻する|彫刻|彫刻作品
scarce	まれな|不足して
reliance	依存|信頼
unpleasant	不愉快な|いやな|気にさわる
summon	を招集する|を呼び出す|勧める|命令する|要求する
earnest	まじめな|熱心な|真剣な|重大な
streak	筋がつく|閃く|層|線|光線|一続き|兆候
dreadful	恐ろしい
proportional	比例した|釣り合った|比例項|比例の
plug	差し込み|消火栓|栓|プラグ|ソケット|点火栓|をふさぐ|宣伝(する)
coupling	男女のカップル
gradual	(勾配が)ゆるやかな|漸次の|徐じょの|徐々の|漸進的な|逐次の|昇階唱
abortion	人工中絶|堕胎|流産|早産|(器官の)発育不全
interactive	インタラクティブな|対話式の|実況の|最新の
individually	個々別々に
deity	神|神性
biomass	生物量|バイオマス|生態学で
murderer	人殺し|殺人者
sunshine	日向|日光
chromosome	染色体
republic	共和政体|共和国|～団体|～社会
colleague	同僚|仲間
coarse	粗野な|あらい|粗末な|粗い
suck	ひとすすり|吸う|しゃぶる|ひどくいやな|むかつくような|最低の
attendance	出席
advertisement	広告
contingent	依存する|付随する|偶然の|臨時の|不慮の出来事|分担|分艦隊|派遣団
signify	を意味する|を示す
teaching	教育|授業|教え|教義
imprint	強く印象づける|押印|感銘させる
captive	捕らわれた|人質(=hostage, pawn, pledge, captive)|とりこ(の)
ripple	波紋ができる|に波紋を起す|波状|細波が立つ|波紋|さざ波
viral	ウイルスの|ウイルス起因の
ethnicity	民族性
tech	技術の|科学技術|技術者
slaughter	大量殺戮|完敗|屠殺する|虐殺する|徹底的に打ち負かす
intimacy	仲の良い|親密|親しい|個人的な|私事の|精通した
retire	退職する|引退する
hood	ずきんをつける|ずきん|フード状のもの
overnight	夜通し|一晩中|前夜の|一夜のうちに
wreck	難破|難破船|破損|廃人|破壊する|難破させる
critically	きわどく|危うく|危なく|危篤状態に|酷評して|批判して|批評的に
culturally	文化的に
advancement	傷心|進歩|促進
scandal	スキャンダル|醜聞|恥ずべきこと
spur	を駆り立てる|に拍車をあてる|急行する|激励|刺激|拍車
paste	をのりではる|ねり物|ペースト|のり|練り粉
neat	さっぱりした|きちんとした|こぎれいな|趣味のよい
nonlinear	非線形の
affective	感情の
hurriedly	あわただしく|大急ぎで
revolt	暴動(を起こす)|反乱|背く|反抗する|暴動を起こす|不快に感じる|一揆|反感
intellect	知性
dismiss	解雇する|fire|立ち去らせる|追放する|解散する|(本来なら考慮すべきことを)忘れる
incredibly	信じられないほど|非常に
spoil	悪くなる|を台無しにする|駄目にする|を甘やかす|役に立たなくする
perish	を殺す|滅びる|死ぬ|消滅する|悪くなる|堕落する
transnational	多国籍企業|国家を越えた|国境を越えた|多国籍の|国という枠組みを超えた
bronze	青銅|ブロンズ
lust	切望する|強い色情をいだく|(通例好ましくない)欲望|強い性欲
waiter	給仕|ボーイ
audio	可聴周波数|音響部分|聴覚の
offend	怒らせる
policeman	警官
unfortunately	あいにく|不幸にも|不運にも
narrator	ナレーター
offspring	子孫|結果|成果
terminology	専門用語|術語|用語法|術語学
chapel	礼拝堂
rationale	理論的解釈|根本的理由|原理|理論的説明(根拠)
integer	(ínṭɪdʒɚ)完全なもの|完全体|(数学)整数|整数値
doll	人形
pearl	真珠(の)|を真珠で飾る|真珠色
swiftly	すばやく|迅速に
convenience	便利なもの|都合|便利
acceleration	加速|促進
rim	リム|へり|枠|ふち
refrain	差し控える|差控える|断つ|抑制する|謹む|こらえる|やめる|我慢する
thrill	をぞくぞくさせる|ぞくぞくする|を感動させる|震え|振動|スリル
casually	何気なく|偶然|思いがけなく
terrace	段地
cult	礼讃|信仰|宗派
angrily	怒って
microbial	微生物の
iteration	反復
torment	に肉体的苦痛を与える|を困らせるを苦しめる|を悩ます|苦労の種|苦痛|苦悩|拷問
mansion	大邸宅
spectral	お化けの(ような)|怪奇の|スペクトルの
comedy	喜劇
mesh	網目|網の目|網|わな|網で捕らえる|かみ合わせる|協力させる
plea	嘆願|陳述|弁解|抗弁
resurrection	回復|蘇り|復活|復興
customary	習慣的の|慣習の|いつもの|例の
custody	拘留|保護|管理|拘置
obesity	(医)肥満|肥満体
bowel	腸|内臓
descriptive	記述的な
workforce	(作業)要員|総労働力|労働|労働人口
scare	こわがらせる|おどして～させる|おびえさせる
utilization	利用
substantive	名詞相当語句(形容詞句|節など)|実詞
detector	発見者
unstable	不安定な|安定していない|動きやすい|ぐらぐらする|不安定|今にも崩れそうな|気が変わりやすい
isolate	孤立させる|を離す|隔てる|を隔離する|を絶縁する
premise	を前提とする|前提|根拠|既述事項|財産|不動産|家具|建物|土地|構内
daylight	昼の明かり|日光|公然|公表|理解|透き間
sheriff	郡保安官
efficiently	能率的に|効果的に
agony	苦痛|煩悶
contemplate	熟考する|凝視する|予期する|直視する
fearful	恐ろしい
vivo	in vitro 試験管内で(=生体外で)|in vivo (in the body) 生体内で
caste	階級|(社会的)地位|カースト|階級制
float	浮くもの|浮かぶ|浮く
relaxation	気晴らし|くつろぎ|息抜き|ゆるみ|弛緩|緩和
disregard	無視する|軽視する
specificity	特異度|特定性|特異性|無病正診率
parliament	議会|国会|英国議会
disc	レコード|円盤
bury	没頭させる|～隠す|を埋める|を埋葬する|を忘れる
notebook	ノート
renewable	更新しうる|再生しうる
communal	地方自治体の|公共の|全住民が共有する
absurd	ばからしい|不合理な|ばかげた
offset	分かれ|分派|オフセット(印刷)|埋め合わせ|相殺|相殺する
prototype	プロトタイプ|原型|手本|試作|模範
brake	ブレーキ|歯止め|制動機|(植物)シダ|ワラビ
adequately	適切に
responsive	すぐ反応する|敏感な
hastily	あわてて|急いで
console	悲しみを和らげる|を慰める|を元気づける
album	アルバム
ribbon	インクリボン|リボン|飾りひも|ひも状のもの
termination	終了|接尾辞
venue	会場|集合場所|(行動･事件の)現場
inappropriate	不適当な
nominal	名目上の|名称上の|名詞の|名詞語句
virgin	純潔の|未婚婦人|修道女(まれ)
viewpoint	見解|見える地点|観点
puff	ぷっと吹く(こと)|ひとふき|たばこの一服|ふくれること|息を切らす|煙を吐く|を膨らませる
morphology	形態論|形態学|形態(学･論)
ambiguity	あいまいさ|両義性|両義にとれる表現
inn	宿屋
vivid	生き生きとした|生気にみちた|(色･光)鮮明な|強烈な|(色に関して)鮮やかな
rally	再び集める|元気づける|回復(する)|反騰(する)|大会|集会
mandatory	強制的な|命令の|統治を委任された|委任の
creator	創造者|創作者|創設者|創始者
promptly	すぐに|敏速に|即座に|ぴったり
lesion	障害|病変|外傷|損傷|病気による組織の変形
dictionary	辞書
susceptible	影響を受けやすい|敏感な|感染しやすい|を許す|可能な
indulge	欲望を満足させる|ふける|耽溺する|深酒する|気ままにさせる|甘やかす
tiger	トラ|乱暴者|強敵|狂暴な(残酷な)人|歓呼|喝采
bug	虫|ナンキンムシ|微生物|バイ菌|熱狂家|欠陥点|盗聴器|盗聴する|いらいらさせる|困惑させる
stagger	よろけ|よろめく|二の足を踏む|動揺させる|ずらす
drawing	引く|製図|素描|鉛筆で描く絵
layout	並べること|広げること|割り付け
resemblance	類似|似ていること
imitate	を手本にする|を模倣する|をまねる
greet	あいさつする|挨拶する|反応する|知覚される
contraction	短縮|縮小|制限
pragmatic	実用主義の|実際的な
compartment	コンパートメント|区画|仕切り
mutually	相互に|双方で
patrol	パトロール(隊)|(～を)巡回する|巡回者
hierarchical	階級の
entail	必要とする|を伴う|限嗣相続の形で譲与する|必然的な結果
distinctly	きっぱり|はっきりと
compute	算定する
shortage	数量の不足|不足|欠点
geographic	地質学上の
peasant	いなか者|小規模農業|小作農|田舎者|農夫
settling	沈降した
dietary	食事の|飲食規定(量)
focal	焦点の
balloon	風船|ふくらむ
coincidence	偶然の一致･出合い
refine	不純物を除く|純化する|精錬|製錬|精練|洗練する
modernity	現代性|現代的なもの
inward	本質的な|内へ|内部へ|内陸の|奥地の|内部|内側
cab	タクシー
predicate	を断定する|を意味する|を叙述する|述部|述語
successive	連続的な|継続的な|次の|連続する
idle	遊んでいる|怠ける|怠惰な|仕事のない|何もしない|暇な
countryside	田舎
dash	粉々に打ち砕く|突進する|投げつける|激しく打つ|突撃|活気|a 100-meter dash(100メートル競走)
conspiracy	共同謀議|陰謀
charter	に特許を与える|憲章|憲法|constitution
smirk	作り笑い|(～を)にやにや笑う(at|on|upon～)
soap	せっけん|石鹸|を石鹸で洗う
asylum	亡命|避難|政治犯の庇護|隠れ家|保護施設|避難所|精神病院|孤児院|聖域
journalist	ジャーナリスト|新聞記者
chant	詠唱する|シュプレヒコール
fountain	泉
replicate	(葉など)を折り返す|を模写･複製する
shoe	くつ|靴
riot	暴動に加わる|放蕩する|ふける|暴動|反乱|一揆|多種多様
tread	を踏む|行く|歩く|階段の段
indifferent	差別しない|無関心な|無感動の|冷淡な|普通の|(電気的･科学的に)中性の|不活性の
randomly	無作為に
appropriately	適切に
unfair	公正を欠いた|不公平な|ずるい|不正な|不当な
explosive	爆発しやすい|爆発性の|爆発物
comprehension	理解|包含
tug	を強く引く|引っ張る|引っ張ること
editorial	社説|編集者の|論説
cerebral	脳の
spike	大くぎ|(塀の)忍び返し|(競技用の靴の)スパイク|(植物)穂
thoughtful	思慮ぶかい|考え込んでいる|思いにふけった|考え深い|思慮深い
pixel	ピクセル|画素
butterfly	蝶|チョウ|バタフライ(水泳)
negatively	マイナスに|否定的に
masculine	男らしい|男の|男性|(文法)男性の
contradict	に矛盾する|反論する|反駁する|抗論する|否定する
documentary	ドキュメンタリー|文書の|ドキュメンタリー映画|事実を記録した|記録もの
embarrassment	困惑|困難
alpha	(第1ギリシア文字)アルファ|Α|α
heroic	おおげさな|英雄の
sober	しらふの|酔っていない|分別のある|真面目な|冷静な
plausible	もっともらしい|口先のうまい
haired	髪
sow	雌豚|蒔く|種をまく
tan	なめす|皮をなめす|皮膚を日焼けさせる|タンニン|黄褐色
terrain	(自然地理･軍事上から見た)地域|地勢|地形
parade	行列|見せびらかし|を行進する|を見せびらかす
composer	作曲家
utmost	最大限の|最上の|極度の|最高の|一番端の|極限|全力
methodological	方法論的な
exempt	免れさせる|免れた|免除する|免疫の|免属の|免税者
mug	(人を暗闇で)襲って金品を奪う|(俗)がり勉する|大型コップ|マグ|ジョッキ|(俗)つら|顔写真を作る|不良|まぬけ
cheerful	気持ちのよい
moonlight	月光(の)|(俗)内職(する)|夜間アルバイトをする
betray	裏切る|騙す|だます|漏らす|密告する|秘密をあばく|敵に売る|背く|うっかりもらす
innocence	無垢|潔白
complementary	補完的な
manifestation	発現|明らかにすること|政策表明|徴候
trash	紙くず入れ(=wastebasket)
superiority	優越
migrate	移住する
inclination	したい気持ち|好み|意向|傾斜|傾向
staircase	階段
wherein	どこに
interpersonal	個人間の
symmetry	釣り合い|調和|同情|対称
wool	羊毛|毛糸|毛織物
dementia	認知症|痴呆症(の)
fertility	多産|繁殖力があること
trustee	受託会社|受託者|被信託人|管財人
eternity	永遠
grocery	食料雑貨類|食料雑貨店
psychiatric	精神医学の
investor	投資家
fantastic	風変わりな|異様な|奇怪な|空想的な|気まぐれな|幻想的な
jealousy	ねたみ|しっと|ジェラシー
irrigation	潅がい|潅漑|洗浄
destine	運命づける|～ということになっている
freeze	凍る|凍らせる|氷結→凍ったようにピタッと動きを止める
fox	キツネ|狐|狡猾な人|すごい美人
helmet	ヘルメット
reading	読書力|読書|知識|学識|朗読|読み物
variant	種々の|異なった|相違する|一致しない|変種の|変化
pharmaceutical	製薬の|薬剤の|薬
maker	製造業者|創造主
theirs	彼らのもの
depict	(いきいきと言葉で)描写する|叙述する|描く
tribal	部族の
sunset	夕焼け空|日没|終局
orgasm	オーガズム|激情
backwards	=backward
utterance	発声|口に出すこと|発言|話ぶり
cardiovascular	心臓血管の|心血管|心臓血管
incentive	刺激的な|鼓舞する|激励|動機|奨励金|刺激|動機づけ
converge	一点に集める|収束する|集まる|合流|一点に集まる
mobilize	動員する
erosion	浸食|腐食|目減り
paradox	逆説|矛盾|矛盾しているように見える人(物)
substitution	置き換え|代用|代用品
foul	不正な|反則の|不潔な|腐敗した|(天候が)荒れもようの|(綱など)もつれた|下品な|(野球)反則の|ファウルの
bargain	堀り出しもの|駆引きする|交渉する|契約|安い買物
humour	humorのUK式綴
unite	結合する|結合させる|を一つにする|連合させる|一体となる|合体する
vertex	最高点|頂上|山頂|頭頂
supplier	原料供給国|供給者|仕入先|業者|供給業者|納入業者
prohibition	禁酒法時代|禁止
oppose	反対する
practitioner	開業医師|熟練家
precursor	先駆者|先駆物質
heel	のすぐ後に続く|かかと|かかと状のもの
lamb	子羊|柔和な人
notify	発表する|通知する|告知する|届け出る|広告する
anonymous	匿名の
fragile	壊れ物
delightful	喜びを与える|愉快な|楽しい
scripture	(常に複数形で)聖書(の一節)
attach	くっつける|付属させる
linen	亜麻布|亜麻糸
meter	メートル
allowance	協定損害率|～料|割当額|手当|支給金
classify	分類する
alley	路地|alley cat 野良猫|おはじき(遊び)
manufacturer	メーカー|製造業者
navy	(色)ネービーブルー|海軍|海軍力|海軍軍人
invoke	思い起こさせる|(権威あるものを)引き合いに出す|(法律など)に訴える|懇願する
reflective	反射による|反射する|照り返す|考え深い|内省的な|考え込む
offering	提供する|上演|贈り物|販売
eligible	資格のある|望ましい|適任者
administer	施行する|管理する|与える
economically	経済的に|節約して
sanction	許可|拘束|賛成|認定(する)|(複数形で)軍事的･経済的制裁措置
biography	一代記|伝記
preacher	説教者|説教師|牧師|伝道者
bully	いじめる|いじめっ子
celebrity	有名人|名士|名声|テレビによくでる有名人
literal	文字の|文字通りの|融通のきかない|事実に忠実な|誤植
navigation	航海学|航空学|航海術|航海|航空|航行
intentional	計画的な
unfamiliar	なじみのない
rupture	破裂(させる)|裂け目|不和|国交断絶
lament	悲しむ|嘆く
aboard	〜に乗って
massage	マッサージ|あんま|按摩術|もみ治療
distal	末端の|先端の
resentment	憤慨|恨み|憤り|立腹
outdoor	戸外の
disciple	弟子
cautious	注意深い|用心深い
juvenile	少年少女(向き)の|若い|少年の|少女の
lag	遅れる|懲役に処する|遅延|前科者
beta	(第2ギリシア文字)ベータ|Β|β|ベータ星(星座の中で2番目に明るい星 cf|α星)
fiercely	獰猛に
recruitment	募集|採用
hypertension	高血圧(症)
prohibit	禁止する|を禁じる|を制止する|を妨げる|予防する
plainly	はっきりと|明らかに|全く|率直に|質素に
adolescent	青春期の
accelerate	の速度を速める|加速する|速める|促進する|増進する
accumulate	積み重ねる|蓄積する|集める
refugee	亡命者|難民
haunt	しばしば訪れる|出没する|とりつかれる|幽霊|～の脳裏に刻み込む|(例|Haunted houseお化け屋敷)
vampire	吸血鬼|人を食いものにする悪人
dental	歯の|歯科(用)の|歯音(の)
upgrade	上り坂|(質を)よくする|グレードアップ(和製英語)
antenna	アンテナ|空中線|antennae(antennaの複数形)(æntɛ́ni)(動物の)触角|触毛
makeup	組み立て|構造|性質|化粧
cruise	周遊観光船|航行する|巡航する|歩き回る
balcony	バルコニー
perch	とまり木|高い地位|運転台|郊外|限界|高い場所に位置を占める|パーチ(スズキの類)
trait	特性|特|特色|特徴|習性|一筆
superficial	うわべだけの|表面の|平方の|皮相な|(息が)浅い
chuckle	くすくす笑う|一人で笑う
monastery	修道院|僧院
collector	光捕集器|収集家|集金人
jerk	急にぐいと引く|むだに時間をつぶす|バカ|愚か者|世間知らず(若い人が用いる)
muscular	たくましい|筋肉の|力強い|強健な
textile	織物(の)|編み物(の)
bitterly	ひどく|はなはだしく|冷酷に
formulate	定式化する
morally	恐らく|常識的に|道徳上
initiation	開始|着手|創始|手ほどき|奥義伝授|入会(式)
kernel	核心|核|仁
globalization	グローバル化
brutal	けものの|残忍な|野蛮な|無茶な
skeleton	がいこつ|概略の|骨格|骸骨
rightly	正しく
chiefly	とりわけ|主に|たいてい
antibody	免疫体|抗体
transplant	移植|移住|移住者|移植された植物|を移植する|移住させる|移住する
torch	たいまつ|光|カンテラ
mob	群衆|暴徒|群れ|大衆|暴力団|マフィア|暴徒の群れ|群がり騒ぐ|襲う|群がる
avenue	並木道|大通り
linkage	関連|連関
rhetorical	修辞学の|修辞的な(上の)|美辞麗句の
sanctuary	聖地|聖域|庇護|神殿|保護|鳥獣保護区域|安らぎの場所
scroll	スクロールする|巻き物|渦巻模様
quantify	量を定める
cushion	クッション
mimic	をまねる|まねてからかう|模倣者|偽の|模倣の|模造の
elimination	削除|除去|予選|排除|排泄|淘汰|消去
consciously	意識的に
pavement	舗装道路|舗装|敷石
heterogeneous	異なる|異質の|異種の|異性の
swarm	いっぱいになる|群がる|群れ|昆虫の群れ|群衆
weaken	を弱める|を薄める|弱る
ambiguous	あいまいな|両義にとれる|不明瞭な
vanish	消える|見えなくなる|消音 
penetration	侵入|進出|広告効果|貫通|浸透|洞察力
educate	を教育する|(教養など)を養う|(動物など)を仕込む
wrath	激怒|憤怒|復讐|神の怒り
theft	盗み|窃盗罪|窃盗(罪)|盗塁
downtown	下町
supra	越えて|上に
confrontation	対決|直面|直面すること
mutation	突然変異|変化
obstruction	じゃま|障害|妨害|閉塞(症)
wireless	無線の|無線電信
explode	爆発させる(する)|打破する|破裂する|感情が激発する|評判を覆す
stray	はぐれた|道に迷った|話題が本筋から外れる|迷子|浮浪人(stray sheep迷える羊)
contamination	堕落させるもの|汚すこと|よごれ|汚染|悪影響|汚染物
migrant	移住者|移住性の
erect	直立した|強ばった|勃起した|組み立てる
cite	引用する|列挙する|を引き合いに出す|特記する
prevalent	普及した|流行の|一般的な|有力な
visualize	目に見えるようになる(する)
recurrent	再発する|反復
ambassador	大使|使節
surround	を取り囲む|サラウンド
scrutiny	精密な調査|精査
secretion	分泌(物|液)|隠匿|分泌物
quasi	に準ずる(resembling)
dumb	口のきけない|おしの|唖然とした|黙っている
rumble	(車などが)がらがら通る|ごろごろ鳴る|とどろく|ゴロゴロ(雷･腹の音)
permanently	永遠に|不変に|永久に
retrieve	検索する|引き出す|取り戻す|償う|回収する|回復する
setup	装備|構成
dissolve	溶解する|解散する|取り消す|溶かす
lazy	怠惰な|のろのろした|眠気を誘う
catalogue	目録を作る|カタログ
supernatural	超自然の
uncommon	まれな|珍しい|異常の|非凡な|非常に
scrap	屑鉄|屑|小片|断片|切り抜き|くず|をくずにする･解体する|捨てる
analytic	分析的な|分析の|解析幾何学
subsection	小区分
trench	にみぞを掘る|塹壕を掘る|掘る|塹壕|堀|掘割
transcription	写すこと|複写|転写|コピー
lattice	格子
madness	狂気|熱中|熱狂
monopoly	独占|専売|専売品 
uptake	理解|理解力|取り込み|摂取
prevail	流行する|勝る|普及する|効果がある|勝つ|克服する
rental	賃貸しの|使用料
propagation	伝達|伝搬|増殖|繁殖|宣伝|普及|蔓延|遺伝
pat	適切な|すっかり|軽くたたく(こと)|なでること|軽くたたく音
grim	残忍な|厳格な|断固とした|気味の悪い|(表情が)険しい
wander	歩き回る|ぶらつく
conductivity	伝導性(力･率･度)|導電率
inquire	尋ねる(=enquire)|質問する
learner	学習者
decomposition	分解|腐敗
pathology	病理学|病理|病状|前足で掻く|蹄で掻く
brass	真ちゅう|真鍮(色･製品)(の)|黄銅|ずうずうしさ|お偉方|大物
immortal	不死の
epic	叙事詩の|英雄的な|叙事詩(のような)|大作|超大作
timely	適時の|時期を得た|折りの良い|折りよく
procure	獲得する|を得る|を手に入れる|売春婦を周旋する
scaffold	足場を設ける|(建築場の)足場|絞首台|処刑台|(野外の)組立て舞台
earthly	地球の
dough	(俗)現金|生練り粉|パン生地