handler	トレーナー|調教師
eds	イーディーエス
reproduce	を生殖させる|を複製する|を模写する|を再生する
computational	計算の
greenhouse	温室|温室効果の|温暖化の
dub	(あだ名･愛称)をつける|肩書きを与える|(国王がknightの爵位授与式で)～の肩をたたいてナイトの位を授ける|突く|ダビング(する)|(俗)不器用|へたくそ
decimal	10進法の|小数
waterproof	防水の|防水布|レーンコート|防水服
hug	抱擁|抱きしめる|凝(こ)っている
passive	消極的な|受動的な|活動的でない|無抵抗の|受動態の
reggae	レゲエ(西インド諸島起源のロック音楽)
sweater	セーター
wagon	乳母車|荷馬車|ワゴン
interpreter	通訳
formulation	公式化|公式表示
evident	明らかな|明かな
cousin	いとこ
sweat	汗水たらして働く|汗をかく|湿気をおびる|汗|湿気|(俗)ぞうさなく|簡単に(easily)
wipe	拭く|をふく|ぬぐう|ふき取る|一掃する|ふくこと
painter	画家|ペンキ屋|塗装工
cumulative	累積の|累積|次第に増加する
crane	ツル|鶴|クレーン
arbitrary	独断的な|任意の|気まぐれの|恣意的な|不定の
prominent	目立った|重要な|著名な|突出した|浮き彫りの
titanium	チタン
irs	国税庁
sediment	沈澱物|沈殿物|堆積物
superintendent	監督(指揮)する|監督者|最高責任者|監督･指揮する
recorder	レコーダー|録音機
occasional	時々の|予備の|ときおり|時折の|特別な場合のための|臨時用の
interference	さしさわり|衝突|妨害|障害|干渉|邪魔|混信
booklet	パンフレット|小冊子
citizenship	市民権
posting	登記|一束の郵便物|転記|任命|配属|登録されたもの|投稿
hedge	保険つなぎ|ヘッジ取引|行動を妨げる|生け垣(を作る)|垣根|境界|防御物
idle	遊んでいる|怠ける|怠惰な|仕事のない|何もしない|暇な
tragedy	悲劇|惨事|悲劇的物語|悲惨な出来事
flex	(関節など)曲げる|可撓(とう)線|電気コード|融通のきく|適応性ある
resin	(rézn)|(樹脂|脂|松脂|松ヤニ|(=rosin)
cascade	滝|滝のように落ちる|カスケード|波状レース飾り|(菊の)懸崖づくり|(電気)縦つなぎ
ramp	ランプ(高速道路出入口)|建物の連絡用傾斜路
explicitly	明示的|(反義語)implicitly
petite	(女性が)小柄な|小柄でこぎれいな|小柄で均整のとれた
trigger	誘発する|引き金|制動機|ばね止め|誘因|きっかけ
triumph	大勝利|勝利|大成功|功績|大業績|勝ち誇り|勝利をおさめる|成功する
relieve	を救う|を和らげる
informative	知識(情報)を与える|有益な
nil	ゼロ
scuba	スキューバ|水中自動呼吸機器
shepherd	シェパード(犬種)|羊飼い|牧師|の番をする|を指導する
utilization	利用
induction	就任式|帰納法|誘発
estimation	見積|評価|判断
dosage	投薬|調剤|1回分の投薬(服用)量|適量|添加香味料|用量決定
courage	勇気
yeast	酵母|イースト菌
halt	停止させる|ためらう|停止|休止|中断|停車場
batman	(映画)バットマン
chromosome	染色体
fleece	からだまし取る|巻き上げる|(一匹分の)羊毛
raven	ワタリガラス(不吉の兆しとされる)|(一般に)カラス属の各種(大ガラスなど)|略奪する
consistency	一貫性|一致|濃度|堅さ|粘り
hearing	審理|公聴会|聴力
efficiently	能率的に|効果的に
textbook	教科書
metallic	金属の|金属性の
crossword	クロスワードパズル
yarn	ほら話|糸|毛糸|編み糸|旅行者の話
caller	訪問者
dame	セクシーな女
peaceful	平和な|穏やかな|平和を好む|おとなしい
rib	あばら骨|肋骨|肉片
corridor	廊下
trophy	戦利品|賞品|戦勝記念品|トロフィー
supplemental	補足の
emerald	エメラルド
recognised	認識
sheriff	郡保安官
belle	舞踏会の花|美人
corrupt	堕落させる|堕落した|買収された|崩れた|汚れる
uh	ええと|huh(話がつかえた時など)
grape	ブドウ|深紫色
prix	グランプリ
astrology	占星術
hungry	空腹の|飢えている
bald	ありのままの|はげた|単調な|毛のない
insure	に保険をかける|保険に入る|保証する
talented	才能ある|才能のある|秀才|有能な
feather	羽
precisely	精密に|正確に|几帳面に
appoint	を任命する
emperor	天皇|皇帝
acne	にきび|座瘡
ballet	バレエ(団･曲)
drift	漂流する|押し流す|ドリフト|趣旨
apt	の傾向がある|しがちな|適切な|利発な|機敏な
widespread	行き渡った|広げた|広範囲に及ぶ|広く行きわたった|いっぱいに広げた(翼)|広まった
sapphire	サファイア|青玉(9月の誕生石)|サファイア色(の)
disappear	見えなくなる|うせる|消滅する
shrink	しりごみする|縮まる|減る|恐れる|避ける|(俗)精神科医
optimum	最適(の)|最高条件(の)
pasta	パスタ
handset	送受話器
alike	差別なく|同様に|一様に
cove	無闇に欲しがる|断崖の窪み
homeless	家のない
horrible	ひどくいやな|恐ろしい|身の毛もよだつ
insurer	保険者
drainage	排水
cement	セメント|つなぐもの|接着剤|絆|固める
collision	衝突
delegate	(仕事を)人に任せる|代理を立てる|委任する|代理人|代表|使節|代議員
smash	スマッシュ|粉々にする|強打する|強打|破壊|破産|バリッ|ガチャン|木が裂ける音
abide	がまんする|とどまる|待つ|従う|住む|規則を守る
gasoline	(米語)ガソリン
mud	泥|つまらぬもの
atmospheric	大気の
heath	ヒース(植物)|(ヒースのおい茂った)荒れ野
penetration	侵入|進出|広告効果|貫通|浸透|洞察力
ppm	百万分の1単位|parts per millionの頭文字|百万分率
mailbox	郵便ポスト
glue	を接着剤でつける|に集中する|にかわ|接着剤
bash	大打撃|強打する|いじめる|叩く
parental	親の|親にふさわしい
transmitter	送信器|送る人|伝達者|伝達装置|譲渡者|伝導物|送信機|送話器
publicity	公共性|公表|一般に知られていること|周知|評判|公開
cooker	料理用の|調理道具|調理用のくだもの
criterion	(pl|criteria)|規準|基準|(判断･批評の)標準|特徴
deadly	命にかかわるような|致命的な|執念深い|死んだような
restart	再開|を再始動する|～を再起動する
dumb	口のきけない|おしの|唖然とした|黙っている
momentum	はずみ|いきおい|(物理)運動量|契機|弾み|惰性
footnote	脚注|補足説明
picnic	ピクニック|戸外での食事|行楽の弁当|行楽|楽な仕事
vcr	ビデオデッキ
rouge	ルージュ|紅|頬紅|赤色の|口紅
keen	しみじみとした|鋭い|鋭敏な|熱心な
electro	電気受容器
jenny	紡績機|移動式起重機|ロバの雌
gossip	うわさ話をする|うわさばなし|陰口|悪口|噂
walnut	クルミ|クルミ材
cursor	位置表示機構|線を引いたガラス板|カーソル
tremendous	ものすごい|途方もない|途方もなく大きい|ばかでかい
convertible	変えられる|転換可能な
continuity	連続性
validity	有効期間|正当性|妥当性|有効性|効力|有効|合法性
trustee	受託会社|受託者|被信託人|管財人
psi	(第23ギリシア文字)プサイ|Ψ|ψ
swift	迅速な|迅速に|敏速な|非常に速い
postcard	郵便はがき
melody	メロディー|旋律|美しい音楽|音調
transparency	透明度|透明性
cathedral	大聖堂|司教座にある
copier	複写器|模倣者
softball	ソフトボール
scholar	学者|奨学生
brook	小川
diaper	おむつ|ひし形模様(のある布)
internationally	国際的に
geology	地質学|地質
torrent	ほとばしり|急流|激流|奔流|豪雨|土砂ぶり|連発
carpenter	船大工|大工|木工
vegetation	(集合的に)植物|植生|植物の発育|無為の生活
controversy	論争|討論
crow	からす|鳴く
hostel	簡易宿泊所|ホステル|宿泊所|合宿所
insulin	インスリン(糖尿病薬)
compute	算定する
mileage	総マイル数|マイル表示距離|マイル当たり料金|利益
specially	特に|特別に
pale	色を失った|青ざめる|青白い|(色に関して)薄い|迫力がない|薄くなる|見劣りする
ambient	周囲の|ぐるりを取り巻く
covenant	契約する|(二国間または多国間の)契約|盟約|誓約|約款
feat	偉業|功績|際だった行い|achievement|妙技|離れ業
xerox	コピー|ゼロックス|コピー
steak	ステーキ
being	生き物|存在|実在|生存|生命
plaque	額|飾り版|斑|歯垢|血小板|(金属･陶器の)飾り板|(記念の)銘板|ブローチ
cannon	大砲
reliance	依存|信頼
whisper	ささやく|内緒話(をする)|ざわめく|ささやき声|さわさわという音(をたてる)
simplify	単純化する|を単純にする
cone	円錐|円すい形|火山すい|松かさ|(アイスクリームの)コーン
elective	(米語)選挙で選ばれた|選択科目
infectious	うつりやすい
prostate	前立腺(の)
behave	ふるまう
bypass	迂回する|バイパス
explosive	爆発しやすい|爆発性の|爆発物
economist	経済学者
biblical	聖書の|聖書にある|聖書のような
conscious	自覚している|気付いている|慎重な|意識のある
substrate	基板|(生化学)基質(酵素の作用で化学反応を起こす物質)
nitrogen	窒素|元素記号N
saddle	課す|サドル|負わせる|鞍|に鞍をつける
referee	(特に決定･解決を)委託された人|調停者|審判|レフェリー
predator	食肉動物|略奪者|捕食者
auburn	赤褐色(の)
navigator	ナビゲーター|航海長|操縦者|海洋探検家
willow	ヤナギ|柳|やなぎば色
preschool	学齢前の|就学前の|幼稚園
widget	規格品|小型装置|部品
differently	異なって|異なるように
firewire	ファイヤーワイヤー(AV機器やコンピュータを接続する高速シリアルバス規格)
assay	含有量(率)を示す|試金(含有量の検査)する|評価する|検定する
garment	衣服の一品|衣服
musician	音楽家
override	覆す|無効にする
operative	働く|活動する|(法律が)効力のある|(薬が)ききめのある|有効な|職人|スパイ
fatty	脂肪質の|油っこい|脂肪性の|脂肪の|デブ
retrieval	取り返し|挽回|回復|修正|検索
sally	出撃する|突撃|小旅行|打って出る|反撃する
scary	おどろきやすい|恐ろしい|驚きやすい|臆病な
tendency	傾向|癖
terrain	(自然地理･軍事上から見た)地域|地勢|地形
charitable	慈悲深い
remainder	(算数)余り|残余|残留者|残り物|遺跡|継承権
opening	開いている|開始|始め|広場|穴|空き|開始の|すきま|開き
researcher	研究者
transplant	移植|移住|移住者|移植された植物|を移植する|移住させる|移住する
nominee	任命された人
safeguard	予防手段|防護手段(対策)|緊急輸入制限
prejudice	先入観|害|偏見|先入主|偏愛|ひがみ|損害|被害|迷惑
sperm	精子
pork	豚肉|(US俗語)援助金|職務|利権
violin	バイオリン|バイオリン奏者
emerge	現れる|台頭する
viral	ウイルスの|ウイルス起因の
gale	強風|疾風|突発
competency	有能さ|コンピテンシー
realtor	不動産業者
pedal	ペダル(の)|のペダルを踏む|足の
champagne	シャンパン酒
chassis	(人･動物の)胴体|シャーシ|車台
stationery	文房具|便箋
pediatric	小児科の
jade	ヒスイ|痩せ馬|疲れ果てさせる
redhead	赤毛の人|大学1年生
subset	部分集合
corpus	文章の収集|集成|死体
daisy	(植物)ヒナギク|すばらしい物(人)|ホモ
herb	草本|草|香料(薬用)植物|(俗)マリファナ
alot	たくさん
dependence	依存|従属
scrub	ごしごし洗う(こと)|ごしごし磨く(こと)|つまらぬ人|低木の雑木林
destiny	運命
unauthorized	許可されていない|権限のない|独断の
competent	有能な|合法的な
lazy	怠惰な|のろのろした|眠気を誘う
lick	打つ|負かす|全速力で進む|(舌で)なめる|なめること|一なめ分|(a lick)少し|少量
apparatus	装置|器具|機構|機関|組織
spine	脊椎|脊柱|背骨|針|とげ
contributor	寄付者
grateful	ありがたくおもう|感謝して|楽しい
gradually	ゆっくりと|だんだんと|徐々に
desirable	魅力がある|価値のある|望ましい|好ましい
journalist	ジャーナリスト|新聞記者
memorandum	備忘録|覚え書き|メモ|摘要|規約|定款
lend	貸す
pharmacist	薬剤師
mime	物まね師|パントマイム|真似る|パントマイムで演じる
polyester	ポリエステル|ポリエステル樹脂|ポリエステル繊維
afterwards	のちほど|後で|逐って|後程|後ほど|おって|あと|追って
webpage	Webページ
garlic	ニンニク
tooth	歯|(複数形はteeth)|(食物の)好み
interfere	利害が衝突する|相容れない|妨害する|邪魔する|仲裁する
advancement	傷心|進歩|促進
vineyard	ぶどう園|(特に高度の精神的な)仕事場
confront	に立ち向かう|直面させる|直面する|立ち向かう
marry	結婚する
sewer	下水道|下水管
bark	howl遠ぼえする|whineクンクンなく|yelp|yapキャンキャン吠える|growl怒って唸る|snarl歯をむき出して唸る)|樹皮
turnover	(商品などの)回転率|離職率|売り上げ
ozone	(化)オゾン|新鮮な空気
contour	等高線|輪郭|外形|外観
casa	(スペイン語)カーサ|家
bloody	血なまぐさい|ひどく
samba	サンバ
irrigation	潅がい|潅漑|洗浄
sexuality	性的要素|性別|性欲|性機能
arbitration	仲裁|調停
redistribute	再配分する|再分配する|分配し直す
retire	退職する|引退する
cologne	コロン|オーデコロン
inbox	受信トレイ
focal	焦点の
bibliographic	書誌の
distant	時間が隔たった|かすかな|遠い|離れた|敬遠した
hardwood	堅木|堅材
milestone	マイル標石|画期的事件
choir	聖歌隊|合唱団|chorus|合唱隊
bucket	バケツ
magical	魔法の|魔法の力による|不思議な|魅惑的な
swan	白鳥|きわだって美しい人|(俗)美人
manually	手動で
antigen	抗原
hydraulic	水力の|水圧の|油圧の
lance	切開する|槍
blah	不快な|憂鬱な|つまらない(こと)|blah-blah-blah などなど, かくかくしかじか|Blah! ちぇ!, くだらない!
peso	ペソ(通貨, 複数形pesos)
casualty	死傷者|戦争犠牲者|被害者
appellant	上訴人|控訴人
yearly	毎年の|例年の|年1度の|その年だけの|毎年|年1度
numeric	数|番号
manipulate	操作する|ごまかす
hollow	くぼんだ|中がからの|空の|うつろな|くぼみ|穴|中空の
writing	書く|執筆|筆跡|書くこと|書かれた物|書き方
characterization	特性づけ|性格描写
yen	円(日本の通貨単位)|熱望|あこがれ|切望する
usher	受付|(結婚式の)先導役|座席案内係|誘導する|案内する
mpg	miles per gallon 1ガロンあたりの走行マイル数
cork	コルク製品|コルク
enroll	登録する|名簿に記載する|会員にする|enrol
carb	炭水化物(carbohydrateの略)
rotary	回る
importantly	もったいぶって|重要で
moss	コケ|こけ|沼|コケで覆う
lecturer	講演者|講師
pretend	ふりをする|make believe
gage	質|抵当
empirical	経験的な|経験によって立証できる|経験主義の|実験に基づいた
discrete	個々の|分離した|別々の|別個の|不連続の
beginner	初心者
savage	野蛮人|無礼な|下品な(ラテン語silvaticus｢森の｣から)|獰猛な|未開の
cubic	3次方程式|立方体の
deaf	聞こうとしない|耳が聞こえない
beg	施しを請う|(熱心に)請う|頼む|懇願する|求める
kinase	キナーゼ|リン酸化酵素の一種
ritual	慣習の|儀式(の)|礼拝式|儀式的な行事
distortion	歪み|ゆがめること|歪曲
rig	艤装する装備する|談合する|八百長する|トレーラートラック|掘削装置
fuse	ヒューズ|信管|導火線|にヒューズを付ける|溶かす|溶ける|融合･連合する
crawford	クロフォード|クロフォード
historian	歴史家
vase	花瓶|壷|びん
holocaust	ホロコースト|ユダヤ人大虐殺
zombie	ゾンビ|zombi|ヘビ神|(俗)機械的動作をする人
reproductive	再生(再現)の|生殖の|多産の
sticky	ねばねばする|粘着性の|べとべとする|どろりとした|蒸し暑い
wade	苦労して進む|(ぬかるみ･雪道を)苦労して渡る
burke	締め殺す|(議案などを)握りつぶす|(うわさなどを)もみ消す
secretariat	書記|秘書室
shortage	数量の不足|不足|欠点
stool	丸椅子|腰掛け|足のせ台|2便器|大便(=excrement)
chevy	悩ます|煩わす|嫌がらせ|責めさいなむ|責める|いたぶる|責苛む|煩わせる|苛む|苦しめる
elimination	削除|除去|予選|排除|排泄|淘汰|消去
toss	を投げる|寝返りをうつ|を激しく動揺させる
jumper	跳躍する人|跳躍選手|跳びはねる虫(ノミ他)|障害馬|(ブラウスなどの上に着る)プルオーバー|作業用上着 (日本語のジャンパーはwindbreaker, jacket)
marijuana	マリファナ
adaptive	適用可能な
wheelchair	車いす
convergence	一点に集まること|収束|輻輳
phantom	幽霊|幻|幻影|幻像|人体模型|幻の|想像上の
humanitarian	人道主義者|人道主義の
nirvana	サンスクリットの仏教用語で|涅槃･解脱のこと
til	〜まで
colon	コロン(:)|植民農業者|大農園所有者|コロン(コスタリカなどの通貨単位)|結腸(盲腸・直腸をのぞいた大腸の大部分)
malpractice	背任行為|職務上の過失|医療過誤|不正治療
generous	気前の良い|気前のいい|豊富な
madness	狂気|熱中|熱狂
monk	修道僧|修道士|修道師
pony	ポニー|小型の馬
mama	おかあさん|ママ|母様
primitive	原始的な|原始人|原始の|昔の|太古の|最初の|初期の
cardiovascular	心臓血管の|心血管|心臓血管
cardiac	心臓(性)の|心臓病の(患者)|強心薬|心臓病の患者
salvation	救世(主)|救済|魂の救済|救済物|(罪からの)救い
jerk	急にぐいと引く|むだに時間をつぶす|バカ|愚か者|世間知らず(若い人が用いる)
elevator	エレベーター
umbrella	傘|雨傘
brutal	けものの|残忍な|野蛮な|無茶な
velvet	ベルベット製の|ビロード|ベルベット|ビロード状のもの|丸もうけ
selective	選択の|注意深く選ぶ
zinc	亜鉛|亜鉛でメッキをする
removable	移動できる
anthropology	人類学|人間学|文化人類学
kinda	いくぶん|ちょっと|(類似語sorta)
funky	悪臭のする|かびくさい|(ジャズ)ファンキーな
lotion	ローション|外用水薬|化粧水
suburban	偏狭な|郊外の
prosecution	起訴|告発|検察当局|遂行|実行|追求
clutch	を掴む|にしがみつく|把握|クラッチ|ピンチ
booster	昇圧器
banquet	晩餐会|宴会
widow	未亡人|余分の手札|未亡人になる
proudly	高慢に|威張って|堂々と|立派に
pix	写真|絵|(pic=picture)の複数形
mic	マイク
pulling	引いている
obesity	(医)肥満|肥満体
closet	密談させる|戸棚|人に知られていない|隠れた
fracture	骨折する|骨折|破砕する|割れ|砕け|破砕(する)|破る
hike	ハイキングをする|引き上げる|値上げする|increase|raise
cleanup	掃除|一掃|浄化運動|(俗)大もうけ|4番打者(の)
hepatitis	肝炎
maiden	少女|未婚の|初めての|処女
nationally	全国的に
tomato	トマト|女|娘
peptide	ペプチド|決まった順番で様々なアミノ酸がつながった分子
heal	なおす|治す|いやす|救う|いえる|治る|治癒する
imply	を(暗に)意味する|ほのめかす
unwrap	包装を解く
sic	(疑わしいまたは誤った文章を) 原文のまま引用
trauma	精神的外傷|精神的ショック|(日常生活に支障を生じるような)深い心の傷
surrender	降伏(する)|を放棄する|引き渡し|明渡し(する)|自首
impairment	(価値･美点･健康を)減じる|害する|そこなう|傷つける
bacterial	バクテリアの
continuously	連続して|引き続き
strawberry	イチゴ(色)
liaison	つなぎ|連結|連絡|連絡窓口|連絡係|密通
vine	つる|ぶどうの木|つる植物|つる草
substitution	置き換え|代用|代用品
painful	痛い|骨の折れる|苦しい|切ない
examiner	試験官
nowhere	どこにも～ない|どこにもない場所
residual	残余の|剰余の|残りの
lime	わなをかける|石灰|石灰をまく|ライム果|シナノキ|鳥もち
distress	苦しめる|苦痛|苦悩|困窮|遭難
lately	近ごろ|最近
vein	調子|静脈|血管|葉脈|木目|鉱脈|地下水脈|筋をつける
forgive	許す|借金を帳消しにする
dense	密集した|濃密な|深い|鈍い|濃厚な|緻密な|濃い
likewise	その上に|さらに|同様に
vibration	心の動揺|振動する(させる)こと|動揺|(米俗)感じ
introductory	紹介の
councillor	(UK英)評議員(=councilor)
viewpoint	見解|見える地点|観点
gum	ゴム糊で張付ける|ゴム|生ゴム|チューインガム|ゴムのり|歯肉|歯ぐき
likelihood	ありそうなこと|見込み|有望さ|有りそうな事
wc	水洗便所|water closet
circus	サーカス
denote	示す|表示する|のしるしである|意味する
disciplinary	訓練上の|規律上の
sympathy	同情|賛成|共感|共鳴
affair	出来事|事務|仕事|問題|事件|事柄
beside	〜のそばで
expiration	満了|満期
playground	運動場|遊び場|行楽地|活動の場
pike	カワカマス|山頂|やり|ほこ|尖峰|やりやほこで殺す
hypothetical	仮定上の|仮定の|仮想の|仮説の
wan	青ざめた|病弱な|かすかな
complimentary	あいさつの|無料の
bisexual	両性愛の|両性具有の|雌雄両生の
contamination	堕落させるもの|汚すこと|よごれ|汚染|悪影響|汚染物
reimbursement	＜reimburse|弁償
concord	調和|一致|協定|(国家間の)意見の一致
unnecessary	不必要な|余計な|無益な|無用な
dramatically	劇的に
buffet	打撃|(風波･運命の)翻弄|打つ|食器棚|ビュッフェ･立食
verb	動詞
peanut	ピーナッツ|詰まらない物(人)|ピーナッツ入りの|小さい子供
goddess	女神
forensic	法廷の|法廷で用いる|弁論の|討論の(polemic)
maid	少女|お手伝い|女中
threaten	をおどす|を脅迫する|をおびやかす
fatigue	疲労|疲労する
flour	小麦粉|粉末
tot	ちび|小児|子供|幼児|ちびっ子
conditioner	空調(冷暖房)装置
prosecutor	起訴者|検事|検察官
induce	勧誘する|人に勧めて～させる|を引き起こす|(反)exclude|除外する
scandal	スキャンダル|醜聞|恥ずべきこと
explode	爆発させる(する)|打破する|破裂する|感情が激発する|評判を覆す
peripheral	周辺の|末梢性の
negotiation	交渉|話し合い|(小切手など)譲渡|談判|流通
domino	ドミノ服(仮装舞踏会用)|ドミノ牌|(単数扱い)ドミノ(28の牌の点合わせ遊び)
regret	を後悔する|残念に思う|後悔|遺憾
confidentiality	信任の厚いこと|秘密性|機密主義|機密保持
electoral	選挙の
infringement	違反|違背|侵害
alternatively	二者択一的に|代りになるべき物として
hunger	空腹|飢え|飢饉|渇望
dinosaur	恐竜|大きすぎて役に立たない(時代遅れの)人(もの)
hatch	(ひなを)かえす|昇降口|孵化する|ハッチ|床窓
dissertation	論文|学位論文|学術論文
gently	育ちがよく|穏やかに|徐々に
spoon	スプーン
controversial	議論好きの|議論の|論争上の
foil	くじく|裏をかく
feeder	飼養する者|食べる人|餌入れ|ほ乳瓶|原料供給装置|給電線|支線
skull	頭蓋骨|頭
peach	桃(の実)|桃色
lone	ひとりぼっちの|連れのない|孤独な|寂しい|人里離れた|独身の
voyage	航海|船旅|飛行|航海記|航海する|(海を)渡る
notable	注目に値する|著しい|著名な|名士|著名な事物
petitioner	原告|請願者
sedan	セダン|セダン型自動車
aw	(抗議・嫌悪などを表して)おお|うわあ
elf	(小)妖精|小人|小妖精
defensive	防御の
accelerate	の速度を速める|加速する|速める|促進する|増進する
pear	西洋ナシ|西洋梨
acknowledgement	(UK綴)承認|通知|自認|受取の通知|感謝|礼状|謝意
flasher	閃光を放つもの|点滅光|方向指示器|回転灯|露出狂
subaru	スバル(車名)
pouch	小袋|袋|を袋に入れる|ポーチ
vanilla	バニラ|バニラの実|バニラエッセンス
chancellor	ドイツの首相
cw	clockwise
nucleus	細胞核|核|心|中軸
practitioner	開業医師|熟練家
flute	フルートを吹く|フルート(横笛)
securely	安全に|しっかりと
commence	を開始する|始まる|を始める
keeper	守る人
trout	マス|鱒
derive	由来する|派生する|引き出す
din	騒ぎ|騒音
slate	石板|スレート(でふく)|候補に立てる|予定する(schedule)|酷評する
endless	絶え間のない
conditional	条件付きの|条件的な|(文法)条件文|条件語句(節･文)
arbor	高木|軸|あずまや
simulator	シミュレータ
bacon	『ベーコン』
hometown	故郷の町|現在住んでいる町
exhibitor	出品人|奨学資金寄贈者
ethnicity	民族性
patron	(仏語)パトロン|守護聖人|ひいき客|後援者
tote	トート(ふたのない箱)|(口語)運ぶ|背負う|合計する(up)
sack	解雇(する)|袋(にいれる)|袋の中身|大袋
manipulation	操作|巧みな操作|市場操作|ごまかし|触診
nod	うとうとする|うなずく|うなずいて承諾･命令する|うなずき|黙礼
getaway	(犯人の)逃走|(車･競争の)スタート
temporarily	仮りに|仮に|当座|一時的に
orchid	蘭(の花)
blond	ブロンドの|金髪の
replication	複製
endorse	裏書きする|保証する|推奨する|承認する|賛成する
tenure	在職期間|保有条件|保有期間|終身的地位
boyfriend	ボーイフレンド
spokesman	スポークスマン|代弁者
crib	ちっぽけな家|盗用|カンニングペーパー|カンニングする(和製英語)
carriage	乗り物|運搬|態度|4輪馬車
notation	表記法|記数法|表記|表示|注釈|記録|メモ
breeze	そよそよ吹く|微風|そよ風|動揺
intranet	イントラネット
conductor	添乗員|(バス･電車などの)車掌|導線|伝導体|揮者
renovation	修復
seq	Sequenceの短縮形|配列　他
relaxation	気晴らし|くつろぎ|息抜き|ゆるみ|弛緩|緩和
psychiatry	精神病学|精神医学|精神科
playback	録音(録画)再生(装置)
err	誤る(=error)
persistent	固執する|しつこい|持続する|永続的な|不屈の|頑固な|永続性の|不変の
absorption	吸収|吸着|吸着量
helper	助力者
ruin	を台無しにする|破滅させる|廃墟|後輩|破滅
manifest	明白な|明らかな|明らかにする|乗客名簿
inventor	発明者|創案者
subtle	かすかな|難解な|微妙な|繊細な|敏感な|陰険な|薄い
magnificent	壮大な|壮麗な|雄大な|崇高な|すばらしい|堂々とした|立派な|格調高い
spiral	らせん状に進む|らせん|螺旋状の|螺旋形のもの
colleague	同僚|仲間
promptly	すぐに|敏速に|即座に|ぴったり
courtyard	中庭
harmful	害をおよぼす|有害な
paintball	ペイントボール|ペイントボール
prozac	プロザック|抗うつ剤(商品名)
inhibit	することを禁ずる|を抑制する|妨げる
reign	支配する|主権を握る|在位期間|治世|御代|支配|統治|君臨
solicitor	懇願者|事務弁護士|勧誘員|個別訪問の販売員
neon	ネオン(元素記号Ne)
kw	キロワット
glucose	ぶどう糖
squeeze	締めつける|を絞る|圧迫する|強制する|規制|圧搾
competence	能力|権限
neural	(解剖)神経の(系)の
compass	を巡る|を取り巻く|コンパス|周囲|羅針盤|範囲|限界|適度
inequality	でこぼこ|不同|不等|不均等|不適当
badly	ひどく|悪く
excitement	刺激|興奮
honeymoon	新婚旅行(をする)|蜜月(期間)
keno	キーノ|ビンゴに似た賭博の一種
continually	ひんぱんに
collectible	グッズ|収集された
handmade	手作りの|手細工の
champ	をむしゃむしゃ食う(chomp)
reuse	再使用|再利用|リユース|再び用いる|再生する|再利用する
compensate	に補償する|補償する|補正する|補正を行なう
fuzzy	ぼやけた|微毛のある|けばだった|縮れた|ファジー理論
mailman	郵便集配人
biodiversity	生物の多様性
abundance	豊富さ|affluent|豊富な|多数|多量|発生量
migrate	移住する
deletion	欠失|削除|消去
liquor	溶液|液体|煮汁|を溶液に浸す|に酒を飲ませる|酒|アルコール飲料
diabetic	糖尿病の
verbal	言葉の|語の|文字通りの|口頭の|動詞の
bitter	苦々しい|悲惨な|苦い|ひどい
terminology	専門用語|術語|用語法|術語学
presently	まもなく|やがて|目下|只今
workflow	ワークフロー|作業の流れ
scarf	スカーフ|接合
mysterious	神秘的な|不可解な|秘密の
suppress	を抑圧する|鎮定する|抑える|を鎮圧する|を我慢する|を隠す
skateboard	スケートボード
peel	皮|をはがす|むける|はがれる|皮をむく|オレンジなどの皮
correspondent	文通する人|特派員|文通者|通信員
detention	拘留|拘置|阻止|居残り
revise	を訂正する|を変える|修正する|改正する
lynch	私刑|リンチ|私刑に処する|Merrill Lynch & Co|Inc|(メリル|リンチとも創業者の姓)|現バンク・オブ・アメリカグループの金融機関
couch	うずくまる|横たわる|長椅子|ベッド兼用のソファー
brace	突っ張り|支柱|引き締める|支える|元気を出す|元気づける
bluff	威嚇(する)|ぶっきらぼうな|荒っぽい|率直な|険しい
shallow	浅い|浅はかな
promoter	推奨者|発起人|発頭人|張本人|首唱者
borrower	借手
thereafter	その後|従って
erotica	エロティカ|性愛の文学作品
temporal	現世の|時間の|俗世の|束の間の|側頭の|時制の
sanctuary	聖地|聖域|庇護|神殿|保護|鳥獣保護区域|安らぎの場所
maturity	満期|成熟|十分な成長
firmware	ファームウエア|マイクロコード|ファームウェア|ファアームウエア
rave	夢中になって話す|たわごとを言う|どなる|わめく|怒号する
defect	不足|欠点|短所|欠陥|亡命する|他国へ逃亡する
qt	quiet|quantity|quart 他の略
awful	すざましい|すさまじい|恐ろしい
coupe	クーペ(2ドアの乗用車)
defender	防御者
asbestos	石綿|アスベスト(発ガン性物質)
crude	天然のままの|粗野な|露骨な|粗い|加工していない|不遠慮な
costly	高価な|損失の大きい
harassment	悩ます(悩まされる)こと|繰り返し悩ますこと|ハラスメント
spreadsheet	スプレッドシート|表計算ソフト
longitude	経度
aunt	おば
lea	草原|草地|牧草地
asterisk	星印
thorough	完全な|徹底的な|心からの|絶対的な|詳細な
inexpensive	費用のかからない
bakery	パン焼室|パン焼き場|製パン所|パン屋|ケーキ
certify	証明する
creature	動物|生物|生き物
ours	わたしたちのもの
aluminium	アルミニウム
webcast	インターネット放送
evanescence	(物・気持ちなどが)次第に消えていくこと
cheer	声援|を励ます
debit	借方(に記入する)|デビット
pyramid	ピラミッド|金字塔|尖塔状のもの|角錐|利乗り
lm	ルーメン
applet	アプレット
mambo	マンボ(を踊る)
designate	指定する|指摘する|示す|表す|指名する
legendary	伝説集|伝説の
asylum	亡命|避難|政治犯の庇護|隠れ家|保護施設|避難所|精神病院|孤児院|聖域
intern	拘禁|抑留する|教育実習生|インターン
beautifully	みごとに
hygiene	衛生|健康法
illusion	思い込み|幻覚|幻影|思い違い|錯覚|妄想|幻想
myrtle	ギンバイカ(結婚式等によく使われる)|ツルニチニチソウ 
poultry	家禽類|家禽
immunology	免疫学
departmental	部門の|省|局|課の|軍管区の
cooperate	協同する|協力する
sauna	サウナ|サウナ浴場
embroidery	ししゅう|刺繍
groundwater	地下水
sigh	ため息をつく|ため息(をつく)|嘆く|慕う
insulation	絶縁体|絶縁|絶縁材
streamline	流線型(の)|(仕事･組織など)を合理化する
collaborate	共同する|協力する|共同して働く|共同研究する
zoloft	サートラリン
frankfurt	フランクフォート|フランクフルト
prisoner	囚人|刑事被告人|捕虜
linkage	関連|連関
accession	追加|就任|増加|到達|即位|相続|取得
gown	ガウン|長上着|正服|法服
pier	防波提|桟橋|橋脚|窓間壁
cert	確実なこと|現実に起こること|必ず起きること|本命|本命馬
sufficiently	十分に
iris	(眼球の)虹彩(こうさい)|アヤメ|アイリス
altitude	高度|高さ
conceptual	概念上の
peg	くぎで止める|くぎ|かけくぎ|テントのくい|弦楽器のねじ|洗濯ばさみ
severity	厳格|重大度
loyalty	貞節|忠義|忠誠|誠実
hl	100リットル(=hectoliters)
overflow	からあふれる|氾濫する|あふれる|いっぱいになる|氾濫
artery	幹線道路|動脈
waist	腰のくびれ|ウエスト|胴着|ブラウス
instrumentation	計測(器)
elk	オオジカ|ヘラジカ
balcony	バルコニー
ob	オビ川|産科学|産科|ＯＢ
breathe	(を)呼吸する
congregation	集会|集合|会衆
alley	路地|alley cat 野良猫|おはじき(遊び)
locker	ロッカー|箱|冷凍庫|コインロッカー
constraint	強制|圧迫|束縛
cruiser	クルーザー|巡洋艦
paradigm	語形変化表|パラダイム|模範|典型
ranger	歩き回る人|放浪者|監視人|遊撃隊員
dominate	支配する|著しく目立つ
gut	(弦楽器の)弦|本能的な|本質的な|内蔵|中身|本質|勇気|ガッツ|体力|みぞ|路地|中身を取出す|はらわたを抜く|内部を破壊する
plantation	栽培場|大農場|大農園|植林地|植民地
rogue	わくぱく小僧|悪漢|ごろつき|詐欺師|悪党|いたずらっ子
theta	(第8ギリシア文字)シータ|Θ|θ
subjective	主体の|主観の|主観的な|主格の|主語の
goose	ガチョウ|(人)の尻(股)をつつく
judiciary	司法の
alphabet	アルファベット|初歩
dishwasher	皿洗い器(人)
faint	気絶する|卒倒する|弱々しい|ぼんやりした|弱い|かすかな|淡い|気の弱い
boxer	ボクサー犬|ボクサー
splash	ねる|をはねかける|バシャ|水のはねる音
countryside	田舎
stoke	(感情)をかきたてる|燃料をもやす|火をたく
warfare	戦闘状態|戦争|交戦|闘争|争い
inland	奥地の
granite	花崗岩(かこうがん)|御影石
nonfiction	ノンフィクション
discourse	会談|講演|論文|(文法)談話|話法
racism	民族優越観|人種差別|人種差別主義
oversight	監視|管理|取り締まり|見落とし|手抜かり
lien	先取特権|留置権|担保権
occupy	(場所･地位など)を占める
unused	使用されない|使わない|使ったことがない|新しい|不慣れの
dart	投げ矢|突進する|すばやく動く|飛んで行く|(衣服)ダーツ(ヒダ)をつける
alcoholic	アルコール中毒|アルコールの
daemon	悪鬼|鬼|悪魔(=demon, devil, Satan, fiend)
bestselling	最もよく売れている
aesthetic	(芸術の)美の|美学の|審美的な|趣味のよい|芸術的な
garnet	ガーネット|ザクロ石(1月の誕生石)|暗紅色
feast	祝宴|宴会|ご馳走|祭日|を大いに楽しむ|もてなす|ごちそうになる|ごちそうする
goodbye	さようなら(=goodby)
curl	縮らす|カール|(髪を)カールする
shooter	狩猟者|銃猟者|(連発)銃|写真(家)
justification	正当化
boil	煮えくり返る|沸騰する|ゆでる|沸く|煮沸する
forthcoming	近くにやってくる|すぐ手に入る|積極的な|近刊予定の
oversee	を監視する|を監督する|watch over
postgraduate	大学院生
vitro	in vitro 試験管内で(=生体外で)|in vivo (in the body) 生体内で
consolidate	強固にする|合併整理する|合併する|統一する
complementary	補完的な
trader	伝統的な|貿易業者
nominal	名目上の|名称上の|名詞の|名詞語句
psychic	心霊現象の|心霊の|霊魂の
twilight	たそがれの|薄明かり|夕方|黄昏どき
matte	つや消しの|(色･つやが)鈍い
incredibly	信じられないほど|非常に
crab	カニ|あら捜し屋|蟹|あら探しをする(find fault)
psychiatric	精神医学の
teenager	ティーンエイジャー(語源はteenの付く13才から19才まで)
ankle	くるぶし|かかと|足関節
quake	震動する|揺れる|震える|身震いする|振動する|地震|earthquake
expressly	明白に
clever	利口な|賢い|上手な|得意な
distinctive	独特の
postcode	=zip code
sensation	興奮|感覚|のような感じ|センセーション
unofficial	非公式の|非公認の
privately	個人として|内密に|ないしょで
clash	衝突(する)|ガチャッ(音)|(色彩の点で)調和しない
stall	畜舎に入れておく|(口実をもうけて)言い逃れする|エンストする|立ち往生する|馬房|露店
tripod	三脚
ginger	ジンジャー|精力|元気|生姜(ショウガ)
underwater	水中の
quartz	クオーツ|石英
pirate	海賊|略奪者|を略奪する|著作権を侵害する
kindergarten	幼稚園
pbs	リン酸緩衝食塩水
humour	humorのUK式綴
nay	《古語》否,いや(no)|《文語》そればかりでなく,それどころか|拒絶|否定|反対投票(者)
reactor	(陽性)反応を示す人|反応者|反応器|反応炉|原子炉
jaw	あご
summarize	を要約する
kitten	子猫
probable	ありそうな|ありうる|もっともらしい|有望な
crescent	三日月
burial	葬式|埋葬|墓
erosion	浸食|腐食|目減り
joey	雑役夫|臨時雇い|稚児|幼獣|子カンガルー|女みたいな男|男色者
hacker	ハッカー|他人のシステムへの不法侵入者
supportive	協力的な|支持する
aide	(大統領などの)補佐官|側近|スタッフ
repeatedly	繰り返して|再三再四
urine	尿
athlete	運動選手|競技者
dashboard	泥よけ|ダッシュボード
barber	理髪師
disconnect	ばらばらにする|絶つ|の関係(接続)を断つ|分離する|(電話･電源を)切る
hm	うーん
khan	汗(かん)(モンゴルなどの統治者の称号)|隊商の宿舎
habit	習慣|癖
cancun	カンクン
bach	ヨハン・ゼバスティアン・バッハ
voter	投票者|投票権所有者|選挙人
botanical	植物学の|植物の
capri	カプリ
gemstone	宝石用原石
pumpkin	(植物)カボチャ|セイヨウカボチャ|まぬけ|ぶざまな人
imagery	イメージ|像
stern	厳格な|きびしい|いかめしい|苦しい|断固たる|船尾
colorful	色彩ゆたかな
inadequate	不適当な|不十分な|無力な
toxicity	毒性
socialist	社会主義者|社会主義(者)の
considerably	かなり
mol	モル(物質量の単位)
cough	咳をする|せき|咳
ambulance	救急車
rotten	腐った|不愉快な
lemma	(言語学で)語彙素(lexeme)を代表する基本形
popup	(野球の)ポップフライ
bulb	真空管|電球|球根
furnish	備え付ける|を供給する|を提供する|を装備する
useless	役に立たない|無用な|無駄な
glove	グローブ|手袋
fringe	ふち|へり|周辺|外れ
northwestern	北西の
insufficient	不適当な
occupancy	占有|占拠|領有|居住|使用
fertility	多産|繁殖力があること
incorporation	合体|合併|法人組織|会社(設立)
issuance	発行|交付|発布|配給|給与
enjoyable	楽しい
repayment	(借入金などの)返済
handbag	ハンドバッグ|旅行かばん
compressor	圧縮機
chili	アメリカ産トウガラシ
blossom	(特に果実の)花が咲く|開花する|発展する
permanently	永遠に|不変に|永久に
adhere	執着する|堅く守る|粘着する|支持する
judgement	判断|判断力|分別|裁判|判決|意見
freeman	自由民|公民
ninja	忍者
patience	がまん|忍耐|一人トランプ
await	待つ|待ち受ける|(物事が)待っている
burger	ハンバーガー|かすり傷
flora	(一時代･一地域の)植物相(群)|植物群|植物誌
lever	てこで動かす|てこを使う|レバー|てこ
purchaser	購入者
syllabus	概要|(講義などの)年間計画
vanity	虚栄心|むなしさ|はかなさ|鏡台|化粧テーブル
ingredient	内容物|要素|成分|材料|構成要素|要因
fetch	取ってくる|引出す|(物を)行って取ってくる|取って来ること
tactical	戦術上の|戦術の
hardy	ずうずうしい|大胆な|我慢強い|丈夫な|耐寒性の
equip	に装備する|仕度を整える|備え付ける
analyzer	アナライザー
mansion	大邸宅
het	heatの過去･過去分詞
illustrator	挿絵画家|説明者
bro	兄弟
progression	進行|前進|行程|経過|発達|数列|発展|連続|連鎖
beacon	水路標識|信号灯
wastewater	廃水
plump	どしんと(落ちる)|丸々と太った|ふくらんだ|たくさんの|を太らせる
viable	生存できる|実行可能な|生存能力のある
mosaic	モザイク|モザイクの
anthology	アンソロジー|名詩(名文)選|詩集
neat	さっぱりした|きちんとした|こぎれいな|趣味のよい
differentiate	を他と別のものにする|を区別する|を変更する
poorly	貧しく|不十分に|不完全に|まずく
erase	拭いて消す
denim	デニム(厚地綿布)
hotline	ホットライン
sermon	(教会での)説教|お説教|小言
shuffle	(足)をひきずって歩く|を移し替える
spacious	広い範囲の|広々とした|雄大な
toast	トースト|乾杯(する)
cheek	ほお
archaeology	考古学
beloved	最愛の
sometime	いつか
ballard	バラード
rem	レム(X線のレントゲンのように|人体に与える電離放射線量の単位)
faithful	義務を遂行する|忠実な|誠実な|信頼できる|貞節な
timeout	タイム[アウト](試合の一時中止);休憩
whatsoever	(=whatever)
auxiliary	補助の|予備の|補助的な
fender	フェンダー|緩衝装置|泥除け
noun	名詞
lithium	リチウム(金属元素)
lighthouse	灯台|燈台
mediation	調停|和解
alphabetically	アルファベット順に|ABC順に
allocate	配分する
orchard	果樹園
chandler	雑貨商人
fitting	に適合する
backyard	裏庭|(表庭はfront yard)
trainee	練習生
haul	強く引っ張る|運搬する
quotation	見積書|引用|相場|引用すること|引用文|時価|見積り
anticipate	予期する|予想する
quota	割当量|割当
definitive	決定的な|最終的な
turbine	タービン
vascular	脈管の|血管の|管の
alongside	〜のそばに
entertain	もてなす|楽しませる|楽します
waterfront	海岸の土地|河岸|海岸通り
delphi	神託地|デルファイ(古代ギリシャのアポロンの神話地)
emotion	感動|感情
timetable	時刻表|予定表
slipknot	引き結び(結び目の一方の端を引けばすぐほどける結び方)
mst	山岳部時間
versatile	多方面な|多才な|融通がきく|変わりやすい|八方美人の
organise	組織化する|団結する
profitable	有益な
blocker	ブロッカー|遮断薬|遮断剤|阻害薬
aspen	ポプラの木
derivative	派生した|デリバティブ
laurel	栄誉を与える|月桂樹|栄誉|ゲッケイジュ|月桂冠|勝利
resemble	に似ている
newborn	生まれたての
plush	フラシ天|豪華な
biker	バイクに乗る人
brent	Brent Crudeブレント原油|主にイギリスの北海のブレント(Brent|岩層区分の名)油田から採鉱される|原油の混合(ブレンド blend)ではない
grasp	理解|つかむこと|を握る|を理解する|を掴む
comb	くしですく|くし|波頭|徹底的に捜す
evolutionary	進化した
niche	(人･物の)適所|適性
spinal	とげの|背骨の
scar	傷跡になる|そこなう|傷跡|心の傷跡
telegraph	電信|電信機|電報|電報で～を知らせる|電報を打つ
itinerary	旅行日程表|道程|旅行記|旅日記|旅行案内
hail	歓迎する|を認める|(タクシーなどを)呼び止める|ひょう,あられ
solvent	溶媒|溶解力のある|解決方法|支払能力がある
insult	侮辱する|侮辱
biotech	バイオテクノロジー
unstable	不安定な|安定していない|動きやすい|ぐらぐらする|不安定|今にも崩れそうな|気が変わりやすい
psychologist	心理学者
mickey	元気|誇り|ジャガイモ|をからかう|侮辱する|いじめる|ぺしゃんこにする
worksheet	ワークシート
quartet	四重奏
duplex	重複の|二連の
nelly	安ブドウ酒|おかまっぽい男|女みたいな男
unsecured	安全でない|保証(担保)のない
philosopher	哲学者|哲人|賢人
eb	電子ブック|電子ブック
appropriately	適切に
inactive	活動しない|怠惰な|緩慢な|受身的な
newsroom	ニュース編集室|報道室
brewer	醸造者
supermarket	スーパーマーケット
continuation	延長|継続|連続
barcode	バーコード
cola	〈C〉コーラの木(熱帯産の木)|〈U〉コーラの木の実からつくった炭酸飲料(Coca-Cola, Pepsi Colaなど)
hinge	ちょうつがい|関節|要所|要点|条件にする|決める
blunt	鈍い|無遠慮な|無愛想な|鈍くする
successor	後継者|後任者
absorb	を吸収する
colt	子馬
lateral	側面|横の
curb	(犬などを)鎖で御する|抑制する|留めぐつわ|拘束|抑制|囲い|縁石
therein	その点で
yell	どなる|大声をあげる|鋭く叫ぶ|エールをおくる
shear	を刈る|はさみを入れる|奪い取る|剥奪する|大ばさみ|(羊毛の)刈り込み
rex	国王|王
infinity	無限領域
torch	たいまつ|光|カンテラ
traditionally	伝統的に|古来
soy	大豆|しょうゆ
dew	露|しずく|みずみずしさ
solicitation	懇願|請願|勧誘|誘惑
cane	ステッキ|籐杖
hen	メンドリ|雌鶏|(鳥･魚の)雌|女
limo	リムジン
rotate	回転する
approximation	近付くこと|接近|近似|近似値
suv	a high-performance four-wheel drive car built on a truck chassis
lacrosse	ラクロッス|ラクロス(ホッケーに似た球技)
duplication	重複
dentist	歯科医|歯医者
tomb	墓|墓穴|墓石|墓標|死
hassle	激論|口論|(口)うるさがらせる
homosexual	同性愛の(人)
prof	教授|先生
postscript	追伸|二伸|後書き(P|S)
chew	噛む
unwanted	不必要な
cobra	コブラ
pedestrian	歩行者|徒歩旅行者|徒歩の|歩行(者専用)の|散文的な|平凡な|鎮痛剤
hurry	急ぐ|を急がせる|急ぎ
tailor	仕立屋|洋服屋
papa	パパ|おとうさん
symbolic	象徴主義の|象徴的な|記号による
grief	悲嘆|(深い)悲しみ|嘆きの種
objectionable	反対すべき
simplicity	単純|平易|質素|純真
shutter	シャッター|閉じる人(物)|よろい戸(を閉める)|雨戸
shrimp	小エビ|ちび|とるに足らない物
stroller	ベビーカー|放浪者|vagrant
buckle	バックル|曲げる
gradient	こう配|変化度|勾配
dolby	ドルビー
condominium	分譲アパート|共同管理|マンション
reinforce	部隊を強化する|を補強する|を強める|強化する
plea	嘆願|陳述|弁解|抗弁
drake	雄のカモ(male duck)|カゲロウ(mayfly)|カゲロウ型毛針|人名
semantic	意味の
dia	直径(diameter) cf. 半径(radius)
concurrent	同時の|同時に起こる|同意見の|に伴う|兼務の|共同に作用する|協力の(cooperating)
globalization	グローバル化
paddle	水かき|櫂|へら|ラケット|パドル|をたたく|ラケットで打つ|ぴちゃぴちゃさせる