gram	グラム
inherent	本来備わっている|生来の|生得の|固有の|先天的の
audition	試聴|オーディション
dedication	献身すること|献身
violet	スミレ|すみれの花|すみれ色
optic	目(の)|光学(の)
selector	選ぶ人|選択装置
mum	黙る|無言の|黙っている|しっ!|奥様|おかあちゃん|強いビール|キク
pinnacle	頂点|絶頂|最高点|に尖塔をつける
overstock	過多|在荷過剰|仕入れ過剰|仕入れ過ぎる|長く搾乳しないでおく|に詰め込み過ぎる|に供給し過ぎる
lavender	ラベンダー色の|ラベンダー|薄紫|フジ色|保管用ポジフイルム
insect	虫|昆虫
steep	急勾配の|急な坂|急な･険しい|不法に高い
vest	ベスト|男子用のチョッキ|婦人･子供用下着|男子用肌着|与える
hank	(糸の)束
ventilation	通気|換気(装置)|(感情の)表出|討議
celeb	有名人|セレブ
dwarf	の発達を妨げる|ちっぽけな|特に小さい動植物|矮星|(童話等の)小人
decree	法令|布告|制令|判決|命令|命ずる|決定する
usability	ユーザビリティ
wedge	くさび|くさび形の|くさびで留める|くさびで割る
isolate	孤立させる|を離す|隔てる|を隔離する|を絶縁する
daylight	昼の明かり|日光|公然|公表|理解|透き間
pol	(けなして)(老練な)政治家(口語)
memorable	記憶すべき|重大な|覚えやすい
locus	場所|位置|遺伝子座(染色体中の遺伝子が占める位置)
percussion	パーカッション|打楽器|衝撃
aspire	熱望する
initialize	初期化する|初期値にセットする|イニシャライズする
formally	正式に|本式に|公式に|儀式張って|堅苦しく|形式上|形式的に|外見的に|礼儀正しく
accompany	に同伴する|おともする|に付随する
twain	イメージ処理用のプログラムと|スキャナやデジタルカメラとの間のインタフェースの一種
squash	カボチャ|つぶれる|押し(踏み)つぶす|ぺちゃんこ|スカッシュ(競技名)
ile	パリの異名|(ileはフランス語で島の意味|Île-de-Franceはパリの中心街を表す)
curry	カレー|馬ぐしでこする|(なめし革に)油で光沢を付ける
tweak	をひねる|ひねり|つねる
slash	スラッシュ|さっと切る|を鞭打つ|一撃|切り傷|大鉈を振るう|大幅値下げする|大改定をする
rite	儀式|儀礼
compartment	コンパートメント|区画|仕切り
shy	後ずさりする|しりごみする|恥ずかしがりの|内気な|恥ずかしがり屋の
doctoral	博士の
outbreak	勃発|突発|発生|暴動
fedora	フェドーラ|(バンド付きの)フェルトの中折れ帽
elaborate	精巧な|念入りに作った
breakthrough	突破口|現状打開|躍進|成功|大発見
ruler	主権者|支配者|君主
beck	手招き
tome	大きな本|大作|学術書
taxable	課税
malaria	マラリア|(湿地から出る)毒気
loyal	忠誠な|忠義な|忠実な|忠臣
dentistry	歯科学|歯科医術(業)
bomber	爆撃機
baton	バトン|警棒
renal	腎臓|腎臓(部)の
esteem	尊重(する)|重んじる|尊ぶ
spite	にもかかわらず|悪意|恨み
capita	per capita 一人当たり(の)|頭割りで(=by heads)
guideline	指針
unite	結合する|結合させる|を一つにする|連合させる|一体となる|合体する
accelerator	(車の)アクセル
superstore	スーパーストア
humble	つつましやかな|身分の低い|謙虚な|卑しい|地位が低い|質素な
volcano	火山|噴火口
wholly	全体的に|完全に|全く
elbow	肘|ひじで押す|ひじ
duct	導管
accumulation	集積|蓄積
purely	純粋に|混じり気なく|単に|全く|きれいに
mob	群衆|暴徒|群れ|大衆|暴力団|マフィア|暴徒の群れ|群がり騒ぐ|襲う|群がる
fisherman	漁師
whirlpool	渦|渦巻|混乱|騒ぎ
vivid	生き生きとした|生気にみちた|(色･光)鮮明な|強烈な|(色に関して)鮮やかな
stationary	動かない|静止した|据え付けの|定住した|変化の無い
woody	木質の
seizure	つかむこと|没収|占領|発作|てんかん
campground	キャンプ場|野営地
streak	筋がつく|閃く|層|線|光線|一続き|兆候
scoreboard	スコアボード
conception	構想|構想力|観念|考え|着想|概念|概念作用
kc	1000サイクル(=kilocycle[s])
pogo	(音楽に合せ)飛び上がって踊る
riot	暴動に加わる|放蕩する|ふける|暴動|反乱|一揆|多種多様
prevalence	普及|流行|(医)有病性|率
subunit	サブユニット
pentagon	五角形|五辺形|ペンタゴン(米国国防総省の建物)
honestly	いやはや|正直に|誠実に|正当に|正直に打ち明けて|まとも|実直|真面目
salsa	サルサ(ダンスの名)
upstream	上流の|上流へ|流れにさからって
cereal	穀物の|穀物
auditorium	講堂
voucher	領収書|商品券|引換券
spawn	(水性動物が卵)を生む|卵|卵を産む|たまご
jointly	合同で
pagan	異教徒(の)|異端者|多神教者|不信者の|無宗教者
bookshop	書店
duff	落葉枝|ごまかす|だます
empower	権限を与える
reboot	再起動
rejection	拒絶|拒否
erect	直立した|強ばった|勃起した|組み立てる
biochemistry	生化学|生理化学|生物化学
equatorial	赤道の(付近の)|赤道儀
clarification	明確化
critic	批評家|評論家
deg	度|=degree
grandfather	祖父
prescribe	命令する|を規定する|処方する|指示する
enthusiasm	熱中させるもの|熱中|意気込み|熱狂
torque	トルク|回す力|回転モーメント|貴金属の針金をねじって作った首飾り･首輪･腕輪
loser	敗北者|負け犬|(野球なら)敗戦投手
pitcher	ピッチャー|水差し|投手
visualization	可視化
odor	におい|悪臭(=smell)|気配|香り|香水|評判
redesign	新しいデザイン|デザインを改める
disturbance	混乱|妨害
epidemiology	疫学
adequately	適切に
spectral	お化けの(ような)|怪奇の|スペクトルの
compliment	お世辞を言う|誉める|賛辞|お世辞|あいさつ
closeout	見切りバーゲンセール|蔵払い
subway	地下道|地下鉄
neighbourhood	近所の人々
amusement	楽しみ|娯楽
biomedical	生物医学|医療従事者が|薬物|放射線
motif	主題|モチーフ|基調|動機|飾り
colonel	連隊長|大佐|部長
conquer	奪取する|克服する|征服する|打ち勝つ|獲得する
chairperson	議長|会長(nonsexist)
mock	偽の|からかい|嘲り|嘲る|真似てからかう|馬鹿にする|無視する|まねる
followup	フォローアップ
brokerage	証券会社|周旋業|仲買手数料
hoc	これ|adhoc 特定の問題(hoc) について(ad)
wherein	どこに
elastic	融通のきく|伸縮自在の|flexible|快活な
hex	16進法|まじない|ジンクス|呪い|魔女|魔力|16進法の|魔法を行う|に不幸をもたらす|魔法をかける|魅する
beard	(通常複数形)あごひげ|ふさ毛
parkway	公園道路
straw	わら製の|麦わら|ストロー
claimant	要求者|苦情を言う人
rag	みすぼらしい人|ぼろ|紙片|新聞|紙幣|叱る
domination	支配
weakness	弱さ|弱点|衰弱|不十分
observatory	天文台|気象台|展望台
sac	袋|嚢
puppet	あやつり人形|傀儡|手先
tucker	完全に磨り減る|仕立て屋|食べ物
monopoly	独占|専売|専売品 
obsolete	すたれた|廃れた|時代遅れの
trumpet	吹聴する|大声で知らせる|(楽器)トランペット|拡声器|ラッパ(を吹く)
freshwater	淡水
crisp	てきぱきした|新鮮な
mist	霧|ミスト|かすみ|霞|意味をぼんやりさせるもの|曇る
nicely	きちょうめんに|うまく|立派に|心地よく|気むずかしく
surprisingly	驚くほど(に)|意外にも|驚くほどに|あきれるほど|驚いたことには
canton	(スイスの)州|県
clown	おどける|からかう|道化師|道化役者|田舎者
practically	実用的に|事実上|事実上は|実質的に|実際に用いて|ほとんど
vivo	in vitro 試験管内で(=生体外で)|in vivo (in the body) 生体内で
molly	モリー(女性名Maryの愛称)|人気がある観賞魚(グッピーの異表記)
efficacy	効き目|効果|有効性
brigade	旅団|編成する|分類する
redemption	買い戻し|見受け|償還|兌換|救済|解放
fond	愛情のこもった|好きな|好んで|優しい|盲愛の
molecule	分子|微量|微分子
pillar	柱|支柱(状のもの)|を支える|大黒柱|中心人物
wreck	難破|難破船|破損|廃人|破壊する|難破させる
sore	痛い
vapor	蒸気|蒸発気(湯気|水蒸気など)|空想|妄想|蒸発する|水蒸気|気相|気体
blaze	輝く|炎|火炎|灼熱|火災
islander	島の住民|島民|島国民
abbey	修道院|僧院
barbecue	バーベキュー
sincerely	誠実に|心から
surveyor	鑑定人|検査者|測量師
dent	へこみ|へこませる
proximity	近接|近似
homemade	自家製の
swell	膨らむ|を膨らませる|隆起(する)|増大(する)|(口)すてきな
strait	(複数形で)難局|困難|海峡
marginal	取るに足りない|最低限の|周縁の|辺境の|欄外の|限界収益点の
refuge	避難する|避難|保護|避難所|隠れ家
residency	専門医学実習生の身分(期間)|居住
topical	話題の|論題の|題目の|原則的な|時事問題の|局部的な
prestige	名声|威信|信望|威光
cocaine	コカイン
schoolgirl	女生徒|女子生徒
admire	に感服する|を賞賛する|尊敬する
responsive	すぐ反応する|敏感な
supra	越えて|上に
flaw	欠陥|弱点|欠点|傷|ひび|割れ目
limb	の手足(翼)を断つ|手足|大枝|縁|節
mitigation	緩和
keynote	基調|基本方針
expire	満了する|終了する|満期になる|(息を)吐き出す|死ぬ
unbiased	偏見のない
saga	英雄伝|冒険談
coconut	ココヤシの実|ココナツ
supplementary	補充(追加)されたもの|補充の|補足の|補遺の
plum	西洋スモモ|プラム|すばらしいもの|濃い紫色
beige	ベージュ
obscure	人目に付かない|ぼんやりした|あいまいな|覆い隠す
winery	ブドウ酒醸造場
soak	を浸す|ずぶ濡れ(になる)|(浴びるように)酒を飲む
chop	打撃|ぶった切り|を切る|たたき切る|を切り刻む
hoover	電気掃除機(をかける)|英国Hoover社の電気掃除機
muse	熟考する|物思いにふける|瞑想|(古代ギリシャの)詩神|詩才
willie	ペニス|ちんちん|男根
culinary	台所の|料理の
semantics	意味論|意義学
huh	ふん(質問･驚き･軽蔑)|はあ
flap	ぴしっとたたく|ひらひらする|はためく|羽ばたく|はためかせる|平手うち|興奮状態|騒動
scarface	傷や痘痕のある顔
accountant	会計係|会計士
boiler	ボイラー
annuity	年金
propaganda	宣伝|主義|主張|宣伝機関
offender	違反者|不快なもの
coli	大腸菌の 
panorama	全景|概観|パノラマ
cruel	悲惨な|残酷な
wheeler	荷車引き|wheel horse|(合成語で)～の車輪付きの物
literal	文字の|文字通りの|融通のきかない|事実に忠実な|誤植
fiesta	(スペイン語)フィエスタ|祝祭|聖日|休日
acceleration	加速|促進
hesitate	躊躇する|ためらう
cuff	袖口|カフス|ズボンの折り返し|手錠|血圧計バンド|平手打ち|に平手打ちをくらわす
degradation	左遷|降職|デグラデーション|規模縮小|減成|分解|劣化|悪化
hmm	うーん
bail	保釈(金)|保釈保証人|保釈してもらう|水をかい出す|(厩の)仕切り
dioxide	二酸化物
avail	価値がある|効能|効用|役に立つ
govern	統治する|決定する|を抑制する|を管理する|を左右する
diffusion	普及|散布|拡散
rust	さび|(植物)さび病|さびる|鈍る
stein	スタイン(陶器製のビール用ジョッキ)|ジョッキ1杯の量
motive	動機|目的|主題|原動力となる
prom	(口)(特に高校･大学などで公式に行う)ダンスパーティー
stimulation	刺激|興奮|激励|鼓舞
issuer	発行者
cote	(羊･ハトの)小屋
awake	目覚めさせる|悟らせる|起きる|気づく|起こす
concession	利権|特権|許容|免許|特許|譲歩
assertion	主張
ticketmaster	チケットマスター(ハリウッドに本社を置くチケット販売会社名)
beetle	カブトムシ|甲虫
wavelength	波長
prohibition	禁酒法時代|禁止
feminist	男女同権主義者|男女同権主義
coupling	男女のカップル
contend	強く主張する|競争する|論争する|戦う
herd	(牛馬の)群れ|群衆|多数の|群がる|集まる
prod	刺激する|つつく
oncology	腫瘍学
correspond	一致する|対応する
docket	(米)判決要録
suspend	中止する|一時中断する|吊す|延期する
sup	(スープ･流動食)少しずつ口に入れる|夕食を供する
chin	あご|あご先
freestyle	(競技)自由型|フリースタイル(の)
migrant	移住者|移住性の
intuitive	直観の|直感的な|直観力のある
rigid	厳格な|かたくなな
soda	ソーダ(水)
regiment	連隊|組織化する|厳しく統制する
nucleotide	ヌクレオチド(化合物)
orthodox	正統派の|ユダヤ教正統派の|伝統的な|正統の|ギリシア正教の
disposable	使い捨てにできる|使い捨ての|自由に使える
holistic	総称的な
comma	コンマ
qualitative	質的な|定性的な|性質上の
sneak	こそこそする(こと)|こっそり盗む･取る･入れる
childcare	保育(の)|育児(の)
commencement	開始|学位授与式
thrust	を突き刺す
bamboo	竹|(家具や杖などに使う)竹材|竹の
throne	王座|王位|司教座|国王|皇帝
rechargeable	充電できる
refugee	亡命者|難民
chunk	厚切|大量|たくさん|厚切り|大きな塊
marital	夫婦の|夫の|結婚の
bait	餌をつける|誘惑する|悩ます|餌|誘惑
clutter	取り散らかす|散乱させる|騒ぐ|散乱物|乱雑|混乱
slavery	奴隷制度|奴隷であること|奴隷の身分|重労働
lumber	木材|不要品|厄介な人･物|を(がらくたで)一杯にする|ふさぐ|(物)を乱雑につみあげる|ドタドタ(のしのし)歩く･進む
notwithstanding	〜にも関わらず
increment	利潤|区切り
feasible	実現可能な|可能な|適した|便利な
credibility	真実性|信頼性|信ぴょう性|信用できること
notch	切り目(をつける)|刻み目|山峡|V字形の刻み目|山あい|段|級
tease	にねだる|じらす|悩ます|いじめる
defective	不良の
piston	ピストン
invade	に侵入する|攻め入る|を侵略する|を冒す
heap	積み上げる|山|沢山の|たいそう|非常に
breaker	こわす人
mechanic	機械工|名人
profound	深い|思想が深い|造詣の深い|難解な|高尚な
dissemination	種蒔き|普及|種まき|散布|宣伝
shareholder	株主
provisional	仮の|一時的の|暫定的な
cosmic	秩序整然とした|宇宙の
politically	政治的に
lieutenant	中尉
rationale	理論的解釈|根本的理由|原理|理論的説明(根拠)
calculus	石|結石|計算法|微積分学
ale	エール酒|ビール|エール(ビールの一種)
jelly	ゼリー
microscope	顕微鏡
suspense	どっちつかずの状態|サスペンス|未決|不安|未定
missionary	伝道(者)の|伝道師|宣伝者|使節
stare	じっと見つめる(こと)|凝視(する)
phosphate	リン酸塩(エステル)|リン酸肥料
arsenal	武器庫|貯蔵兵器|軍需物資|集積
southwestern	南西の|南西(部)|南西からの
perfection	完全(なこと)|完成|完成の域に達した人(物)
undermine	密かに傷つける|の下を掘る
eager	熱望して|熱心な|しきりに～したがって
drought	日照り|かんばつ|旱魃|渇水
hypertension	高血圧(症)
searchable	検索可能な
vacancy	空き地|空き部屋|すきま|放心|放心状態|空虚
debtor	債務者|借主
landfill	埋め立てごみ処理(地)|ごみの埋め立て処理場
pupil	生徒|教え子|弟子|被後見人|年少者|未成年者|瞳|瞳孔
penetrate	を貫通する|染み込む|入る|理解できる|仮釈放(する)|執行猶予|合い言葉
upright	まっすぐ立った|直立の|まっすぐな|垂直な|直立した
canopy	天蓋(てんがい)
gland	腺|パッキン押さえ
buffer	緩衝域|-を置く
radiator	ラジエーター
stiff	肩こり|こわばった|堅苦しい(人)|不自然な|(俗)勃起|死体|浮浪者
binder	縛る道具|包帯|ひも|ルーズリーフ用バインダー|製本屋|製本機械
hut	簡易住居|小屋
restraint	妨げとなるもの|抑制|制止|拘束|監禁|遠慮|慎み|自制|制限
historically	歴史的に
homo	ホモ|同一の|同質の|人|人間
thrive	成長する|を生き甲斐にする|栄える|繁栄する|繁盛する|(人･動植物が)力強く成長する
scare	こわがらせる|おどして～させる|おびえさせる
assemble	招集する|を集める|組み立てる
almanac	年鑑|暦
microbiology	微生物学|細菌学|bacteriology
kite	凧|ハンググライダー|ぺてん師|融通手形|トビ
cater	料理|娯楽を提供する|供する|満たす
replay	再生
aux	auxiliary(補助の)の略
rue	後悔する|悲しむ|(植物)ヘンルーダ(薬用)
dignity	尊厳|威厳|高位|爵位
insane	気が違った|狂気の
weaver	織り手|織工|織布業者|(鳥)ウソ|ミズスマシ|(人名･姓)ウィーバー
proton	陽子
overtime	時間外の|超過勤務時間|時間外|残業手当|OT
gill	鰓(えら)|ひだ|少女(Jack and Gillと用いられる)
transitional	移り変わりの
lister	あぜ作り機|リストを作る人|税額査定者|動力耕運機|培土プラウ(鋤|スキ)
nightly	夜な夜なの|毎夜の|毎夜|夜に
ego	自我
inheritance	相続財産|遺産|継承物|遺物|相続|遺伝
maxim	格言|ことわざ|金言|行動原理|処世訓
misplace	置き場所を誤る|置き忘れる|間違って与える
pulp	果肉|パルプ|髄(質)|歯髄|パルプにする|どろどろにする|植物の髄|肉質部
slaughter	大量殺戮|完敗|屠殺する|虐殺する|徹底的に打ち負かす
carbohydrate	炭水化物
grandmother	祖母
firmly	堅く
nationality	国民性|国籍|国家|国民|愛国心
articulate	はっきり言う|はっきり発音する|明瞭な|(関節で)繋ぐ|関連づける|(文法)分節する|文節する
superman	超人
flop	失敗|ばたりと倒れる|どさりと落す
carat	カラット(宝石の重量単位=200mg)= karat
cellar	地下室|貯蔵室|最下位
novice	初心者
invoke	思い起こさせる|(権威あるものを)引き合いに出す|(法律など)に訴える|懇願する
filing	綴じ込みの
durability	耐久力
coaster	沿岸貿易船|滑降そり|(遊園地の)(グラス受けの)コースター
apprentice	年季奉公人|見習生|徒弟|実習生
flare	ゆらゆら燃える|かっと怒り出す|ゆらめき|パッと燃え上がる
furnace	厳しい試練|炉|かまど|暖炉|溶鉱炉|猛烈に熱い所
sting	(を針で)刺す|傷つける|をひりひりさせる|(人を)苦しめる|ひりひり痛む|ひどく痛む|刺すこと|針
robe	職服を着る|ローブ(長くてゆったりした外衣)|バスローブ|式服|礼服|職服|浴衣|化粧着|衣服
aboard	〜に乗って
linguistics	言語学
stimulus	刺激(物)|激励|興奮剤
roundup	検挙|手入れ
baron	男爵|財界人|大実力者|～王
delicate	きゃしゃな|繊細な|優美な|おいしい|かすかな
tor	(頂上のとがった)小さい岩山
altogether	全体で|全く|全部で
obey	従う|理性に従って行動する|力･衝動のままに動く
descriptive	記述的な
impulse	心のはずみ|刺激|(心の)衝動|衝撃|推進力|影響
subtotal	小計
feasibility	実行可能性
comet	(天体)すい星|彗星|ほうき星
oblique	斜行進する|間接の|斜めの|遠まわしの
wardrobe	衣装だな|持ち衣装|洋服タンス|衣服|衣装管理係
endowment	寄付金|基金|天性|才能
dilemma	ジレンマ|板ばさみ
automate	自動化する
goo	(米語)(うんざりするような)感傷
snack	軽食をとる|軽い食事|軽食(をとる)|急いでする食事
dinar	ディナール|アラブ地域など多くの国で使われている通貨
exploitation	活用|開発|宣伝|搾取
ideally	完全無欠に|理想的に|観念的に
activism	積極行動主義
mythology	神話学|神話(集)
probation	保護観察(期間)|執行猶予|仮採用|試験|試用期間|見習期間
remover	移転者|運送屋|除去剤
gran	おばあちゃん(=nan, nana, nanny, granny, grandma, granma)
rebound	回復|跳ね返る
presidency	presidentの地位|統轄|主宰|最高会議
reconciliation	和解|調停|調和|一致|服従
compulsory	強制的な|義務的な
favorable	好意ある|好意的な|賛成の|都合のよい|有利な|望ましい(=favourable)
sovereign	主権者|君主|最高の
lisp	かたこと|舌足らずに話す
rupee	ルピー(インドなどの通貨単位)
activist	活動家|運動家
maintainer	維持する人
suede	スエード皮
mould	鋳型|流し型|骨組み|鋳物|性質|作る|肥土|土|かび
advent	出現|到来|キリスト降臨
hum	ブンブン音をたてる|鼻唄をうたう|景気がよい|ぶんぶんいう音|buzz
mayo	mayonnaise
cellphone	携帯電話
wont	習慣|し慣れた
silicone	シリコーン
initiation	開始|着手|創始|手ほどき|奥義伝授|入会(式)
overload	に荷を積みすぎる
supervise	を監督(管理)する
fabrication	作り話|でっち上げ|組立
scrapbook	スクラップブック
limousine	リムジン
affirmative	断定的な|肯定の|積極的な|断固たる
spoil	悪くなる|を台無しにする|駄目にする|を甘やかす|役に立たなくする
lump	塊になっている|重そうに動く|たくさん|角砂糖|こぶ|塊
fortunately	運よく|幸運にも
exile	追放(する)|亡命(させる)|亡命者|追放人|国外追放
wealthy	富んでいる|裕福な
damp	じめじめした|湿らす|湿気を帯た|湿った|湿り気|落胆|悪気|汚気|湿気
sour	ひねくれた|酸っぱい|不機嫌な
proportional	比例した|釣り合った|比例項|比例の
nonetheless	それにもかかわらず|やはり
mystic	神秘主義者|秘伝の|神秘的な|秘教の
expectation	予期|期待
severely	厳しく
loft	屋根裏(=attic, garret)|ハト小屋|屋根裏に貯蔵する|打ち上げる
liberation	解放
masterpiece	傑作|名人芸
greet	あいさつする|挨拶する|反応する|知覚される
ancestry	(集合的)祖先|家系|家柄
luxurious	快楽を追い求める|贅沢な|豪華な|ありあまるほどの
squid	イカ
indirectly	間接に|二次的に|暗に|間接|それとなく|当て付ける|やんわりと
ark	箱舟 (ノアの箱舟)
variability	変動性
gardener	植木屋|外野手
litre	(=liter)|リッター|リットル
asleep	眠って
razor	かみそり
potassium	カリウム(独Kalium)
vita	ビータ(ゲームソフト名　他)
accidental	偶然の
abnormal	異常な
endeavor	～しようと努力する|試みる
whoever	だれでも|だれであっても|する人は誰でも|だれが～しようとも|いったいだれが
frustration	欲求不満
troll	トロール(北欧民話で洞穴に住む巨人･小人)|陽気に歌う|輪唱する|流し釣りする
bake	焼く
preventive	予防的な|予防法
diagnose	診断する
mankind	人類
uncertain	変りやすい|不確実な|疑わしい|しっかりしない
ivy	(植物)ツタ|キヅタ属の各種|(特に)セイヨウキヅタ
persuade	を説得する|を信じさせる
citrus	柑橘類(の)
paramount	最高(位)の|最高権力者|首長
samurai	侍|武士|武士階級|日本陸軍の将校
immunity	(税･責任･義務などの)免除|免疫性|免疫
persist	固執する|やり通す|主張する|続く|残る
plague	伝染病|天災|災難|疫病神|を苦しめる|悩ます
sentinel	歩哨|を見張りに立てせる
markup	値上げ
glacier	氷河
tolerate	許容する|容認する|大目に見る|我慢する|寛大な|耐性のある|寛大に取り扱う
shampoo	シャンプー|洗髪(剤)|(髪を)洗う
append	添える
congestion	港での船混み|密集|混雑|人口密集|うっ血
outpatient	外来患者|(病院の)外来(科)
ape	サル|尾のない猿|猿の中でも人間に近い類人猿
ambition	功名心|大望|大きな望み
economically	経済的に|節約して
uncut	切らない|ノーカット(和製英語)
intact	そこなわれていなくて|そのままで|完全で
darling	いとしい人
lure	誘惑する|を引き寄せる|待ち伏せる|魅力|おとり|わな
onset	襲撃|攻撃|始まり|着手|手始め
lightly	もったいぶらずに|軽く|すばやく|冷淡に|そっと|少しばかり|容易に|陽気に
pavement	舗装道路|舗装|敷石
discourage	(人の)やる気をそぐ|がっかりさせる
transient	はかない|無常の|一時の|短期の|つかの間の
nutrient	栄養物|食物
underway	進行中で|旅行中の
scenery	風景|気色|景観
theatrical	(しろうとの)演劇|わざとらしさ|芝居じみたしぐさ|劇場の|演劇の|劇風の
preferably	むしろ|できれば|なるべく
collateral	付随的な|傍系の|対応する|見返りの|傍系親|縁者
sadly	悲しそうに
flock	集まる|群がる|群れ|大勢|羊毛･綿などのふさ･くず
hype	詐欺|誇大な宣伝･広告(をする)|だます|興奮させる|皮下注射|麻薬常用者
cavity	虫歯|虫歯の穴|くぼみ|うろ
prestigious	誉れの高い|名声のある
etiquette	エチケット|礼儀作法
mosquito	蚊(カ)
diner	食事する人|食堂車
deposition	罷免|証言録取書|宣誓供述書|堆積作用|堆積物
skeleton	がいこつ|概略の|骨格|骸骨
drip	したたる|滴る|点滴
fertilizer	肥料|化学肥料|豊かにする人･物
goodness	よいところ|よい状態|神
footer	フッター(脚注)
autism	自閉症
deli	デリカテッセン|調製食料品(店)|delicatessen
meridian	子午線|絶頂|放物線|経線の|正午の|頂点の
madden	(人を)発狂させる|激怒させる
inability	不可能
cor	あっ!|うわっ!あら!|えっ!
coronary	冠状の|冠動脈
consume	消費する
enjoyment	楽しみ
vaginal	膣の
cohort	(古代ローマ)歩兵隊|軍隊|仲間|相棒
inevitable	避けられない|不可避の
creep	忍び寄る|はう|いやな奴|薄気味悪い感じ(を与える人)
trilogy	(劇･小説･オペラなどの)三部作
fingerprint	指紋(をとる)
porch	ベランダ|玄関|車寄せ
lipid	脂質
thigh	もも|また|太腿(尻から膝まで)
interdisciplinary	学際的な|二つ以上の学問にまたがる
sequel	続篇|結果|後編|続き
abandon	を捨てる|放棄する|give up|desert
chic	上品な|スタイル|上品さ|いき
jacuzzi	ジャグジー
grease	グリースを塗る|脱脂しない生羊毛|油脂|獣脂|グリース|潤滑油|(俗)ダイナマイト|ニトログリセリン
taxonomy	分類学
puma	ピューマ
proliferation	増殖|急増|拡散|(生物)分芽|分裂|増殖
shutdown	(工場などの)一時休業(閉鎖)|操業停止
sentiment	感情|心情|心証|感傷|涙もろさ|(複数形で)意見|感想
autonomous	自治の|自治権のある
appropriation	割り当て|歳出予算(額)
randomly	無作為に
interchange	置き換える
theological	神学の
displacement	置換え
quietly	静かに|落ち着いて|平穏に
coca	コカ(南米産薬用植物)|その乾燥した葉
brightness	ブライトネス|輝度|快活さ|輝き|晴れやかさ|利発
depreciation	減価償却|価格低下|軽視|価値が下がること
juicy	水分の多い|うまみのある|おいしい
bollywood	ボリウッド|インド･ムンバイの映画産業につけられた俗称
mentally	心で|精神的に|知的に
gesture	身振り|手ぶり|ジェスチャー
learner	学習者
photon	光子|光量子|トロランド|フォトン
noisy	やかましい|騒々しい|ざわついた
blur	ぼんやりさせる|しみをつける|かすむ|ぼやける|ぼやけ|不鮮明
warp	(織物の)縦糸|歪み|ゆがみ|(板など)をそらせる|ひずませる|そる|ゆがむ
glitter	ぴかぴか光る|きらきら光る|派手である
usenet	UNIXユーザによるメールやニュースのためのネットワーク
panda	パンダ
embryo	胎芽(妊娠2ヶ月未満の胎児)|(発達の)初期|幼虫
hardback	堅表紙の(本)
zipper	ジッパー|ファスナー|チャック(和製英語)
topology	位相幾何学
prophecy	予言的能力|予言|お告げ|天啓|預言
inlet	入り江
trolley	路面電車
propagation	伝達|伝搬|増殖|繁殖|宣伝|普及|蔓延|遺伝
bout	勝負|(ボクシングの)試合|取り組み|一区切り|発作
technically	純法律的に|専門的に言えば
interconnect	互いに連絡(連結)させる
sock	靴下
deductible	控除できる
gaze	じっと見つめる|をじっと見つめる|注視|凝視
amplitude	振幅
rainfall	雨量|降雨
straightforward	率直な|まっすぐな|まっすぐに
simultaneous	同時の|同時に起こる
evolve	展開する|発展させる|導きだす|発展する
pornography	ポルノ写真
debris	残骸|破片|瓦礫|がれき
orphan	孤児|親のない
handsome	均整の取れた|ハンサムな
parrot	オウム|(～を)オウムのように繰り返す
precursor	先駆者|先駆物質
vibrant	生気にあふれる|わくわくする|震える|敏感な
lit	火がつく|火をつける
rude	教養のない|無作法な|無礼な|野蛮な|粗野な
customization	カスタム化
lively	active|生き生きした|泡立つ|新鮮な|陽気な|効果的な
nip	阻止する|つねる|はさむ|かむ|はさみ|ひとかみ|ひとつねり|風刺|酷評|犬が噛む
symmetry	釣り合い|調和|同情|対称
vicinity	近いこと|近所|付近|接近
purification	浄化|精製|おはらい|斎戒|清め
crawl	這う|腹ばいですすむ|のろのろ進む|クロール(で泳ぐ)|(テレビの)制作･出演者の字幕リスト
gloss	つやを出す|光沢|注解|注釈
organism	有機体|生物|人間|個々の小さな動･植物|有機的組織体(社会など)
groom	花婿|馬丁|身なりを整える|仕込む
thyroid	甲状腺(の)|甲状軟骨(の)|甲状腺動脈(静脈･神経)|甲状腺製剤
symptom	徴候|柱|症状|症候
laughter	笑い(声)
ignorance	無知|無学|不案内
polynomial	多項式
cur	そっけない
disseminate	(種子など)をまく|(意見など)を広める
moody	不機嫌な|憂欝な|憂うつな|気分の変わりやすい
dysfunction	機能障害
conscience	良心|誠実さ
humiliation	恥|屈辱
charcoal	木炭
southeastern	南東の|南東部の|南東への|南東向きの
horoscope	星占い|ホロスコープ
invasive	侵略的な
prosperity	繁栄|繁盛|成功|幸運
lantern	ランタン|カンテラ|提灯
rodeo	(牧牛の)かり集め|公開競技会
inconsistent	矛盾した|一貫してない
seemingly	一見したところ|うわべは
epidemic	流行性の|はやりの|病気の流行|流行病|思想のはやり
espresso	(ｲﾀﾘｱ語)エスプレッソ|コーヒー豆の粉に蒸気を通して入れる濃いコーヒー
passionate	熱烈な|熱情的な|短気な|好色な
chloride	塩化物
backward	遅れている|後方へ|逆に|後ろに|以前に|嫌がる|発展の遅れた
combustion	燃焼|激動|騒動|酸化
apologize	謝罪する|謝る|わびる|あやまる
weld	溶接する|結合する|溶接される|溶接点|溶接|密着
diva	歌姫|ラテン語で男性型divus|女性型diva|(英語のdivineの基になった語)|オペラで卓越した女性歌手の賛辞として広まる|(男性歌手の場合ディーヴォ)
bilateral	二国間の|両国間の|両側の|左右相称の|相互的な|双務的な|両側のある|双方の
piper	管楽器奏者|笛ふき(bagpiper)導管敷設者|(魚)ホウボウ
slap	非難(する)|平手打ち|をピシャリと打つ(こと)|ピシャ|ひっぱたく音
ghetto	スラム街
dictate	を書き取らせる|口述する|を命令する|命令|指図
bladder	ぼうこう|嚢(のう)|気胞|(魚の)浮き袋|水疱
terra	大地|土
ignition	点火|燃焼|発火|イグニッション|キーの差し込み口
revival	生き返り|復興|回復|復活|再生
ticker	ティッカー|カチカチいうもの|時計|心臓|受信機|懐中時計|監査助手|レジ|会計係
beware	用心する|注意する|警戒する
aloud	声を出して|大声で
glorious	すばらしく愉快な|名誉ある|光栄ある|荘厳な|光輝く
dynasty	王朝時代|王朝|名門|～朝|王家
parole	仮釈放(する)|執行猶予|合い言葉|(捕虜の)宣誓|運用言語
blender	ミキサー
foreclosure	抵当流れ
coke	コカコーラ|コークス|コカイン
prevail	流行する|勝る|普及する|効果がある|勝つ|克服する
fn	footnote
prey	犠牲(にする)|餌食(にする)|えさ|捕獲|捕食(する)
trump	切り札|奥の手
movable	動く|動かせる|年によって日の変わる|動産|家具|動産の|年によって日が変わる
garner	(情報･議席など)を(苦労して)集める|蓄える|穀倉
grin	歯を見せて笑う|にっと笑う
verdict	(陪審員の)評決|答申|判断|決定|意見|判決
homeowner	自家所有者
vale	(おもに詩)谷|谷間|現世|苦悩の世界|浮き世
geometric	幾何学的な
subsystem	サブシステム|コンポーネントシステム|下位組織
submarine	潜水艦|海底の
intrusion	侵入|押しつけること|侵害
greenwood	緑林
hydro	水治療施設|水力電気|水力発電所|水力発電電力|水力発電の|水力電気の
nonlinear	非線形の
batter	(野球)連打する|バッター|たたきつぶす
radioactive	放射能の|放射性の
whistle	笛|警笛|口笛を吹く|口笛|汽笛|ヒューと音をたてる|を口笛で吹く|笛で合図する
complainant	原告|告訴人
mania	マニア|躁病|異常な熱意|熱中させるもの
kayak	カヤック
lam	逃走|ずらかる|叩く|やっつける|打ちすえる|脱走する|殴る
ideology	空想すること|イデオロギー|観念形態|観念学(論)|空論
misuse	誤用|悪用|誤用する|虐待する
hostile	敵意のある|敵の|敵国の|敵対する
tasty	おいしい|味のいい
chalet	シャレー|シャレー風の家|バンガロー|羊飼いの山小屋
voyager	ボイジャー
spit	吐いた|つばを吐く|を吐く|つば(を吐く)
flashlight	懐中電灯
bliss	この上ない喜び|至福(を味わう)|幸福|天国
tuck	差し込む|を押し込む|を隠す|をはさむ|縫い込む|はおる|(袖など)をまくり上げる
carrot	ニンジン
reflective	反射による|反射する|照り返す|考え深い|内省的な|考え込む
outerwear	上着
stance	姿勢
grandma	おばあちゃん(=nan, nana, nanny, granny, granma, gran)
switchboard	代表電話番号|配電盤|交換台
carcinoma	癌腫
rugged	ごつごつした|でこぼこの|ぎざぎざの|岩だらけの|厳しい
practise	習慣|練習
superstar	大スター|超人気商品|巨大な星
downstream	流れをくだって|下流に
petrol	ガソリン
midway	中途の|中途に|催し会場
replicate	(葉など)を折り返す|を模写･複製する
dealership	販売特約店
ax	おの|斧|解任する|dismiss
slayer	殺害者
solitaire	(ダイヤモンドの)ひとつはめの宝石|ソリテール(ひとりトランプ)
recognise	認識する
radiology	放射線科|放射線学|放射(X)線使用|放射線医学
swivel	自在軸受け|旋回させる
diplomatic	外交の|外交上の
linguistic	語学上の|言葉の|言語(上)の|言語学の
internally	内部で
planetary	惑星の|起動を回る
tungsten	タングステン(金属元素;化学記号は W)
contingency	不測の出来事|偶然性|偶発事件|付随の事件|臨時出費
appetite	食欲|性欲|欲求
fluorescent	蛍光の|蛍光灯
influenza	インフルエンザ
compose	を組み立てる|(曲･文)を作る
flick	軽く打つ(こと)|はじき飛ばす|軽くたたく|(pl|で)映画
discography	ディスコグラフィー|椎間板造影(法)
creed	(=credoラテン語)|信条|信念|教義
transporter	運送者
cavalier	騎士|無頓着な
inference	推論
excite	興奮させる|刺激する|エキサイト
meaning	意味する|意味|意義|真意|効果|意味深長な
refusal	拒否|拒絶
unemployed	仕事のない|失業した|利用しない|寝かしてある
heavenly	すばらしい|天の
grievance	苦情(の種)|不平
electrode	電極
faucet	(水道などの)じゃ口|コック|飲み口|蛇口|水道栓
racist	人種差別主義の|人種差別論者
willingness	快く(喜んで)すること
implicit	暗黙の|暗示的な|絶対の|絶対的な|(反義語)explicit
patriotic	愛国心の強い|愛国的な|半島
terrific	恐ろしい|大変な|ひどい|すごい
laguna	潟
definite	明確な|限定された
flavour	風味(をそえる)|芳香
reviewer	批評家|評論家
bastard	雑種の|不純な|偽の|偽物|粗悪品|私生児|庶子|野郎
differentiation	区別
whereby	なにによって|そのために|何について|どのようにして|どういう手段で|それによって
entitlement	資格があること|有資格|社会保障給付金
jigsaw	ジグソーパズル|糸鋸(のこぎり)
waterfall	どっと押し寄せるもの|滝
capitalism	資本主義
monogram	モノグラム(装飾用組合せ文字)
tow	(綱･鎖で)を引っ張る(こと)|(ロープ製造の)麻くず
leukemia	白血病
oyster	牡蛎(カキ)|無口な人
millionaire	百万長者|大富豪
hitch	ぐいとうごかすこと|つなぐ|引張る|ひっかける|障害
educator	教育者
premature	早すぎる|早まった|時期尚早の|尚早の|早計の
visually	視覚的に
immigrant	帰化植物|移住者|移住民|(外国からの)移民|外来動物
alright	大丈夫
fury	憤慨|激怒|激しさ|憤激|怒る|激情
bother	を悩ませる|困らせる|を気にする|面倒|やっかいなもの
pooh	ばかな! フン|くまのプーさん
pesticide	農薬|殺虫剤
sophomore	2年目の人|2年生
asshole	ろくでなし|•尻の穴(卑語)
guilt	有罪
avid	どん欲な|貪欲な|熱心な
inflammatory	扇動的な|怒りをかきたてる|感情を刺激する|激昂させる|煽動的な
chemotherapy	化学療法
cookware	料理用具:pots,pans,bowls (utensilはknife,fork)
autobiography	自伝|自叙伝
tempo	テンポ|速度
scrutiny	精密な調査|精査
regeneration	再建|復興|復活|改革|刷新|再生
lunar	月の影響による|月の|太陰暦の
environmentally	環境的に
nonsense	たわごと|無意味
ore	鉱石|原鉱|(複数形ore)|オーレ(通貨)
lattice	格子
ripper	引き裂く人|道具|縦びきのこ|人をめった切りにする狂人|バラバラ殺人犯|二連ぞり|すてきな人|素晴らしい|自派に有利な改造を許す
dispenser	調剤師|分配者
motivate	に動機を与える|動機を与える|やる気にさせる
toggle	(縄の端の輪や鎖の輪などに通す)留め金|留め棒|(洋服のボタン代りに使う)細長い棒状の飾りボタン
swamp	浸す|を水浸しにする|沼地|低湿地|湿地
mare	雌馬|雌ロバ|(月･火星などの)海
ultrasound	超音波
sausage	ソーセージ|ソーセージ形のもの
boo	ブー(という非難)|ブーイング|ブーという
payout	支払い
anthem	賛美歌|賛歌|祝歌
bury	没頭させる|～隠す|を埋める|を埋葬する|を忘れる
grinder	グラインダー|粉砕(研磨)機|臼歯|奥歯|歯
livejournal	ライブジャーナル
proficiency	熟達|熟練|上達
regency	摂政の|執権職|摂政時代|摂政政治
pant	息を切らす|あえぐ|熱望する|どきどきする|をあえぎながら言う|ズボン|パンツ
tarot	タロット占い
synchronization	同期化
clerical	聖職者の|書記
mitigate	和らげる|緩める
moose	ムース|アメリカヘラジカ
paw	(肉球のある)手|足|客間|居間|店|診察室|手荒く扱う|前足で叩く|前足で掻く|蹄で掻く
heck	(俗)地獄|ひどいこと
corrosion	腐食作用
influential	影響力のある|有力な
rectangular	長方形の
horde	群落になる|大群
positively	確実に|明確に|確信して|肯定的に|積極的に
legion	歩兵軍団|軍隊|多数|きわめて多い|おびただしい
wee	ちっぽけな|ちっちゃな
sorrow	悲しみ|後悔|悲しむ
chap	男|あかぎれ|ひび(あかぎれ)を作る|(手などが)荒れる|(動物の)あご|ほお
vac	vacation|vacuum cleaner|電気掃除機をかける|を電気掃除機で掃除する
rhapsody	ラプソディ|狂想曲
majesty	威厳|陛下
meantime	合い間|その間の時間
mercer	呉服商|絹物商人
apex	頂上
ness	岬|岬角|海角
redundant	余分の|余剰の|冗長な
midland	中部地方
offspring	子孫|結果|成果
stark	硬直した|厳格な|厳しい|正真正銘の|(副詞)全く
informatics	インフォマティクス|情報科学
biscuit	ビスケット|小型食パン
vaccination	ワクチン注射|種痘|予防接種|種痘の痕跡
cocoa	ココア
volatile	揮発性の|爆発しやすい|(人･性格･情勢・市場などが)変わりやすい|不安定な|一時的な|はかない
solicit	せがむ|懇請する|請い求める|を求める
tulip	チューリップ
lynx	ヤマネコ|山猫
maternal	母らしい|母の|母方の
specimen	見本の|標本|見本|試験片|試料
seamless	継ぎ目のない
panther	ヒョウ|獰猛な人
affinity	類似性|親近感|魅力|attraction|婚姻(関係)
evergreen	いつまでも新鮮な|常緑の|(装飾用の)常緑樹の枝|常緑樹|ときわ木
gamble	投機をする|ギャンブルをする
meadow	草地|牧草地
localization	ローカライゼーション(各国・地域制度に訳す|他)
tapestry	つづれ織り|タペストリー
dull	苦痛を和らげる|(切れ味や頭が)鈍い|わかりの遅い|鈍感な|動作がのろい
panty	パンティー
goodman	一家のあるじ|《Goodman》=Mr.
manifold	種々の|多数の|多様性|複写する|(内燃機関の吸排気をする)マニホールド管(多岐管)
lac	ラック(ワニスの原料)
handful	ひと握りの量|小数|一握り|少量
beneficiary	受取人|受給者|受益者|信託受益者
outlaw	無法者|追放する|禁止する|時効にする
solder	はんだ|はんだづけする|を固く結合する|しろめ|きずな
crate	わく箱に詰める|木枠|木箱
dismiss	解雇する|fire|立ち去らせる|追放する|解散する|(本来なら考慮すべきことを)忘れる
fidelity	忠実
sidewalk	歩道
thunderbird	サンダーバード|雷鳴と稲妻の精霊|巨大な鳥の形と先住アメリカ人に信じられている
lust	切望する|強い色情をいだく|(通例好ましくない)欲望|強い性欲
emergence	出現
pigeon	ハト|鳩|若い娘|だまされやすい人|だます
stunt	を妨げる|発育を止める|発育阻害|妙技|離れ業|人気取り
crimson	深紅色の|深紅色
compassion	思いやり|哀れみ|同情
garland	花輪で飾る|花環
recap	recapitulate(要約する)
almond	アーモンド
diversion	気晴らし|気分転換
extensively	広く|手広く|大々的
attic	屋根裏(=garret, loft)
syrup	シロップ
imp	鬼の子|小鬼|イムプ|腕白小属|(古語)子ども
gadget	小さな機械装置|機械装置|付属品|便利な機械装置
behold	見る|眺める|注意して見る
dong	ベルのように鐘を鳴らす音
teaspoon	茶さじ
glimpse	ちらりと見えること|一瞥(いちべつ)|ちらりと見る
jockey	騎手|操作する|だます
trivial	つまらない|平凡な|とるに足らない|些細な|普通の
deco	デコレーションdecoration
sensible	(人行動など)分別のある|目的にかなった|賢明だ|顕著な|思慮のある|賢明な
unlawful	不法の|非合法的な|私生(児)の
accountable	説明のつく|責任がある
battalion	大隊|大部隊
procedural	手続きの
delightful	喜びを与える|愉快な|楽しい
simulate	擬態する|のふりをする|をまねる
zodiac	《the ~》黄道帯|獣帯|十二宮図(占星術)
ay	はい|aye|yes
pediatrics	小児科|小児科学
bilingual	二つの言語を話す
sushi	すし
puffy	パッと吹く|一息の|息の短い|膨れた|誇大な|思い上がった|ふくれた|一陣の|あえぐ|肥満した
lobster	伊勢海老|うみざりがに
heading	あたまとなるもの|表題|頭書き
claw	動物の爪|つめ|人の爪はnail
roar	吠える|唸る|大笑いする|怒鳴る(声)|どよめき|ウォー|猛獣の鳴き声
ridiculous	けしからぬ|おかしい|ばかげた
suppression	抑えること|鎮圧|隠すこと|抑圧|鎮静|抑制
wildcat	ヤマネコ|ノラネコ|突然怒りだす人|無謀な|非合法な
spacecraft	宇宙船
scholarly	学者らしい|学術的な|学問的な
spectator	見物人|傍観者|観客|傍聴人
concerto	協奏曲
circa	(年代･日付の前に用い)およそ(略c., ca.)
treadmill	踏み車|単調な仕事
surrounding	周囲の|付近の
attendant	付添いの|係員|コンパニオン(和製英語)
uranium	ウラニウム|ウラン(放射性金属元素)|元素記号U
temper	気分|機嫌|性質|を調節する|和らげる|粘土をこねる
mortal	死を免れぬ運命の|死すべき|人間の|死ぬべき運命の|死ぬ運命にある|命にかかわる|ひどく
hale	(老人)強壮な|かくしゃくとした
laminate	薄板|薄板をかぶせる
systemic	組織の|全身(性)の
flea	ノミ|蚤のように跳ぶ小虫|くだらない奴|こうるさい奴
readiness	素早さ|用意|準備|迅速|快諾|進んで
secular	俗人の|世俗の|非宗教的な|修道院外の|修道院外の僧侶
tout	客引きする|勧誘する|大げさに宣伝する|客引き|運動員|(競馬の)予想屋|(泥棒の)見張り
apostle	使徒
converge	一点に集める|収束する|集まる|合流|一点に集まる
fishery	漁業
chateau	付きのブドウ園|城|大邸宅
homestead	家屋敷|農家|自作農場
outdated	時代遅れの
temptation	誘惑|誘惑物
pewter	白鑞|シロメ(錫･鉛などの合金)
notably	明白に|著しく
nanny	おばあちゃん(=nan, nana, granny, grandma, granma, gran)|ばあや|乳母|子守|雌ヤギ
showroom	陳列室
secondly	第2に
ohm	オーム(電気抵抗の単位)
cerebral	脳の
kennel	犬小屋(に住む)
realization	実現
precinct	境内|周囲|区域|管区|選挙区|境界|周辺|付近|地区|地域
backwards	=backward
telecommunication	(遠距離の)電気通信|電気通信術
nightclub	ナイトクラブ
gravel	じゃり|砂利
presumably	おそらく|たぶん
coating	コーティング
eureka	(ギリシア語)わかった|見つけた|I have found it
constructive	建設的な|強い相場の|前向き|積極的な
preparedness	(可能性のある戦争に対し)戦闘準備ができていること
abundant	豊富な
specialize	専門化する|専攻する|専門にする|特別にする|を特殊化する
baptism	洗礼
hound	猟犬で狩る|猟犬|犬
corpse	(特に人の)死体|死骸
preteen	13歳未満の子供
realise	realizeの英式綴
conveniently	都合よく
indigo	インジゴ(藍色染料)
gov	政府関連機関
armour	よろい|装甲
stealth	こっそり|密かなやり方|内密|ステルス軍用機
subclass	サブクラス
unfortunate	不運な|不幸な|運の悪い|残念な|不運な人
inhibition	抑制|禁止|禁制|防止|抑圧
collegiate	大学(カレッジ)の|大学生らしい|大学生用の|大学(組合)組織の
runway	滑走路|走路|動物の通り道|(劇場の)花道
prospectus	目論見書|学校案内|趣意書
nominate	(候補者として)指名する|推薦する|任命する
tornado	(陸上の)竜巻|旋風
traverse	交差点|横木|横断(する)|に矛盾する|妨害する|を詳しく検討する
morale	志気|風紀|勤労意欲
pertinent	(直接)関係がある|適切な
descent	下り坂|下降
lifelong	一生の
commute	取りかえる|切り替える|換算する|通勤･通学する
shaker	振る人(もの)|シェーカー
wander	歩き回る|ぶらつく
remotely	およそ|遠く離れて|関係が薄く|時間が遠く隔たって|間接的に|よそよそしく|冷淡に|これっぽちも
characterize	の特性を示す
concise	簡潔な|簡明な
wretch	不運な人|かわいそうな人|気の毒な人|見下げ果てた人
sergeant	軍曹|巡査部長
percentile	百分率|百分位数|百分順位|パーセンタイル値
implant	(心など)に植え付ける|深く刻みこむ|教えこむ|移植する|移植組織
ole	いいぞ|よし
constituency	有権者|支持者|選挙民|選挙区(の有権者)|得意先|顧客層
hilarious	陽気な|楽しい|おもしろい|こっけいな
pseudo	偽の|偽りの|仮の|仮名の|匿名の
tighten	締める
nan	インドの粘土オーブンで焼かれた発酵パン|おばあちゃん(=nana, nanny, granny, grandma, granma, gran)|子守|乳母
brew	醸造する|計画する|醸造物|調合する|起ころうとしている
elegance	優雅
sensory	感覚(上)の|知覚の
magnesium	マグネシウム(金属元素)
broaden	広くする|広げる
socially	社会的に|社交的に
territorial	領土の
iteration	反復
stab	を刺す|中傷する|刺し傷|突き傷|白血球
brit	英国人
alkaline	アルカリ性
ditch	溝に捨てる|見捨てる|水路|溝|溝を掘る
directorate	重役|取締役