elegance	優雅
sensory	感覚(上)の|知覚の
magnesium	マグネシウム(金属元素)
broaden	広くする|広げる
socially	社会的に|社交的に
territorial	領土の
iteration	反復
stab	を刺す|中傷する|刺し傷|突き傷|白血球
brit	英国人
alkaline	アルカリ性
ditch	溝に捨てる|見捨てる|水路|溝|溝を掘る
directorate	重役|取締役
och	おお
midst	中央|の中に|真ん中に
methyl	メチル|メチル基
sickness	病気
seam	縫い目|継ぎ目|を縫いあわせる|薄層
skinny	皮と骨ばかりの|やせこけた|皮の(ような)|けちな|(俗)内部情報|事実
competitor	競争相手
songwriter	作詞家
encompass	取り囲む|含む|包含する
rainy	雨の|雨の多い
gee	おや|へえっ|うわ～
elm	ニレ(花言葉は威厳)|ニレの木
morality	道徳|道徳性|徳行
usable	使用できる
decoder	デコーダ|コード化を元に戻すもの|(反義語)coder
taboo	禁止された|禁忌|タブー|忌み言葉|禁制|禁止
readable	おもしろく読める(書かれた)|読みやすい
glide	グライダーで飛ぶ|滑空(する)|すべる(こと)|すべり台|(文法)わたり
polling	投票
stub	使い残り|引抜く|切株|吸い殻|切り株|をぶつける
blazer	ブレザーコート
continuum	(物質･事件などの)連続(体)
workload	(仕事の)負担|仕事量|仕事負荷|作業負荷
speculation	投機|思惑買い|思索|思弁|考察|空論|推測|やま
confess	白状する|自認する|を自白する|を認める
statistically	統計的に
messy	散らかった|扱いにくい|汚い
erection	勃起(ぼっき)
hummer	ただでもらえるもの|とても素晴らしい人|ブンブンいうもの|鼻歌を歌う人|蜂薬
appraiser	評価(鑑定)人|税関査定官
badger	しつこく苦しめる|悩ます|アナグマ|アナグマの毛皮
chestnut	クリ|栗
wrinkle	にしわを寄せる|しわが寄る|しわ|うまい考え
discriminate	差異を見分ける|識別する|弁別する|差別する|目の肥えた
noel	クリスマス(仏語)
perceive	を知覚する|に気づく|と思う|理解する
sanction	許可|拘束|賛成|認定(する)|(複数形で)軍事的･経済的制裁措置
vibe	雰囲気
premise	を前提とする|前提|根拠|既述事項|財産|不動産|家具|建物|土地|構内
negligence	無頓着|投げやり
unclear	あいまいな
aromatherapy	芳香療法|アロマテラピー
rancho	仮小屋|粗末な小屋
intervene	干渉する|仲裁する|邪魔する|間に起こる|挟まる
finalize	を終わらせる|完了する|に結末をつける|を決定的にする
flint	非常に堅い物|ライターの石
airborne	空輸の|空挺の|空輸された|空気電送|空中の
honorable	名誉となる|尊敬すべき|名誉ある|恥を知る|高貴な|身分のある
sewage	下水|汚水
lifecycle	生活環
dominion	支配権|主権|支配|統制|所有権
mack	ゴム引きの生地で作った防水のレインコート|ポン引き|殺し文句|プレイボーイ|言い寄る|取り持つ|食べる|人名(Mack)
snoop	のぞき回る|捜し回る|詮索する|探偵・スパイ|詮索好きの人|おせっかい屋
hallmark	顕著な特徴|太鼓判
shortcut	近道
choke	窒息する|を絞殺する|窒息させる|の息の根を止める|の成長を阻止する|閉塞|チョーク
sunlight	日光
endure	に持ちこたえる|がまんする|苦痛に耐える|を我慢する
hog	ブタ|大型車|むさぼる|独り占めする
profitability	収益性
globally	全体的に
inflatable	ふくらませられる
bearing	方向|態度|ベアリング
lame	足が不自由の|(仏語)キラキラした金糸を織り込んだ布
tumble	転倒する|宙返りする|を倒す|を投げる|転落|暴落
resurrection	回復|蘇り|復活|復興
eternity	永遠
fiat	命令|厳命|許可|決定|決断
facilitator	進行役
ballroom	ダンスホール
utter	口に出す|言う|(叫び声･うめき声)を出す|全くの
tightly	きつく|しっかりと|きっちりと|厳重に|きちんと
mute	無言の|ものが言えない|黙秘の|黙音の|弱音器
transplantation	Transplantation (外科)|(臓器)移植|移植法|(植物)植え替え|移住|移民
compost	配合土|堆肥
inverse	反対|逆
tack	針路|方針|がびょう|仮縫い|をびょうで留める
underneath	〜の下に
metabolic	新陳代謝の|変態の
whistler	(北米産)ロッキーマーモット
leaflet	小葉状の部分(構造)|印刷物|ちらし|小葉|若葉
capsule	被膜|さや|さく果|(薬用･ロケット用の)カプセル
mailer	メーラー|メールソフト
plead	弁護する|弁論する|申し立てる|嘆願する
encore	アンコール(を求める)|もう一度(の叫び)
lineup	スケジュール一覧|テレビ番組編成予定表|顔ぶれ|構成|在庫品|人の列|製品一覧
jackpot	積立賞金|積立掛金|(俗)大当たり|賭事の大当たり
dislike	きらう|嫌う
kinky	奇妙な|狂った|倒錯した
kindly	思いやりのある|親切に
cutie	かわいい娘|かわいこちゃん|策略|相手を出し抜こうとする人
dissent	意見の相違|意見を異にする|同意しない|反対する
weekday	平日
capacitor	(電気)コンデンサー|蓄電器
clipboard	回覧板|クリップボード|紙挟み(板)
attainment	達成
snatch	ひっつかむ|ひったくる|やっと得る|飛びつく(こと)|(スポーツなど)勝利を奪う
lieu	in lieu of ～の代わりに
jumbo	ずばぬけて大きな
veil	ベール|顔おおい|おおい隠すもの|を覆う
columnist	コラムニスト|特別寄稿者
throughput	処理能力
tuberculosis	結核
referendum	国民投票
sonata	ソナタ
daytime	昼
ambitious	大望のある|野心的な|熱望して
loom	ぼんやり現れる(こと)|不気味に迫る|織機|織物機械
notorious	悪評の高い|悪名高い|周知の
ibid	同書に|同上
residue	残余|残留物|かす
sequential	連続する|結果として起こる|逐次服用(避妊)ピル
uniquely	独自に
archaeological	考古学の
nap	昼寝|うたた寝する|油断する
rectangle	長方形|四辺形|矩形
thrice	3倍に|三度|三回|三重に
resale	再び売ること|再販(売)|再売却|追加販売|転売
emulator	競争者|見習う人|エミュレータ
musing	物思い(にふけって)
filler	filler 詰める人(もの)|(重さ･量などを増すための)混ぜ物|詰め物|充填材|注入器
amnesty	恩赦|特赦|大赦
blueprint	設計図|青写真
ringer	囲う人･もの|(輪投げ式のゲームで)輪を柱に向かって投げる人|輪投げの輪|生き写し|替え玉
gymnastics	体操
titanic	巨大な|大力無双の|《Titanic》タイタン(Titan)の
exquisite	優美な|精巧な|非常に見事な|絶妙な
massacre	大虐殺
herpes	ヘルペス(ウィルスにより生じる性病の一種)
upward	上向きの|上へ|上方へ|上へ向かって|上流へ|内陸へ
contractual	契約(上)の
unchanged	不変の|変わらない|変化していない
hatred	憎しみ|憎悪
squadron	戦車大隊|飛行中隊|中隊|小艦隊|飛行編隊
ounce	1オンスは28.3グラム
ally	同盟(させる)|同盟国|同盟者|連合国
suspicion	容疑|疑い
tragic	悲劇の|悲劇的な|悲劇に関する|悲劇を演じる|悲惨な
guidebook	案内書
mommy	おかあちゃん|ママ
enquire	尋ねる
rhetoric	レトリック|修辞|口先だけの発言
irrelevant	無関係の
professionally	専門的に
guitarist	ギタリスト
incense	香(の煙･香り)|香をたく|世辞|ひどく怒らせる|立腹させる
barker	ほえる動物|どなる人|客引き|ピストル
happily	しあわせに|幸福に|楽しく
testify	証明する|を証言する
shiny	光る|輝く|晴れた
mound	土塁|塚|盛り土|小山|土手|堤|盛り上げる|(野球)マウンド
khz	キロヘルツ
mutually	相互に|双方で
drummer	ドラマー
buff	打撃|～狂|(熱狂的な)ファン
incidental	ありがちな
enamel	エナメル|ほうろう|(陶器の)上ぐすり
exodus	《時にan exodus》(多数の人々が)国を出て行くこと|モーセの出エジプト(記)
gemini	双子座|双子座生まれの人
presbyterian	長老派の人|長老派の信徒
supervisory	監督上の
disrupt	分裂させる|中断させる|崩壊させる
chiropractic	脊柱指圧療法|カイロプラクティック
synergy	相乗効果
placebo	(有効成分のない)偽薬|プラシーボ
donkey	ロバ|民主党(Democratic Party)の象徴
fairness	金色|金髪|公正|順調|色白|清朗|美しさ
octet	8重唱(奏)曲;8重唱(奏)団|8個一組のもの
discreet	慎重な|控えめな|思慮深い
versa	その逆(vice versa)
recess	奥まったところ･場所|休会|休み時間|休憩|休み|休暇|床の間
reciprocal	相互交換の|お返しの|報いの|相互作用(関係)を表わす
whichever	どちらでも|どちらの～でも
hostage	宿泊所|抵当|入質(=pawn, pledge, captive)
attribution	帰属|属性|権能
disruption	分裂|崩壊|混乱
unspecified	不特定
unreal	実存しない|虚偽の|真実性のない|幻想的な|空想的な
physiological	生理学上の|生理的な|生理学の
unprecedented	前例のない|先例がない|空前の|無類の|新奇な|未曾有の|異例|破格|空前|前代未聞
dummy	ダミー|モデル台
financially	財政的に
sanitation	公衆衛生|衛生設備|下水設備
nurture	滋養物|養育|養う|育てる
ornament	装飾|飾る|光彩を添える人|飾り
cleanliness	きれい好き|清潔
thermometer	温度計|寒暖計|検温器
kung	カンフー
varsity	(大学などの)代表チーム
crank	変人
collectively	集合的に
capitalist	資本主義者
pep	元気|活力|気力|を元気づける|を活気づかせる
roach	ゴキブリ(=cockroach)|ローチ(コイ科の魚)|マリファナの吸いさし
solidarity	団結|連帯|一致
holt	雑木林|(動物|特にカワウソの)巣穴|けんか|口論|争い|(レスリングの)ホールド
marlin	マカジキ(魚)
pilgrim	巡礼者|巡礼の|巡礼する|流浪する
squirrel	リス|リスの毛皮
crochet	カギ針編み
allegedly	(真偽のほどはわからないが)伝えられるところによると
congressman	議員
incubus	インキュバス|悪夢|心配事|夢魔(むま)|淫魔
puff	ぷっと吹く(こと)|ひとふき|たばこの一服|ふくれること|息を切らす|煙を吐く|を膨らませる
corvette	コルベット艦(商船護送用快速艦)
lad	少年|若者|やつ|男
wrench	ねじる|(事実を)曲げる|歪曲する|もぎ取る|レンチ|かなしみ
footprint	足あと
contingent	依存する|付随する|偶然の|臨時の|不慮の出来事|分担|分艦隊|派遣団
coop	おりに入れる|鶏小屋|囲い|かご|小屋
irregular	でこぼこの|不揃いの|不同の|不規則な|変則的な|(文法)不規則変化の
candid	率直な|遠慮のない|気取らない
coherent	首尾一貫した|同位相の|密着した|筋の通った|一貫した
majestic	壮厳な|威厳のある|雄大な
tester	試験官|検査員|テスター
inhibitor	阻害剤
knowledgeable	知性のある|よく知っている
critically	きわどく|危うく|危なく|危篤状態に|酷評して|批判して|批評的に
carte	アラカルト
spicy	薬味を入れた|香ばしい|香辛料のきいた|気のきいた|きわどい
neutron	中性子
felony	重罪(強盗･殺人など)
chant	詠唱する|シュプレヒコール
putative	推定(推測)(上)の|うわさの
cypress	イトスギ(哀悼の象徴)|檜(ヒノキ)
slack	景気後退|不注意な|のろい|ゆるく|おそく
petty	つまらない|僅かな|小さい|些細な|狭量な|下級の|けちな|ささいな
admiral	司令長官|海軍大将|指令長官
hyperlink	ハイパーリンク
encouragement	励まし|促進
barb	とげ|辛辣
evangelical	福音の|福音書の|福音主義の|福音伝道者の|福音派の|普及に熱心な
helix	らせん|らせん形のもの
scalar	段階状の|はしご状の|(数学で)スカラーの|スカラー(空間・平面上の関数)|スカラー量(温度・時間など目盛り上の単位で表される量)
turf	縄張り|芝生|泥炭|競馬界
unsure	安全でない|確信のない
destructive	破壊的な
peek	ちらっとのぞく|のぞき見|かいま見
ample	広大な|広い|豊富な|豊かな|十分にゆとりある
countless	無数の
abusive	悪用された|口汚くののしって
stranger	よその人|他人|見知らぬ人|奇妙な
glamour	魅惑|グラマー(=glamor)
neuroscience	神経科学
berg	氷山
abdominal	腹部|腹部の
blaster	光線銃
hanger	格納庫
shave	ひげそり|をそる|を薄く削る|ひげをそる(こと)|ひげそり道具
frankly	率直に
chronological	年代順の
entrepreneurship	起業家精神
dispose	配列する|配置する
oath	神名濫用|のろい|悪罵|誓い|宣誓
zebra	しまのある|シマウマ|ゼブラ
crossover	(鉄道)渡り線|交差路|歩道橋|支持政党をかえる選挙人|異花受粉|クロスオーバー
economical	経済的な|倹約した
asphalt	アスファルト
immunization	免除|免疫処置|(免疫)予防注射|免疫化
pundit	専門家|博学者|インド人の賢者|博識者
chemist	化学者|薬屋
tavern	酒屋|バー(特にむさ苦しい|低級な酒場を指す)
woo	に求婚する|口説く|を手に入れる|せがむ
competitiveness	競争力
microscopy	顕微鏡検査
assortment	品揃え|仕分け|分類|類別|詰合せ
hyper	ハイパー(hyper-)|「上|超越|向こう側」を意味する接頭辞
savvy	精通した|抜け目のない|知る|わかる
equestrian	馬術の|馬の|乗馬姿の|(名詞)乗馬者|騎手
instinct	本能
tangible	具体的な|明白な|はっきりと理解できる|実体のある
welch	=welsh
veterinarian	獣医
bowel	腸|内臓
dime	10セント銀貨
lotto	ロット|賭けゲームの一種
reactive	(刺激に対して)敏感な|反応の早い|反作用的な
monarch	君主|王者
chord	感情|心の琴線|音楽関連のコード
axle	車軸|(機の)機軸|心棒
weed	(俗)マリファナ|雑草|喪章|役に立たない人|煙草|雑草を除く
lizard	トカゲ
saloon	談話室|酒場|広い場所(部屋)|大広間|客室
faux	人造の
kettle	やかん
farewell	別れ(の挨拶)|送別会|さようなら|さらば!
serenity	静けさ|晴朗|平静|平穏
salvage	残余財産売得金|海難救助|救助|財産救出|救出|を持ち出す|を救い出す|回収|廃物利用|救助する
incumbent	現職の|在職の|行う義務のある|現職者|現職議員|牧師
sanitary	公衆便所|(公衆)衛生の|衛生的な
probate	遺言検認|遺言を検認する
soybean	大豆
fortunate	しあわせな|幸運の|運の良い
lagoon	潟(かた)|潟湖せきこ|沼|礁湖
dismissal	免職|訴訟の却下|棄却|解任|却下|更迭|解散
workbook	ワークブック|練習帳|(学習･業務の)記録簿|計画書|(仕事の)規定集
analogue	(=analog主に米)|アナログ(の)|類似(の)|相似(の)|(肉･魚もどきの)合成食品
urinary	尿の|泌尿器の|小便所(ユﾘﾅﾘ)
prima	気難しい女|主役女性歌手|プリマドンナ|主なる|首位の|第一の
cinnamon	シナモン(肉桂皮･香味料)|肉桂(につけい)
corrective	訂正する|訂正の
rad	radicalの略語|すごい|最高の(coolやawesomeより強い)|ラッド(人名)|RAD(radiation absorbed dose)放射線吸収線量|Rapid Access Disk/Data
underworld	犯罪社会|下界|あの世|地獄|下層社会|暗黒街
fetal	胎児の
quantify	量を定める
billboard	《米》掲示板|広告板(《英》hoarding)|(ラジオ・テレビの)番組紹介
metaphor	比喩|隠喩|暗喩(類似語simile 直喩)
reportedly	伝えるところによると|聞くところによれば
countdown	カウントダウン
prose	散文的な|散文|散文的な文章|無味乾燥な話し|平凡|単調
tiff	もめごと|争い|quarrel|dispute
vous	(仏)あなた|の意
improper	不適切な|不道徳な|不規則な
coyote	コヨーテ
moor	《英》荒れ地|荒野(こうや)(特にイングランド・スコットランド地方のヒース(heather)などが一面に生えた湿地)
relocate	移転させる|立ち退かせる
sew	を縫う|縫い物をする|を縫い付ける|ドレミのソ(Doe,Ray,Me,Far,*,La,Tea)
facsimile	ファクシミリ(で送る)|複写(する)|複製|模写
plunge	突っ込む(こと)|突入|陥る
filtration	ろ過
teaching	教育|授業|教え|教義
friction	摩擦|不和
affirm	肯定する|断言する|確認する|確信する
dope	(俗)麻薬|マリファナ|薬物|薬物常用者
warmth	思いやり|暖かさ|熱心
curiosity	珍しい存在|好奇心
hospice	ホスピス
nanotechnology	ナノテクノロジー|微少加工技術
astronomical	天文の|(数字など)(数が)天文学的な|天文学(上)の|膨大な
backbone	背骨|中心|勢力|屋台骨
photocopy	コピー|複写
predicate	を断定する|を意味する|を叙述する|述部|述語
encode	符合化する|コード化する
commercially	商業上
annotate	に注釈する|注釈をつける
completeness	完全
hymn	賛美歌|聖歌
realised	実現した
latency	待ち時間
singular	唯一の|並外れた|奇妙な|単数の|単数
jukebox	ジュークボックス
incremental	増加分の|増量の
unacceptable	受け入れがたい|気に入らない
rot	やせ衰える|腐る|腐敗|だめになる|腐敗する|腐食
succession	連続(物)|継承|相続
avalanche	雪崩|殺到(する)
terrestrial	地上の|地球上の
scalable	拡張性のある
intra	(接頭辞)内に|内部に|内方に
spontaneous	自発的な|自然な|自然に起きる|自然に起こる
glossy	光沢のある|見栄えのする|もっともらしい
dough	(俗)現金|生練り粉|パン生地
vanguard	前衛|先導者|先駆|先導的地位
wetland	湿地
malicious	悪意のある
someday	いつか
spear	やり|槍|やりで突く
predecessor	前任者|祖先|先輩|前のもの
bur	(クリなどの)いが|いがをつける植物|くっついて離れない人(物)
exporter	輸出業者|輸出の
honesty	誠実|正直
diagonal	対角線の
instability	不安定|不安定性(度)(率)
northeastern	北東部の|北東|東北|北東からの
multicultural	多文化的な
dataset	データセット
ledger	元帳|台帳
stellar	星のような|優れた|星の
davenport	大型ソファ-
gasket	パッキン|ガスケット
maverick	一匹狼|無所属派|異端者
relational	リレーショナル|関係の
snowmobile	スノーモービル
queer	体の調子が悪い|ぶちこわす|妙な|奇妙な|変な|気分が悪い|不正の|いかがわしい
refrigeration	冷蔵|冷凍|冷却
purifier	ピュリファイア|清浄器
natl	national
imperative	命令的な|避けられない|緊急の|絶対に必要な|強制的な|(文法)命令法(の)
brewery	ビール醸造所|醸造所
mule	ラバ(家畜)|頑固者|雑種の動植物|つっかけ式スリッパ
checksum	データの信頼性を確認する検出符号
birch	バーチ(家具用材)|カバの木
formulate	定式化する
haired	髪
directional	方向の
cyclone	温帯性低気圧|つむじ風
lethal	致命的な|致死の
biographical	伝記(体)の
inflammation	燃焼|炎症
bib	よだれかけ
jug	水入れ
spectroscopy	分光法
militant	攻撃的な|好戦的な(人)|交戦中の|交戦状態
townhouse	タウンハウス
moan	うめき声|不平|うめき声を出す
slab	厚板でおおう|石板
rosemary	ローズマリー(スパイスの一種)
maroon	くり色|えび茶色(の)|(警報用)花火|マルーン(西インド諸島の山中に住む黒人･もとは脱走奴隷)|孤島に捨てられた人
abstraction	抽象作用|抽象
turquoise	トルコ石(12月の誕生石)|青緑色
archival	記録文書の|古文書の|記録保管所の|古文書保管所の
coincide	一致する|同時に起こる|性質が合う|同じくする
seismic	地震の|地震性の
liar	うそをつく人|うそつき
baccarat	バカラ|おいちょかぶに似たトランプ賭博
paperwork	ペーパーワーク
vie	優劣を争う|競う(=compete)
suburb	郊外|近郊
requisite	必要な|必須の|必要品|要素|必要条件
intercept	途中で捕まえる|妨害する
purity	清浄|混じり気のないこと|純粋|純度|清潔|純潔|清廉|正格
hotspot	ホットスポット
rigorous	厳格な|綿密な|きわめて厳密な|severely exact or accurate|precise
poke	を突く|を突き出す|突っ込む
aftermath	余波
demolition	破壊|取り壊し
clarion	爽やかな(声･音)|明快な
repeal	を無効にする|を取り消す|取り消し|廃止(する)|撤廃|無効に(する)
axe	解雇する
deb	スケ番|突っ張り娘 (debutanteの略)
enthusiastic	熱心な
wink	まばたきする|ウインクする|きらめく|をまばたきさせる|目くばせ|きらめき
rumor	をうわさする|うわさ|風説|流言
natal	出生(出産|分娩)の
pasture	を放牧する|牧場|牧草(地)|外野|食う
sidebar	追いかけ(追跡)記事|続報|(大記事の)補足記事
evening	夕方|晩|夜
factual	事実上の|事実の|実際の|事実に基づく
subordinate	を従属させる|副次的な|下位の|従属の
inconvenience	不自由|不便|迷惑
revive	を生き返らせる|回復させる|を元気にする|を復興させる
unregistered	未登録の
payload	打上げ荷重|(会社などの)給料支払い用経常負担金
standby	待機|頼りになる人(物)|交替要員|キャンセル待ちの(客)
prone	の傾向がある|のくせがある|しがちな|うつぶせの
prism	プリズム|分光スペクトル|柱
coarse	粗野な|あらい|粗末な|粗い
orient	東洋|東に向ける|適応する|真珠の光沢
equitable	公平な|公正な|衡平法上の|衡平法上有効な
dwell	移住する|住む
perennial	多年生の|絶え間ない|四季を通じての|年中絶えない|永続的な
canary	カナリア|カナリア色の
bookshelf	書棚|本棚|(個人の)蔵書
amid	〜の真っ最中に
micron	ミクロン|マイクロン(100 万分の1 記号μ)
pimp	売春宿の亭主|売春斡旋業者|ポン引き
proactive	先のことを考えた
uncomfortable	居心地の悪い|ここちよくない|不安な|厄介な
spur	を駆り立てる|に拍車をあてる|急行する|激励|刺激|拍車
goodwill	善意|営業権
worthwhile	それ相応の|やりがいのある|むだではない
anxious	心配している|しきりに～したがって|切望して
imprisonment	投獄|監禁|留置|禁固|懲役
pastry	ねり菓子
cervical	子宮頸管の|頚部の
cutlery	刃物類|食卓用金物(ナイフ, フォーク, スプーンなど)
trench	にみぞを掘る|塹壕を掘る|掘る|塹壕|堀|掘割
seminary	学校|神学校
devotion	深い愛情|献身
refinement	精練|精製|純化|上品|精妙
orbital	軌道の
yep	yes
reclaim	取り戻す|改善(する)|矯正(する)|を埋め立てる|を開墾する
harp	ハープ(竪琴)
flirt	異性に対して面白半分に気を引く
toaster	トースター
suspicious	疑い深い|疑わしい
converse	打ち解けて話す|逆の|談話する|談話|交際
pickle	(通例複数)ピクルス(にする)|キュウリ|困った立場
bleed	重傷を負う|出血する|流れ出る|心痛する|泣きだす
kris	東南アジア地区の短剣|(人名)クリス
thief	泥棒|こそ泥|盗人
cactus	サボテン
sponge	拭く|スポンジ(ですばやく拭くこと)|海綿動物|海綿|(俗)大酒飲み|居そうろう|放射能危険区域内の臨時作業員
feminine	女の|女性の|(文法)女性(の)
pigment	絵具|顔料|色素|を着色する
tuna	マグロ|鮪
pastoral	羊飼いの|牧歌|牧師の
contradiction	矛盾|否定|反対
regain	取りもどす|回復(奪還)する
nautical	航海の
installment	分割払い込み金|分割払い|月賦
hind	後部の|後ろの
splice	重ね継ぐ|組み継ぎ(する)|結婚させる
subtract	を控除する|引算をする|を引く|減じる|取り去る
modulation	調節|転調|変調
diminish	小さくなる|減らす|減少する
interruption	妨害|邪魔|障害|中断|中絶
muscular	たくましい|筋肉の|力強い|強健な
altar	祭壇
unisex	モノセックス|男女共用|(服･髪型などが)男女の区別がない|男女共用の
chopper	(俗)入れ歯|ヘリコプター|改造オートバイ|肉切り包丁
identifiable	身元を確認できる|同一であると証明できる
stag	男だけの|雄|雄ジカ|ニワトリの雄|Stag beetle(クワガタムシ)
digestive	消化の|消化を助ける|消化力のある|蒸解の|消化剤|消化薬
ethanol	エタノール|バイオマス･アルコール
abort	流産する|頓挫する|むだに終わる
antioxidant	酸化防止剤
cannabis	大麻
dynamically	動的に
outsource	外部委託する
giveaway	景品
comprise	包含する|包む|含む|意味する|構成する|成り立つ
harmonic	調和した|和声の
tort	私犯|不法行為(=legal liability)
hep	(俗)進んでいる|事情に明るい
typo	誤植(typographical error)|印刷工|印刷技術者(typographer)
thug	悪党|暴力団
enrichment	豊かにすること|価値を高めること|質を向上させること|富裕|濃縮
disregard	無視する|軽視する
unpaid	未払いの
arithmetic	(一般的な)計算力|数値に強い
mustard	カラシ|マスタード|カラシ色|カラシナ
transistor	トランジスター
locality	産地|ある土地|現場|ある場所に位置すること
soprano	ソプラノ(女性の高音部歌手)
substantive	名詞相当語句(形容詞句|節など)|実詞
broadly	露骨に
augmentation	増加|増大|increase
ethereal	エーテルの|エーテルを含んだ|天空の|天上の|この世のものでない
aero	航空の|航空学の
smoothly	なめらかに|滑らかに|やすやすと|流暢に|すべらかに|とんとん拍子|スムースに|するする|丸く|円く|滞りなく|すんなりと|すらすらと|順調に
faction	派閥|党派|党争|実話小説|内紛
etiology	病因(学)|因果関係学
swimsuit	水着
dispersion	散乱|分散|散布
corona	コロナ|光冠
blanc	(仏語)ブラン|白い
autonomy	自主性|自治権|自治体|自律性
diode	ダイオード|整流作用(電流を一定方向にしか流さない作用)を持つ電子素子
manifestation	発現|明らかにすること|政策表明|徴候
shack	掘っ立て小屋|部屋|同棲する|一夜を共にする
repay	払いもどす|金を返す|返金する|に報いる|を返す
fulfillment	充足感|達成感|実現(主に米)
biomass	生物量|バイオマス|生態学で
unresolved	未解決
sesame	ゴマ(の実)
businessman	ビジネスマン|実業家|実務家
punish	罰する|人を罰する|人を懲らしめる|をひどい目に合わせる|処刑する|酷使する
speedway	高速自動車道路|自動車競走場
electromagnetic	電磁力の
obsession	妄想|取り付かれること|脅迫観念
housewife	主婦
scarlet	深紅色|緋|緋色の|緋色(の)(ひいろ)|ひ色(濃い明かるい赤色)|あかね色
depict	(いきいきと言葉で)描写する|叙述する|描く
marshal	(英国|その他いくつかの国の)軍司令官|元帥|将官|《米》連邦裁判所の執行官|《米》警察(消防)署長|儀式(パレードなどの)準備担当者|〈兵隊など〉‘を'整列させる|結集させる|〈事|特に事実・考え〉‘を'整理する|整とんする|(所定の位置に)〈人〉‘を'案内する《+『名』〈人〉+『into』+『名』》
cranberry	ツルコケモモ
reckon	計算する|数える|勘定に入れる|判断する|みなす|思う
lei	レイ|花輪
unrelated	関係ない|無関係の|無縁の
condemn	運命づける|非難する|糾弾する|有罪の判決を下す
radial	輻射形の|放射状に|光線の|半径の
upside	上側
cosmos	(秩序と調和ある)宇宙|完全体系|調和|コスモス
dixie	キャンプ用湯沸かし|飯盒|大きな鉄鍋
endeavour	努力する
hierarchical	階級の
slogan	スローガン|標語
rhino	リノ(犀 サイ=rhinoceros)|金|現金|上陸艦艇
specificity	特異度|特定性|特異性|無病正診率
veronica	クワガタソウ
scramble	はい登る|奪い合う|をごちゃ混ぜにする|(盗聴予防に)周波数を変える|緊急発進する|(つる草などが)はびこる
affection	愛情|感情|気質|影響|体調|障害|疾患
incur	負う|被る|を受ける|にぶつかる
allergic	アレルギーの|大嫌いな
overland	陸上で|陸路で
unanimously	満場一致で|満場一致
popcorn	ポップコーン
comprehension	理解|包含
fraternity	同業者仲間|共済組合|友愛会|友愛団体|友愛|兄弟愛
schematic	概要の|図解の|構造図|回路図
uncommon	まれな|珍しい|異常の|非凡な|非常に
dread	恐怖|を心配する|恐い|を(非常に)恐れる
subgroup	下位群
sovereignty	主権|統治権|支配権|独立|君主であること|独立国
endpoint	エンドポイント
unpublished	未発表の|未出版の
embark	乗船させる|乗船する|始める|着手する
enlightenment	啓発|啓蒙|文明開化
conquest	占領地|征服
renter	賃借人|貸し手
stride	大股で歩く|またぐ|一またぎ|進歩
genetically	遺伝的に
supposedly	たぶん|おそらく
fable	寓話(ぐうわ)|作り話|伝説|神話
chimney	煙突
saw	seeの過去形|のこぎり(で切る)
communion	親交|宗派
jabber	ぺちゃくちゃしゃべる|きゃっきゃっと叫ぶ|早口にしゃべる|おしゃべり
yay	いえーい
captive	捕らわれた|人質(=hostage, pawn, pledge, captive)|とりこ(の)
pity	哀れと思う|残念な事|あわれみ|哀れみ|(～を)かわいそうに思う|かわいそうなこと
videotape	ビデオテープ(に録画する)
recruiter	リクルーター
preach	説教する|を伝道する|を説く
helm	かじ|操舵装置
lug	強く引く|持ち出す|突起
fortress	安全地域|要塞|要塞地|大規模な要塞|とりで|砦
cashier	現金出納係|帳場係|出納係|レジ係|免職する|を解雇する
diffuse	散らす|拡散させる
genomic	ゲノムの
archery	アーチェリー
qualifier	限定詞|修飾語句
sabbath	悪魔の|安息(日)
vegan	完全菜食主義者
emit	出す|放射する|発する|発行する
carton	ボール箱
avian	鳥類の|鳥
mole	モグラ|防波堤|スパイ|ほくろ|グラム分子|モル(単位)
shire	州|イングランド中部諸州
paradox	逆説|矛盾|矛盾しているように見える人(物)
estrogen	ステロイドホルモンの一種
palette	パレット|板|台
quark	クオーク(素粒子の構成要素となる粒子)
lymphoma	リンパ腫
flee	(人･場所)から逃げる|消える|を捨てる
amortization	定期償還 
bleach	漂白する|晒す
sect	教派|派閥|分派|学派
discard	捨てる|解雇する|(不用のものを)処分する|放棄|解雇
staple	中心部|原料|止め金|特産物|主要素|主要な
hopper	ホッパー(じょうご状の投入口)|底開き船(貨車)|ホップを摘む人
foundry	鋳造(業･類･工場)
credible	信じられる|信用できる|信頼できる|確かな
sportswear	スポーツウェア|運動着
deliberately	ゆっくりと|慎重に|故意に
openly	公然と|率直に
certainty	確実性
astro	宇宙飛行士(の)
sparkling	きらめく|発泡性の
robbery	強奪|略奪
roadway	道路|車道
genocide	大量殺戮|ジェノサイド|計画的な大量殺戮
binding	拘束力のある|縛る(こと)|製本|装丁|(スキーの)ビンディング
artisan	職人|腕のいい職人|熟練工
freeway	高速道路|ハイウェイ(和製英語)
latch	ラッチ|掛けがね|掛金
craftsman	職人
riddle	なぞなぞ|判じ物|難問|ふるい(にかける)(=sieve)
instruct	知らせる|を教える
neurology	神経(病)学|神経病学
duel	果たし合い|決闘|勝負
resign	放棄する|辞職する|退職する|譲り渡す|を任せる
commodore	提督|准将
classify	分類する
fragile	壊れ物
sapiens	(古代化石人類と対照して)現生人類の|現人に関する
boycott	ボイコットする|交渉拒否|不買同盟|ボイコット
sling	パチンコ|投石器|三角巾|一撃|投げつける|つるす
challenger	挑戦者
alteration	改変箇所|変更
supper	夕食(会)|夜食
graft	(骨の折れる)仕事|挿し木|移植する
rotor	回転部
centennial	100周年|100年祭|100年の|百年ごとの
eddy	小さい渦巻き|渦巻く|旋風
bluegrass	スズメノカタビラ属(牧草)|カントリーミュージック
pinch	つまむ(こと)|はさむ(こと)|苦しい状況|危機
accumulate	積み重ねる|蓄積する|集める
hazel	ハシバミ(の実)|薄茶色(の)
sleek	口先のうまい|光沢を出す|なめらかな|しゃれた身なりの|栄養がよい|を滑らかにする
reissue	再発刊物|再発行|新版|再び出る|に再発行する|再支給する
rash	発疹|軽率な
bravo	喝采のの言葉|ブラボー!
rehearsal	リハーサル|試演|練習|暗唱
martini	マーティニ(ジンまたはウオツカとベルモットで作るカクテル)
vague	ばく然とした|曖昧な|ぼんやりした|あいまいな
hemisphere	半球|半球体|大脳(小脳)
redevelopment	再開発|再開発区域|再興|再建
cornerstone	礎石|肝要なもの|不可欠なもの|土台|基礎|いしずえ
resignation	あきらめ|辞職|辞任|退職|辞表|放棄|断念|服従
nib	ペン先|くちばし(=bill, beak, pecker, neb)
gala	はなやかな|お祭りの
aerosol	スプレー|噴霧器
tense	強くはった|緊張した|張り詰めた|堅苦しい|ぴんと張った|時制
subsidy	補助金|助成金|交付金
sulfate	(～を)硫酸化する|硫酸塩
empowerment	権限委譲|人びとに夢や希望を与え勇気づけること
comforter	慰める物|慰安者|おしゃぶり|毛糸の襟巻き|掛け布団
slick	なめらかな(部分)|巧妙な|なめらかに|如才ない|をなめらかにする|滑らかな
chalk	チョーク|白亜
gypsy	ジプシー|一般にはヨーロッパで生活している移動型民族|外名であり|自称ではない
ballad	バラード|民謡|小唄|物語|物語詩
acupuncture	はり治療|針(療法)
nestle	気持ちよく横たわる|寄添う|心地よく横たわる|すり寄る|～身を落ちつける
aggregation	集合体
duly	正式に
checkpoint	(通行)検問所|チェックポイント
grassroots	一般人|民衆|基本的事実
mast	マスト|柱
mick	(軽蔑的に)アイルランド人|Irish Person
crust	皮|パンの皮|堅くなった表面
surcharge	追加料金|不足金|上積み|積過ぎ
driveway	(公道から通じる)私用自動車道|車回し
envision	心に描く|想像する
cadet	士官学校生
deem	意見をもつ|思う|判断する
excavation	ほら穴|切り通し|発掘|(通例複数)発掘された遺跡
intercourse	交わり|交際(性的な意味強し)
emblem	象徴|記章|シンボルマーク(和製英語)
routinely	日常的に
coed	共学の女子学生
managerial	経営上の|経営の|管理者の
plateau	高原|飾り皿|プラトー|水平域|平坦域|停滞状態(になる)|頭打ちになる
kappa	(第10ギリシア文字)カッパ|Κ|κ
reflex	反射作用の|映像|反射的な|反動的な|反り返った
redwood	アメリカスギ|巨木で知られる
ontology	オントロジー(存在論)
humorous	ユーモアを解する|滑稽な|ユーモアのある
sow	雌豚|蒔く|種をまく
investigative	調査の
morrow	朝|翌日|(事件の)直後
quasi	に準ずる(resembling)
energetic	精力のある|エネルギッシュ
moonlight	月光(の)|(俗)内職(する)|夜間アルバイトをする
mosque	モスク
emulation	競争|対抗|張り合い|なりすます|まねる
disappointment	落胆
chandelier	シャンデリア
tango	タンゴ(を踊る)|赤橙色
weave	織る|よろめく|編む|編み込む|仕組む|張る|まとめあげる|(物語･計画などを)作り上げる
stray	はぐれた|道に迷った|話題が本筋から外れる|迷子|浮浪人(stray sheep迷える羊)
motivational	やる気を起こさせる
touchdown	タッチダウン(アメリカンフットボール用語)
longitudinal	経度の
speedy	速い|迅速な
grind	すりつぶす|こすりつける|すり減らす|つらい単調な仕事
shin	向こうずね|(～に)よじ登る|むこうずねを蹴る|するすると降りる
grizzly	(髪などが)白髪混じりの|灰色の(= grizzled)|グリズリーベアー
optimistic	楽観的な|楽観主義の
seldom	めったに～しない|めったに～ない
perimeter	周囲の長さ|全周|防御腺|(眼科)視野計
sunflower	ヒマワリ
mower	草刈り人(機)
awhile	しばらく
gull	カモメ|鴎|だます
pedigree	系図|血統書|家系図|起源|由来|語源
decomposition	分解|腐敗
skyline	スカイライン|地平線|(都市などの)空を背景とした輪郭
epilepsy	てんかん,痙攣,発作(=seizure)
rusty	錆びた|さびた|鈍くなった|役に立たなくなった|下手になった
longhorn	長角牛
pharma	製薬|ファーマ
quarry	切り出す|獲物|石切り場|採石場|源泉|石を切り出す
bootstrap	ブートストラップ(編み上げ靴のつまみ皮)|WebサイトやWebアプリケーションを作成するフリーソフトウェアツール集の名
magistrate	行政長官|行政官|治安判事
shrine	聖体容器|聖地|聖堂|神社
recycle	再循環させる|再生利用する|リサイクル
multinational	他国籍の|多国籍企業
harmless	無害の|損害をうけない|罪のない
resistor	(電気の)抵抗器
aroma	芳香|香気|香り|におい|風格|気品
redistribution	再区分|再配分|再分配
runoff	決選投票|(同点者の)決勝戦
trivium	(古代ローマの)三学科(七教養科目のうち文法・修辞学・論理学を指す)
cougar	クーガー
persistence	固執|粘り強さ|永続|持続性
precedent	前の|先行する|前例|判例
analogy	相似(生命化学)|外見や機能は似ているが遺伝子が共通の祖先に由来しないこと|(対義語)homology|類似|類推
gigabyte	ギガバイト
blessing	ありがたい|神の恵み
subcontractor	下請業者|下請け人|下請け会社
intrinsic	本質的な|本来備わっている|固有の
ox	雄牛
thoughtful	思慮ぶかい|考え込んでいる|思いにふけった|考え深い|思慮深い
raptor	猛禽類
cot	(羊・ハトなどの)小屋|囲い(cote)|粗末な家|(米国)指サック|小児用ベッド=crib|格納や運搬のために折り畳める小型のベッド
electrician	電気技師(工･係)
posture	状態|事態|状況|姿勢|体位|身構え|心構え|態度
dryer	乾燥機|乾いた
calf	子牛|カバ|サイ|クジラ|シカ|ゾウ|アザラシなどの幼獣|ふくらはぎ
specialization	特殊化|限定
migraine	偏頭痛
maze	迷路|当惑する
tau	(第19ギリシア文字)タウ|Τ|τ
lineage	血統|系図|家系
contra	反対に|コントラ|右派の反対者|反対の側|反対意見
marrow	髄質|骨髄(bone marrow)|髄|核心
lengthy	長たらしい|冗長な|長い
rinse	すすぎ
redefine	再評価する|定義し直す|問い直す
unhappy	浮かぬ|不幸な|不運な|惨めな|適切でない
impress	に感銘を与える|印象を与える|印象ずける|の心を打つ|特徴|効果|押印
tally	投票|得点|勘定|一致する|記録する|数え上げる
grim	残忍な|厳格な|断固とした|気味の悪い|(表情が)険しい
mandarin	(中国清朝の)役人|標準中国語|(植物)マンダリン
mash	すりつぶした物|どろどろのもの|麦芽汁|飼料|マッシュポテト|すりつぶす
shotgun	ショットガン|散弾銃
peep	のぞき見(する)|こっそり見る|姿を現す|出現
opal	オパール(10月の誕生石)|タンパク石
assessor	査定官|査定者|裁判所補佐人|陪席判事|補佐役
reversal	反転|逆転|取消し|反転現像|反転フイルム
subpart	下位区分
transformer	変化させるもの|変圧器
preclude	不可能にする|除外する|排除する|妨げる
fierce	気性が荒々しい|激しい|すさまじい|獰猛な|熱烈な
envy	うらやむ|うらやみ|羨望
magnum	マグナム瓶(約2.3リットル)|マグナム弾
seize	をつかむ|を理解する|つかむこと|差し押さえ|奪取
situ	場所
osteoporosis	オステオポローシス|骨粗鬆症|骨の希薄化
pup	子|小犬|あざらしの子
keystone	要石
successive	連続的な|継続的な|次の|連続する
illumination	照明
deliberate	意図的な|故意の|慎重な|熟考する
lira	リラ(通貨)
conformity	相似|適合|一致(to,with)|(法・慣習などに)服従|準拠|協調(to,with)
suffix	サフィックス|接尾辞
embodiment	化身|具体化
nexus	関連(connection)|絆(bond)|ネクサス(文の構成要素間の主語述語関係)
foremost	まっさきの|真っ先の|一番の|一流の
limp	びっこを引く(こと)|軟弱な|柔軟な|ぐったりした|薄表紙|のろのろ進む|話がつかえる
mahogany	マホガニー|食卓|赤褐色
shortlist	最終選抜候補者名簿
ignorant	無知から起こる|無知の|無学の|教育のない
allowable	安全
pane	窓ガラス|窓枠|鏡板|一抹模様の一目
parity	(量|質など)同等であること|等価|同等|類似|平衡|対応|欄干|パリティ
karate	空手
shoreline	海岸線|湖岸線|(=coastline)
endurance	持久力|忍耐|がまん
pager	ポケットベル|ポケベル|携帯電話|携帯用小型無線呼出し機
soar	舞い上がる|急に上がる|そびえたつ|高く昇る|急上昇する|急騰する
tang	(〜の)ぴりっとした味|ぶんとくるにおい《+of+名》
torah	律法
symmetric	対称の|対称的な|シンメトリック
appellate	上訴(控訴･上告)の|上訴(控訴･上告)を処理する
insightful	洞察に満ちた
bungalow	バンガロー
roundtable	ラウンドテーブル
kiosk	あずまや|キオスク|売店|公衆電話ボックス
sturdy	がんじょうな|逞しい|丈夫な|不屈の|頑健な
dyke	堤防
fir	樅(モミ)の木|材
eater	経口的薬物常用者|食べる人|大食漢|腐食物
contiguous	隣接する|次の|接触している|接触する|間もない
ascertain	突止める|確かめる|突きとめる|確実にする
inaccurate	不正確な
explanatory	解説の|説明の
ministerial	閣僚の|大臣の|内閣の|行政の
traction	牽引
hover	空中に舞う|施空する|うろつく|さまよう
enrolment	記載|登録|入隊|入学|登録簿|登録者名簿|登録(者)数
dragonfly	トンボ
disguise	本性を偽る|変装する|隠す|変装|(人目をごまかす)偽り|ごまかし
bipolar	二極性の|正反対の
communicator	通報器|通報者|伝達者
preacher	説教者|説教師|牧師|伝道者
outrage	侵害|乱暴|激怒|憤慨させる
amethyst	紫色|紫水晶(2月の誕生石)
lush	生い茂った
undoubtedly	疑いなく|疑う余地なく|確かに
menopause	月経閉止|更年期|閉経期(月経･生理が終わる年頃)
inbound	入ってくる|帰航の|市内に向かう|本国行きの|上りの
plaster	しっくい|膏薬|漆喰|に漆喰を塗る|をべたべた塗る
blush	赤面|恥じらい|紅潮させる|恥じる|顔を赤らめる|赤面する
eclectic	取捨選択する|折衷主義の|(意見など)折衷的な
reluctant	気乗りのしない|不承不承の|しぶしぶの|嫌がる
headphone	ヘッドホン|受話器
graphite	石墨|黒鉛
limerick	リメリック|五行戯詩
flourish	栄える|華麗な身振り|見せびらかし
bum	のらくら者|浮浪人(tramp)|なまけ者|ルンペン|飲んだくれ|くだらない|値打ちのない
invaluable	非常に貴重な|priceless
multitude	多数|群集|大衆|大勢
intercontinental	大陸間の
accuse	を非難する|を告発する|告訴する
utterly	全く|完全に|徹底的に
punt	パント船(さおでこぐ平底の船)|さおでこぐ
foe	敵|仇|反対者|障害|対戦者|enemy
perpetual	絶え間ない|永久の|終身の|四季咲きの植物
kinetic	(物理学)動的な
caffeine	カフェイン
patty	パティー|挽き肉などを小円盤状にまとめたもの|小さい円盤状のキャンディ
sulfur	を硫黄で処理する|硫黄
eta	(第7ギリシア文字)エータ|Η|η|(ETA)Estimate Time of Arrival|航空機などの到着予定時刻
troop	軍隊|警官隊|(人･動物の)群れ|ぞろぞろ歩く|隊|組み|多数|大勢|集まる
verbatim	文字どおりに|逐語的に
innocence	無垢|潔白
cation	陽(正)イオン
cardboard	厚紙|ダンボール|段ボール
attributable	原因を帰しうる
collage	コラージュ(画面に新聞紙の切り抜きや写真をはりつけ特殊な効果をねらう技法)
tertiary	第3の|ひどい
calorie	カロリー|熱量
inverter	逆変換回路
tread	を踏む|行く|歩く|階段の段
predictable	予報し得る|予知できる|予知可能な
susceptible	影響を受けやすい|敏感な|感染しやすい|を許す|可能な
personalize	人格化する
tenor	男性の高音部歌手
tao	道教の「道」
spruce	小ぎれいにする|きちんとした|エゾマツ|とくさ色(黒味がかかった深いみどり色)|きりっと|こぎれいな|トウヒ
volatility	不安定さ|変わりやすさ
quot	quotation|引用の略語
diocese	監督(司教|主教)管区
ritz	虚飾|見せびらかし|誇示|に傲慢に振る舞う
deception	だますこと|ごまかし|詐欺|幻想
preface	前置き|序文|序論|序説|を前置きする
affidavit	宣誓供述書|宣誓書|口述書
blitz	電撃戦|電撃的猛攻撃
ulcer	アルサー|潰瘍(かいよう)
cardiology	心臓(病)学
playoff	再試合|延長戦|王者決定戦
honorary	名誉上の|肩書きだけの|無給の
stencil	ステンシル|型板|原紙|(型紙を紙にあて色をつける)
kart	(競走・娯楽用)ゴーカート
hammer	たたく|を槌で打つ|槌|金槌|ハンマー
butte	差別侵食によって形成された孤立丘
misty	かすみのかかった|かすんだ|霧の|ぼんやりとした
magnolia	モクレン(花)
conservatory	保存力のある|温室
escrow	条件つき捺印証書
pineapple	パイナップル
misery	不幸|みじめな|みじめさ|窮乏|苦難|苦痛
spindle	紡錘|軸|スピンドル
heh	あわや
prentice	洗練されない|年季奉公人の|未熟な
despair	絶望(する)|絶望する
transcend	を超越する|超越する
mediator	調停者
sprinkle	雨がぱらつく|振りかける|をまく|を点在させる
cobalt	コバルト(金属元素)
recombinant	組換え型の(個体)|遺伝子組み替えの
inferior	下の方の|より下の|下位の|下級の|劣った|粗悪な
downward	下向きに|下方へ
coup	クーデター|政変|大当たり|大成功
hogan	ホーガン|北米インディアンNavaho族の住居
retriever	リトリーバー(犬種:狩の獲物を回収する(retrieve)に由来)
libertarian	自由意志論者
hem	縁|境|包囲する
pea	エンドウ豆|豆粒大の(もの)
magician	魔法使い|奇術師|魔術師
rebellion	謀反|暴動|反乱|むほん|反抗|造反|反逆
accidentally	偶然に|たまたま|ひょっこり
doughty	勇気のある|勇敢な(valiant);強い|がんじょうな
vinegar	酢|苦い顔|ひねくれた性質|気難しさ|精力|元気
fixture	固定物|備品|開催日
glassware	ガラス製品|ガラス器具類|ガラス製
steadily	しっかりと|着々と|こくこくと
clergy	聖職者
moderately	ほどほどに|控え目に|穏やかに|適度に
hatchback	ハッチバック
biochemical	生化学的な
repetitive	(けなして)繰り返しの|繰り返しの多い(repetitiousより控えめな語)
ponder	をじっくり考える
concur	同意する|一致する|協力する
commend	ほめる|推薦する
panoramic	パノラマ(式)の|全景の見える|概観的な
clover	クローバー
stakeholder	株主･利害関係者
sincere	誠実な|偽りのない|正直な
crusade	改革に加わる|撲滅運動|十字軍|改革運動
reinforcement	補強|強化
stochastic	確率論的な
prelude	前触れとなる|序|序幕|序曲|前奏曲|準備行為|前置き|前兆
canine	犬の(ような)|イヌ科
ammunition	弾薬|兵器|戦闘手段
midget	小さい人|超小型の(物)
airmail	『航空郵便』(の手紙)(また《英》air post)|航空郵便の|航空郵便で(by airmail)|〜'を'航空便で送る
problematic	問題のあった|問題の
roadmap	ロードマップ
blower	送風機
siege	包囲攻撃(する)|長く苦しい期間|執拗な努力･説得
elder	年長者|年上の 2|ニワトコ
aggression	攻撃|侵略
redundancy	余剰性|冗長性
bistro	ビストロ(小レストラン|居酒屋|仏語)
heroin	ヘロイン|アヘンに含まれるモルヒネから作られる麻薬
evacuation	撤退|排出|排気
sucker	乳飲み子|お人よし|カモ|吸盤|(俗)lollipop ペロペロキャンディー
laborer	労働者
holster	ホルスター(ピストルの革ケース)
rubbish	ばかげたこと|ナンセンス|くだらないこと|ゴミ|廃物
analytic	分析的な|分析の|解析幾何学
risky	危険な|冒険的な
luncheon	昼食をする|弁当
predominantly	優勢に|主に|大部分は|広く|支配的な
precedence	先に来ること|先行|優位|以前の|先の
uncover	暴露する|打ち明ける|覆いを取りはずす|脱帽する
monastery	修道院|僧院
adorable	魅力的な
reconcile	を和解させる|仲直りさせる|に甘んじる|満足させる|を調停する|諦めさせる|承諾させる
courthouse	裁判所
fern	シダ
timeless	永遠の|永久の|いつでも有効な|時間を超越した|時代を超えた|時ならぬ|時期尚早の
exposition	博覧会|解説|公開|開帳|顕示|展示会|展覧会